Site Occupation Location,Toponyms,SubOc1,Period,Period No.,Period Start,Period End,Estimated Span,Area
1,Padiglione,A,Early Iron Age,4,-800,-750,50,0.2
1,Padiglione,A,Late Iron Age,5,-750,-700,50,0.2
1,Padiglione,B,Republican Period,7,-100,-30,70,0.2
1,Padiglione,B,Early Imperial Period,8,-30,100,130,0.2
1,Padiglione,B,Mid-Imperial Period,9,100,300,200,0.2
1,Padiglione,B,Late Imperial Period,10,300,500,200,0.2
2,Astura,A,Late Iron Age,5,-700,-580,120,34
2,Astura,A,Archaic Period,6,-580,-350,230,34
2,Astura,B,Republican Period,7,-250,-30,220,34
2,Astura,B,Early Imperial Period,8,-30,100,130,34
2,Astura,B,Mid-Imperial Period,9,100,300,200,34
2,Astura,B,Late Imperial Period,10,300,500,200,34
2,Astura,B,Late Antique Period,11,500,1200,700,34
3,Torre Astura,A,Middle Bronze Age,2,-1700,-1350,350,4
3,Torre Astura,B,Late Iron Age,5,-600,-580,20,4
3,Torre Astura,B,Archaic Period,6,-580,-500,80,4
3,Torre Astura,C,Republican Period,7,-350,-30,320,4
3,Torre Astura,C,Early Imperial Period,8,-30,100,130,4
3,Torre Astura,C,Mid-Imperial Period,9,100,300,200,4
3,Torre Astura,C,Late Imperial Period,10,300,500,200,4
3,Torre Astura,C,Late Antique Period,11,500,1200,700,4
4,Pineta di Torre Astura,A,Republican Period,7,-350,-30,320,0.5
4,Pineta di Torre Astura,A,Early Imperial Period,8,-30,100,130,0.5
4,Pineta di Torre Astura,A,Mid-Imperial Period,9,100,300,200,0.5
4,Pineta di Torre Astura,A,Late Imperial Period,10,300,400,100,0.5
5,Pineta di Torre Astura,A,Republican Period,7,-250,-30,220,0.5
5,Pineta di Torre Astura,A,Early Imperial Period,8,-30,100,130,0.5
5,Pineta di Torre Astura,A,Mid-Imperial Period,9,100,300,200,0.5
5,Pineta di Torre Astura,A,Late Imperial Period,10,300,400,100,0.5
6,La Banca,A,Republican Period,7,-100,-30,70,0.5
6,La Banca,A,Early Imperial Period,8,-30,100,130,0.5
7,La Banca,A,Middle Bronze Age,2,-1700,-1350,350,0.30000001
8,Saracca,A,Republican Period,7,-100,-30,70,0.5
8,Saracca,A,Early Imperial Period,8,-30,100,130,0.5
8,Saracca,A,Mid-Imperial Period,9,100,300,200,0.5
8,Saracca,A,Late Imperial Period,10,300,400,100,0.5
9,Saracca,A,Early Imperial Period,8,-30,100,130,0.5
9,Saracca,A,Mid-Imperial Period,9,100,300,200,0.5
9,Saracca,A,Late Imperial Period,10,300,400,100,0.5
10,Saracca,A,Middle Bronze Age,2,-1350,-1300,50,0.1
10,Saracca,A,Late Bronze Age,3,-1300,-1020,280,0.1
10,Saracca,B,Republican Period,7,-100,-30,70,0.1
10,Saracca,B,Early Imperial Period,8,-30,100,130,0.1
10,Saracca,B,Mid-Imperial Period,9,100,250,150,0.1
11,Pelliccione,A,Republican Period,7,-350,-30,320,0.1
11,Pelliccione,A,Early Imperial Period,8,-30,100,130,0.1
11,Pelliccione,A,Mid-Imperial Period,9,100,300,200,0.1
11,Pelliccione,A,Late Imperial Period,10,300,400,100,0.1
12,Pelliccione,A,Middle Bronze Age,2,-1700,-1300,400,0.01
12,Pelliccione,A,Late Bronze Age,3,-1300,-1020,280,0.01
12,Pelliccione,B,Republican Period,7,-350,-30,320,0.01
12,Pelliccione,B,Early Imperial Period,8,-30,100,130,0.01
12,Pelliccione,B,Mid-Imperial Period,9,100,300,200,0.01
12,Pelliccione,B,Late Imperial Period,10,300,400,100,0.01
13,Pelliccione,A,Republican Period,7,-100,-30,70,0.30000001
13,Pelliccione,A,Early Imperial Period,8,-30,100,130,0.30000001
14,Le Grottace,A,Middle Bronze Age,2,-1350,-1300,50,0.5
14,Le Grottace,A,Late Bronze Age,3,-1300,-1020,280,0.5
14,Le Grottace,B,Republican Period,7,-250,-30,220,0.5
14,Le Grottace,B,Early Imperial Period,8,-30,100,130,0.5
14,Le Grottace,B,Mid-Imperial Period,9,100,250,150,0.5
15,Pelliccione,A,Republican Period,7,-250,-30,220,0.30000001
16,Pelliccione,A,Republican Period,7,-350,-30,320,0.30000001
16,Pelliccione,A,Early Imperial Period,8,-30,100,130,0.30000001
16,Pelliccione,A,Mid-Imperial Period,9,100,300,200,0.30000001
16,Pelliccione,A,Late Imperial Period,10,300,400,100,0.30000001
17,Finocchierelle,A,Republican Period,7,-350,-30,320,0.1
17,Finocchierelle,A,Early Imperial Period,8,-30,100,130,0.1
17,Finocchierelle,A,Mid-Imperial Period,9,100,300,200,0.1
17,Finocchierelle,A,Late Imperial Period,10,300,400,100,0.1
18,Vallone Carnevale,A,Republican Period,7,-350,-30,320,0.1
18,Vallone Carnevale,A,Early Imperial Period,8,-30,100,130,0.1
18,Vallone Carnevale,A,Mid-Imperial Period,9,100,300,200,0.1
18,Vallone Carnevale,A,Late Imperial Period,10,300,400,100,0.1
19,Finocchierelle,A,Republican Period,7,-350,-30,320,0.1
20,Finocchierelle,A,Republican Period,7,-350,-30,320,0.1
20,Finocchierelle,A,Early Imperial Period,8,-30,100,130,0.1
20,Finocchierelle,A,Mid-Imperial Period,9,100,300,200,0.1
20,Finocchierelle,A,Late Imperial Period,10,300,400,100,0.1
21,Finocchierelle,A,Republican Period,7,-350,-30,320,0.1
21,Finocchierelle,A,Early Imperial Period,8,-30,100,130,0.1
21,Finocchierelle,A,Mid-Imperial Period,9,100,300,200,0.1
21,Finocchierelle,A,Late Imperial Period,10,300,400,100,0.1
22,Finocchierelle,A,Republican Period,7,-350,-30,320,0.1
22,Finocchierelle,A,Early Imperial Period,8,-30,100,130,0.1
22,Finocchierelle,A,Mid-Imperial Period,9,100,300,200,0.1
22,Finocchierelle,A,Late Imperial Period,10,300,400,100,0.1
23,Finocchierelle,A,Republican Period,7,-350,-30,320,0.1
23,Finocchierelle,A,Early Imperial Period,8,-30,100,130,0.1
23,Finocchierelle,A,Mid-Imperial Period,9,100,300,200,0.1
23,Finocchierelle,A,Late Imperial Period,10,300,400,100,0.1
24,Finocchierelle,A,Republican Period,7,-350,-30,320,0.40000001
24,Finocchierelle,A,Early Imperial Period,8,-30,100,130,0.40000001
24,Finocchierelle,A,Mid-Imperial Period,9,100,300,200,0.40000001
24,Finocchierelle,A,Late Imperial Period,10,300,400,100,0.40000001
25,Finocchierelle,A,Republican Period,7,-350,-30,320,0.1
25,Finocchierelle,A,Early Imperial Period,8,-30,100,130,0.1
25,Finocchierelle,A,Mid-Imperial Period,9,100,300,200,0.1
25,Finocchierelle,A,Late Imperial Period,10,300,400,100,0.1
26,Finocchierelle,A,Republican Period,7,-350,-30,320,0.1
26,Finocchierelle,A,Early Imperial Period,8,-30,100,130,0.1
26,Finocchierelle,A,Mid-Imperial Period,9,100,300,200,0.1
26,Finocchierelle,A,Late Imperial Period,10,300,400,100,0.1
27,Finocchierelle,A,Republican Period,7,-350,-30,320,0.1
27,Finocchierelle,A,Early Imperial Period,8,-30,100,130,0.1
27,Finocchierelle,A,Mid-Imperial Period,9,100,300,200,0.1
27,Finocchierelle,A,Late Imperial Period,10,300,400,100,0.1
28,Finocchierelle,A,Republican Period,7,-350,-30,320,0.1
28,Finocchierelle,A,Early Imperial Period,8,-30,100,130,0.1
28,Finocchierelle,A,Mid-Imperial Period,9,100,300,200,0.1
28,Finocchierelle,A,Late Imperial Period,10,300,400,100,0.1
29,Finocchierelle,A,Republican Period,7,-350,-30,320,0.1
29,Finocchierelle,A,Early Imperial Period,8,-30,100,130,0.1
29,Finocchierelle,A,Mid-Imperial Period,9,100,300,200,0.1
29,Finocchierelle,A,Late Imperial Period,10,300,400,100,0.1
30,Finocchierelle,A,Republican Period,7,-350,-30,320,0.1
30,Finocchierelle,A,Early Imperial Period,8,-30,100,130,0.1
30,Finocchierelle,A,Mid-Imperial Period,9,100,300,200,0.1
30,Finocchierelle,A,Late Imperial Period,10,300,400,100,0.1
31,Finocchierelle,A,Republican Period,7,-350,-30,320,0.1
31,Finocchierelle,A,Early Imperial Period,8,-30,100,130,0.1
31,Finocchierelle,A,Mid-Imperial Period,9,100,300,200,0.1
31,Finocchierelle,A,Late Imperial Period,10,300,400,100,0.1
32,Finocchierelle,A,Republican Period,7,-350,-30,320,0.1
32,Finocchierelle,A,Early Imperial Period,8,-30,100,130,0.1
32,Finocchierelle,A,Mid-Imperial Period,9,100,300,200,0.1
32,Finocchierelle,A,Late Imperial Period,10,300,400,100,0.1
33,Finocchierelle,A,Republican Period,7,-350,-30,320,0.1
33,Finocchierelle,A,Early Imperial Period,8,-30,100,130,0.1
33,Finocchierelle,A,Mid-Imperial Period,9,100,300,200,0.1
33,Finocchierelle,A,Late Imperial Period,10,300,400,100,0.1
34,Finocchierelle,A,Republican Period,7,-350,-30,320,0.1
34,Finocchierelle,A,Early Imperial Period,8,-30,100,130,0.1
34,Finocchierelle,A,Mid-Imperial Period,9,100,300,200,0.1
34,Finocchierelle,A,Late Imperial Period,10,300,400,100,0.1
35,Finocchierelle,A,Republican Period,7,-350,-30,320,0.1
35,Finocchierelle,A,Early Imperial Period,8,-30,100,130,0.1
35,Finocchierelle,A,Mid-Imperial Period,9,100,300,200,0.1
35,Finocchierelle,A,Late Imperial Period,10,300,400,100,0.1
36,Finocchierelle,A,Republican Period,7,-350,-30,320,0.1
36,Finocchierelle,A,Early Imperial Period,8,-30,100,130,0.1
36,Finocchierelle,A,Mid-Imperial Period,9,100,300,200,0.1
36,Finocchierelle,A,Late Imperial Period,10,300,400,100,0.1
37,Finocchierelle,A,Republican Period,7,-350,-30,320,0.1
37,Finocchierelle,A,Early Imperial Period,8,-30,100,130,0.1
37,Finocchierelle,A,Mid-Imperial Period,9,100,300,200,0.1
37,Finocchierelle,A,Late Imperial Period,10,300,400,100,0.1
38,Finocchierelle,A,Republican Period,7,-350,-30,320,0.1
38,Finocchierelle,A,Early Imperial Period,8,-30,100,130,0.1
38,Finocchierelle,A,Mid-Imperial Period,9,100,300,200,0.1
38,Finocchierelle,A,Late Imperial Period,10,300,400,100,0.1
39,Finocchierelle,A,Republican Period,7,-350,-30,320,0.1
39,Finocchierelle,A,Early Imperial Period,8,-30,100,130,0.1
39,Finocchierelle,A,Mid-Imperial Period,9,100,300,200,0.1
39,Finocchierelle,A,Late Imperial Period,10,300,400,100,0.1
40,Selvapiana,A,Republican Period,7,-350,-30,320,0.1
40,Selvapiana,A,Early Imperial Period,8,-30,100,130,0.1
40,Selvapiana,A,Mid-Imperial Period,9,100,300,200,0.1
40,Selvapiana,A,Late Imperial Period,10,300,400,100,0.1
41,Selvapiana,A,Republican Period,7,-350,-30,320,0.1
41,Selvapiana,A,Early Imperial Period,8,-30,100,130,0.1
41,Selvapiana,A,Mid-Imperial Period,9,100,300,200,0.1
41,Selvapiana,A,Late Imperial Period,10,300,400,100,0.1
42,Selvapiana,A,Republican Period,7,-350,-30,320,0.1
42,Selvapiana,A,Early Imperial Period,8,-30,100,130,0.1
42,Selvapiana,A,Mid-Imperial Period,9,100,300,200,0.1
42,Selvapiana,A,Late Imperial Period,10,300,400,100,0.1
43,Selvapiana,A,Republican Period,7,-350,-30,320,0.1
43,Selvapiana,A,Early Imperial Period,8,-30,100,130,0.1
43,Selvapiana,A,Mid-Imperial Period,9,100,300,200,0.1
43,Selvapiana,A,Late Imperial Period,10,300,400,100,0.1
44,Selvapiana,A,Republican Period,7,-350,-30,320,0.1
44,Selvapiana,A,Early Imperial Period,8,-30,100,130,0.1
44,Selvapiana,A,Mid-Imperial Period,9,100,300,200,0.1
44,Selvapiana,A,Late Imperial Period,10,300,400,100,0.1
45,Selvapiana,A,Republican Period,7,-350,-30,320,0.1
45,Selvapiana,A,Early Imperial Period,8,-30,100,130,0.1
45,Selvapiana,A,Mid-Imperial Period,9,100,300,200,0.1
45,Selvapiana,A,Late Imperial Period,10,300,400,100,0.1
46,Selvapiana,A,Republican Period,7,-350,-30,320,0.1
46,Selvapiana,A,Early Imperial Period,8,-30,100,130,0.1
46,Selvapiana,A,Mid-Imperial Period,9,100,300,200,0.1
46,Selvapiana,A,Late Imperial Period,10,300,400,100,0.1
47,Selvapiana,A,Republican Period,7,-350,-30,320,0.1
47,Selvapiana,A,Early Imperial Period,8,-30,100,130,0.1
47,Selvapiana,A,Mid-Imperial Period,9,100,300,200,0.1
47,Selvapiana,A,Late Imperial Period,10,300,400,100,0.1
48,Selvapiana,A,Republican Period,7,-350,-30,320,0.1
48,Selvapiana,A,Early Imperial Period,8,-30,100,130,0.1
48,Selvapiana,A,Mid-Imperial Period,9,100,300,200,0.1
48,Selvapiana,A,Late Imperial Period,10,300,400,100,0.1
49,Selvapiana,A,Republican Period,7,-350,-30,320,0.1
49,Selvapiana,A,Early Imperial Period,8,-30,100,130,0.1
49,Selvapiana,A,Mid-Imperial Period,9,100,300,200,0.1
49,Selvapiana,A,Late Imperial Period,10,300,400,100,0.1
50,Valle Foglino,A,Republican Period,7,-350,-30,320,0.5
51,Valle Foglino,A,Republican Period,7,-350,-30,320,0.1
51,Valle Foglino,A,Early Imperial Period,8,-30,100,130,0.1
51,Valle Foglino,A,Mid-Imperial Period,9,100,300,200,0.1
51,Valle Foglino,A,Late Imperial Period,10,300,400,100,0.1
52,Valle Foglino,A,Republican Period,7,-350,-30,320,0.1
52,Valle Foglino,A,Early Imperial Period,8,-30,100,130,0.1
52,Valle Foglino,A,Mid-Imperial Period,9,100,300,200,0.1
52,Valle Foglino,A,Late Imperial Period,10,300,400,100,0.1
53,Pantano Potassa,A,Republican Period,7,-350,-30,320,0.1
53,Pantano Potassa,A,Early Imperial Period,8,-30,100,130,0.1
53,Pantano Potassa,A,Mid-Imperial Period,9,100,300,200,0.1
53,Pantano Potassa,A,Late Imperial Period,10,300,400,100,0.1
54,Pantano Potassa,A,Republican Period,7,-350,-30,320,0.1
54,Pantano Potassa,A,Early Imperial Period,8,-30,100,130,0.1
54,Pantano Potassa,A,Mid-Imperial Period,9,100,300,200,0.1
54,Pantano Potassa,A,Late Imperial Period,10,300,400,100,0.1
55,Riserva del Nespolo,A,Republican Period,7,-350,-30,320,0.1
55,Riserva del Nespolo,A,Early Imperial Period,8,-30,100,130,0.1
55,Riserva del Nespolo,A,Mid-Imperial Period,9,100,300,200,0.1
55,Riserva del Nespolo,A,Late Imperial Period,10,300,400,100,0.1
56,Riserva del Nespolo,A,Republican Period,7,-350,-30,320,0.1
56,Riserva del Nespolo,A,Early Imperial Period,8,-30,100,130,0.1
56,Riserva del Nespolo,A,Mid-Imperial Period,9,100,300,200,0.1
56,Riserva del Nespolo,A,Late Imperial Period,10,300,400,100,0.1
57,Riserva Mattone,A,Republican Period,7,-350,-30,320,0.1
57,Riserva Mattone,A,Early Imperial Period,8,-30,100,130,0.1
57,Riserva Mattone,A,Mid-Imperial Period,9,100,300,200,0.1
57,Riserva Mattone,A,Late Imperial Period,10,300,400,100,0.1
58,Spinacceto,A,Late Iron Age,5,-600,-580,20,0.40000001
58,Spinacceto,A,Archaic Period,6,-580,-350,230,0.40000001
58,Spinacceto,B,Republican Period,7,-250,-30,220,0.40000001
58,Spinacceto,B,Early Imperial Period,8,-30,100,130,0.40000001
58,Spinacceto,B,Mid-Imperial Period,9,100,250,150,0.40000001
59,Spinacceto,A,Republican Period,7,-350,-30,320,0.1
59,Spinacceto,A,Early Imperial Period,8,-30,100,130,0.1
59,Spinacceto,A,Mid-Imperial Period,9,100,300,200,0.1
59,Spinacceto,A,Late Imperial Period,10,300,400,100,0.1
60,Pantano del'Intossicata,A,Republican Period,7,-350,-30,320,0.1
60,Pantano del'Intossicata,A,Early Imperial Period,8,-30,100,130,0.1
60,Pantano del'Intossicata,A,Mid-Imperial Period,9,100,300,200,0.1
60,Pantano del'Intossicata,A,Late Imperial Period,10,300,400,100,0.1
61,Orti Maoni / Intossicata,A,Late Iron Age,5,-600,-580,20,0.1
61,Orti Maoni / Intossicata,A,Archaic Period,6,-580,-500,80,0.1
61,Orti Maoni / Intossicata,B,Republican Period,7,-350,-30,320,0.1
62,Orti Maoni / Intossicata,A,Late Iron Age,5,-600,-580,20,0.69999999
62,Orti Maoni / Intossicata,A,Archaic Period,6,-580,-350,230,0.69999999
62,Orti Maoni / Intossicata,B,Republican Period,7,-250,-30,220,0.69999999
62,Orti Maoni / Intossicata,B,Early Imperial Period,8,-30,100,130,0.69999999
62,Orti Maoni / Intossicata,B,Mid-Imperial Period,9,100,250,150,0.69999999
63,unknown,A,Republican Period,7,-350,-30,320,0.1
63,unknown,A,Early Imperial Period,8,-30,100,130,0.1
63,unknown,A,Mid-Imperial Period,9,100,300,200,0.1
63,unknown,A,Late Imperial Period,10,300,400,100,0.1
64,Piscina della Farna,A,Republican Period,7,-350,-30,320,0.1
64,Piscina della Farna,A,Early Imperial Period,8,-30,100,130,0.1
64,Piscina della Farna,A,Mid-Imperial Period,9,100,300,200,0.1
64,Piscina della Farna,A,Late Imperial Period,10,300,400,100,0.1
65,Piscina della Farna,A,Late Iron Age,5,-700,-600,100,0.039999999
65,Piscina della Farna,B,Archaic Period,6,-500,-350,150,0.039999999
65,Piscina della Farna,C,Republican Period,7,-250,-30,220,0.039999999
65,Piscina della Farna,C,Early Imperial Period,8,-30,100,130,0.039999999
66,Piscina dell Farna,A,Republican Period,7,-350,-30,320,0.1
66,Piscina dell Farna,A,Early Imperial Period,8,-30,100,130,0.1
66,Piscina dell Farna,A,Mid-Imperial Period,9,100,300,200,0.1
66,Piscina dell Farna,A,Late Imperial Period,10,300,400,100,0.1
67,Tre Cancelli,A,Early Imperial Period,8,-30,100,130,0.1
67,Tre Cancelli,A,Mid-Imperial Period,9,100,250,150,0.1
68,Cadolino,A,Early Imperial Period,8,-30,100,130,0.1
68,Cadolino,A,Mid-Imperial Period,9,100,250,150,0.1
69,Cadolino,A,Early Imperial Period,8,-30,100,130,0.1
69,Cadolino,A,Mid-Imperial Period,9,100,250,150,0.1
70,Cadolino,A,Early Iron Age,4,-800,-750,50,1
70,Cadolino,A,Late Iron Age,5,-750,-700,50,1
70,Cadolino,B,Early Imperial Period,8,-30,100,130,1
70,Cadolino,B,Mid-Imperial Period,9,100,250,150,1
71,Ospedaletto,A,Late Iron Age,5,-600,-580,20,0.2
71,Ospedaletto,A,Archaic Period,6,-580,-350,230,0.2
71,Ospedaletto,B,Republican Period,7,-250,-30,220,0.2
71,Ospedaletto,B,Early Imperial Period,8,-30,100,130,0.2
71,Ospedaletto,B,Mid-Imperial Period,9,100,300,200,0.2
71,Ospedaletto,B,Late Imperial Period,10,300,400,100,0.2
72,Piscina Cardillo,A,Middle Bronze Age,2,-1700,-1300,400,0.2
72,Piscina Cardillo,A,Late Bronze Age,3,-1300,-1020,280,0.2
72,Piscina Cardillo,B,Late Iron Age,5,-600,-580,20,0.2
72,Piscina Cardillo,B,Archaic Period,6,-580,-350,230,0.2
72,Piscina Cardillo,B,Republican Period,7,-350,-30,320,0.2
72,Piscina Cardillo,B,Early Imperial Period,8,-30,100,130,0.2
72,Piscina Cardillo,B,Mid-Imperial Period,9,100,250,150,0.2
73,Campana,A,Middle Bronze Age,2,-1700,-1300,400,0.2
73,Campana,A,Late Bronze Age,3,-1300,-1020,280,0.2
74,Campana,A,Early Imperial Period,8,-30,100,130,0.1
74,Campana,A,Mid-Imperial Period,9,100,300,200,0.1
74,Campana,A,Late Imperial Period,10,300,400,100,0.1
75,Campana,A,Middle Bronze Age,2,-1700,-1350,350,1
76,Campana,A,Late Iron Age,5,-600,-580,20,1
76,Campana,A,Archaic Period,6,-580,-500,80,1
76,Campana,B,Republican Period,7,-350,-30,320,1
76,Campana,B,Early Imperial Period,8,-30,100,130,1
76,Campana,B,Mid-Imperial Period,9,100,300,200,1
76,Campana,B,Late Imperial Period,10,300,500,200,1
76,Campana,B,Late Antique Period,11,500,700,200,1
77,Campana,A,Republican Period,7,-100,-30,70,0.2
77,Campana,A,Early Imperial Period,8,-30,100,130,0.2
78,Torre del Monumento,A,Republican Period,7,-350,-100,250,0.40000001
78,Torre del Monumento,B,Early Imperial Period,8,-30,100,130,0.40000001
78,Torre del Monumento,B,Mid-Imperial Period,9,100,300,200,0.40000001
78,Torre del Monumento,B,Late Imperial Period,10,300,500,200,0.40000001
78,Torre del Monumento,B,Late Antique Period,11,500,600,100,0.40000001
79,Torre del Monumento,A,Archaic Period,6,-500,-350,150,0.1
79,Torre del Monumento,A,Republican Period,7,-350,-100,250,0.1
79,Torre del Monumento,B,Early Imperial Period,8,-30,100,130,0.1
79,Torre del Monumento,B,Mid-Imperial Period,9,100,250,150,0.1
80,,A,Republican Period,7,-350,-30,320,0.1
80,,A,Early Imperial Period,8,-30,100,130,0.1
80,,A,Mid-Imperial Period,9,100,300,200,0.1
80,,A,Late Imperial Period,10,300,400,100,0.1
81,Pineta della Campana,A,Late Iron Age,5,-700,-580,120,0.079999998
81,Pineta della Campana,A,Archaic Period,6,-580,-500,80,0.079999998
81,Pineta della Campana,B,Republican Period,7,-250,-30,220,0.079999998
81,Pineta della Campana,B,Early Imperial Period,8,-30,100,130,0.079999998
81,Pineta della Campana,B,Mid-Imperial Period,9,100,300,200,0.079999998
81,Pineta della Campana,B,Late Imperial Period,10,300,400,100,0.079999998
82,Pineta della Campana,A,Republican Period,7,-350,-30,320,0.1
82,Pineta della Campana,A,Early Imperial Period,8,-30,100,130,0.1
82,Pineta della Campana,A,Mid-Imperial Period,9,100,300,200,0.1
82,Pineta della Campana,A,Late Imperial Period,10,300,400,100,0.1
83,Campana,A,Early Iron Age,4,-800,-750,50,0.1
83,Campana,A,Late Iron Age,5,-750,-700,50,0.1
84,Piscina Cardillo,A,Early Iron Age,4,-800,-750,50,0.1
84,Piscina Cardillo,A,Late Iron Age,5,-750,-700,50,0.1
85,Campana,A,Late Iron Age,5,-600,-580,20,0.090000004
85,Campana,A,Archaic Period,6,-580,-350,230,0.090000004
86,Campana,A,Republican Period,7,-350,-30,320,0.1
86,Campana,A,Early Imperial Period,8,-30,100,130,0.1
86,Campana,A,Mid-Imperial Period,9,100,300,200,0.1
86,Campana,A,Late Imperial Period,10,300,400,100,0.1
87,Campana,A,Early Iron Age,4,-800,-750,50,0.80000001
87,Campana,A,Late Iron Age,5,-750,-700,50,0.80000001
87,Campana,B,Archaic Period,6,-500,-350,150,0.80000001
87,Campana,C,Republican Period,7,-250,-30,220,0.80000001
87,Campana,C,Early Imperial Period,8,-30,100,130,0.80000001
87,Campana,C,Mid-Imperial Period,9,100,250,150,0.80000001
88,Opsedaletto,A,Republican Period,7,-350,-30,320,0.1
88,Opsedaletto,A,Early Imperial Period,8,-30,100,130,0.1
88,Opsedaletto,A,Mid-Imperial Period,9,100,300,200,0.1
88,Opsedaletto,A,Late Imperial Period,10,300,400,100,0.1
89,Campana,A,Archaic Period,6,-500,-350,150,0.1
89,Campana,A,Republican Period,7,-350,-100,250,0.1
89,Campana,B,Mid-Imperial Period,9,100,250,150,0.1
90,Ospedaletto,A,Republican Period,7,-350,-30,320,0.1
90,Ospedaletto,A,Early Imperial Period,8,-30,100,130,0.1
90,Ospedaletto,A,Mid-Imperial Period,9,100,300,200,0.1
90,Ospedaletto,A,Late Imperial Period,10,300,400,100,0.1
91,Piscina Cardillo,A,Late Iron Age,5,-700,-600,100,0.1
92,Piscina Cardillo,A,Republican Period,7,-350,-30,320,0.1
92,Piscina Cardillo,A,Early Imperial Period,8,-30,100,130,0.1
92,Piscina Cardillo,A,Mid-Imperial Period,9,100,300,200,0.1
92,Piscina Cardillo,A,Late Imperial Period,10,300,400,100,0.1
93,Loricina,A,Early Iron Age,4,-800,-750,50,0.1
93,Loricina,A,Late Iron Age,5,-750,-700,50,0.1
94,Intossicata,A,Republican Period,7,-350,-30,320,0.1
94,Intossicata,A,Early Imperial Period,8,-30,100,130,0.1
94,Intossicata,A,Mid-Imperial Period,9,100,300,200,0.1
94,Intossicata,A,Late Imperial Period,10,300,400,100,0.1
95,Intossicata,A,Republican Period,7,-350,-30,320,0.1
95,Intossicata,A,Early Imperial Period,8,-30,100,130,0.1
95,Intossicata,A,Mid-Imperial Period,9,100,300,200,0.1
95,Intossicata,A,Late Imperial Period,10,300,400,100,0.1
96,I Marmi,A,Republican Period,7,-350,-30,320,0.1
97,Contrada Tinozzi,A,Republican Period,7,-350,-30,320,0.1
97,Contrada Tinozzi,A,Early Imperial Period,8,-30,100,130,0.1
97,Contrada Tinozzi,A,Mid-Imperial Period,9,100,300,200,0.1
97,Contrada Tinozzi,A,Late Imperial Period,10,300,400,100,0.1
98,Pantano Granieri,A,Republican Period,7,-350,-30,320,0.1
99,Nettuno,A,Republican Period,7,-350,-30,320,0.1
99,Nettuno,A,Early Imperial Period,8,-30,100,130,0.1
99,Nettuno,A,Mid-Imperial Period,9,100,300,200,0.1
99,Nettuno,A,Late Imperial Period,10,300,400,100,0.1
100,Nettuno,A,Republican Period,7,-350,-30,320,0.1
100,Nettuno,A,Early Imperial Period,8,-30,100,130,0.1
100,Nettuno,A,Mid-Imperial Period,9,100,300,200,0.1
100,Nettuno,A,Late Imperial Period,10,300,400,100,0.1
101,Loricina,A,Republican Period,7,-350,-30,320,0.1
101,Loricina,A,Early Imperial Period,8,-30,100,130,0.1
101,Loricina,A,Mid-Imperial Period,9,100,300,200,0.1
101,Loricina,A,Late Imperial Period,10,300,400,100,0.1
102,Nettuno,A,Republican Period,7,-350,-30,320,0.1
102,Nettuno,A,Early Imperial Period,8,-30,100,130,0.1
102,Nettuno,A,Mid-Imperial Period,9,100,300,200,0.1
102,Nettuno,A,Late Imperial Period,10,300,400,100,0.1
103,Nettuno,A,Republican Period,7,-350,-30,320,0.1
103,Nettuno,A,Early Imperial Period,8,-30,100,130,0.1
103,Nettuno,A,Mid-Imperial Period,9,100,300,200,0.1
103,Nettuno,A,Late Imperial Period,10,300,400,100,0.1
104,Nettuno,A,Republican Period,7,-350,-30,320,0.1
104,Nettuno,A,Early Imperial Period,8,-30,100,130,0.1
104,Nettuno,A,Mid-Imperial Period,9,100,300,200,0.1
104,Nettuno,A,Late Imperial Period,10,300,400,100,0.1
105,,A,Republican Period,7,-350,-30,320,0.1
105,,A,Early Imperial Period,8,-30,100,130,0.1
105,,A,Mid-Imperial Period,9,100,300,200,0.1
105,,A,Late Imperial Period,10,300,400,100,0.1
106,Campana,A,Republican Period,7,-350,-30,320,0.1
106,Campana,A,Early Imperial Period,8,-30,100,130,0.1
106,Campana,A,Mid-Imperial Period,9,100,300,200,0.1
106,Campana,A,Late Imperial Period,10,300,400,100,0.1
107,Campana,A,Republican Period,7,-350,-30,320,0.1
107,Campana,A,Early Imperial Period,8,-30,100,130,0.1
107,Campana,A,Mid-Imperial Period,9,100,300,200,0.1
107,Campana,A,Late Imperial Period,10,300,400,100,0.1
108,Campana,A,Middle Bronze Age,2,-1700,-1350,350,0.1
108,Campana,B,Late Iron Age,5,-700,-600,100,0.1
108,Campana,C,Archaic Period,6,-500,-350,150,0.1
108,Campana,C,Republican Period,7,-350,-30,320,0.1
112,Laghetto Granieri,A,Republican Period,7,-350,-30,320,0.1
112,Laghetto Granieri,A,Early Imperial Period,8,-30,100,130,0.1
112,Laghetto Granieri,A,Mid-Imperial Period,9,100,300,200,0.1
112,Laghetto Granieri,A,Late Imperial Period,10,300,400,100,0.1
113,Loricina,A,Republican Period,7,-100,-30,70,0.1
113,Loricina,A,Early Imperial Period,8,-30,100,130,0.1
113,Loricina,A,Mid-Imperial Period,9,100,250,150,0.1
114,Villa Borghese,A,Late Iron Age,5,-700,-580,120,0.1
114,Villa Borghese,A,Archaic Period,6,-580,-500,80,0.1
114,Villa Borghese,B,Republican Period,7,-350,-30,320,0.1
114,Villa Borghese,B,Early Imperial Period,8,-30,100,130,0.1
114,Villa Borghese,B,Mid-Imperial Period,9,100,250,150,0.1
115,Cerreto Regina Margherita,A,Early Iron Age,4,-800,-750,50,0.1
115,Cerreto Regina Margherita,A,Late Iron Age,5,-750,-600,150,0.1
116,,A,Early Iron Age,4,-800,-750,50,0.1
116,,A,Late Iron Age,5,-750,-600,150,0.1
117,Pantano Potassa,A,Early Iron Age,4,-800,-750,50,0.1
117,Pantano Potassa,A,Late Iron Age,5,-750,-600,150,0.1
118,Spinacceto,A,Late Iron Age,5,-600,-580,20,0.1
118,Spinacceto,A,Archaic Period,6,-580,-500,80,0.1
119,Campana,A,Middle Bronze Age,2,-1700,-1350,350,0.1
119,Campana,B,Early Imperial Period,8,-30,100,130,0.1
120,Campo Cerreto,A,Late Iron Age,5,-600,-580,20,0.1
120,Campo Cerreto,A,Archaic Period,6,-580,-500,80,0.1
121,Campana,A,Early Imperial Period,8,-30,100,130,0.1
121,Campana,A,Mid-Imperial Period,9,100,300,200,0.1
121,Campana,A,Late Imperial Period,10,300,400,100,0.1
122,Campana,A,Republican Period,7,-350,-100,250,1
123,Cadolino,A,Republican Period,7,-350,-30,320,0.2
123,Cadolino,A,Early Imperial Period,8,-30,100,130,0.2
123,Cadolino,A,Mid-Imperial Period,9,100,300,200,0.2
123,Cadolino,A,Late Imperial Period,10,300,400,100,0.2
124,I Cioccatti,A,Republican Period,7,-100,-30,70,0.1
124,I Cioccatti,A,Early Imperial Period,8,-30,100,130,0.1
124,I Cioccatti,A,Mid-Imperial Period,9,100,300,200,0.1
124,I Cioccatti,A,Late Imperial Period,10,300,400,100,0.1
125,I Cioccatti,A,Republican Period,7,-100,-30,70,0.1
125,I Cioccatti,A,Early Imperial Period,8,-30,100,130,0.1
125,I Cioccatti,A,Mid-Imperial Period,9,100,300,200,0.1
125,I Cioccatti,A,Late Imperial Period,10,300,400,100,0.1
126,I Cioccatti,A,Republican Period,7,-100,-30,70,0.1
126,I Cioccatti,A,Early Imperial Period,8,-30,100,130,0.1
126,I Cioccatti,A,Mid-Imperial Period,9,100,300,200,0.1
126,I Cioccatti,A,Late Imperial Period,10,300,400,100,0.1
127,I Cioccatti,A,Republican Period,7,-100,-30,70,0.1
127,I Cioccatti,A,Early Imperial Period,8,-30,100,130,0.1
127,I Cioccatti,A,Mid-Imperial Period,9,100,300,200,0.1
127,I Cioccatti,A,Late Imperial Period,10,300,400,100,0.1
128,I Cioccatti,A,Republican Period,7,-100,-30,70,0.1
128,I Cioccatti,A,Early Imperial Period,8,-30,100,130,0.1
128,I Cioccatti,A,Mid-Imperial Period,9,100,300,200,0.1
128,I Cioccatti,A,Late Imperial Period,10,300,400,100,0.1
129,I Cioccatti,A,Republican Period,7,-100,-30,70,0.1
129,I Cioccatti,A,Early Imperial Period,8,-30,100,130,0.1
129,I Cioccatti,A,Mid-Imperial Period,9,100,300,200,0.1
129,I Cioccatti,A,Late Imperial Period,10,300,400,100,0.1
130,Scopone,A,Late Iron Age,5,-700,-600,100,0.1
131,Scopone,A,Early Iron Age,4,-800,-750,50,0.01
131,Scopone,A,Late Iron Age,5,-750,-600,150,0.01
132,Zucchetti,A,Late Iron Age,5,-600,-580,20,0.40000001
132,Zucchetti,A,Archaic Period,6,-580,-350,230,0.40000001
132,Zucchetti,A,Republican Period,7,-350,-30,320,0.40000001
132,Zucchetti,A,Early Imperial Period,8,-30,100,130,0.40000001
132,Zucchetti,A,Mid-Imperial Period,9,100,250,150,0.40000001
133,Zucchetti,A,Early Iron Age,4,-800,-750,50,0.40000001
133,Zucchetti,A,Late Iron Age,5,-750,-600,150,0.40000001
133,Zucchetti,B,Republican Period,7,-100,-30,70,0.40000001
133,Zucchetti,B,Early Imperial Period,8,-30,100,130,0.40000001
133,Zucchetti,B,Mid-Imperial Period,9,100,250,150,0.40000001
133,Zucchetti,C,Late Imperial Period,10,400,500,100,0.40000001
134,,A,Early Iron Age,4,-800,-750,50,0.30000001
134,,A,Late Iron Age,5,-750,-580,170,0.30000001
134,,A,Archaic Period,6,-580,-350,230,0.30000001
134,,A,Republican Period,7,-350,-30,320,0.30000001
134,,A,Early Imperial Period,8,-30,100,130,0.30000001
135,Torre del Monumento,A,Republican Period,7,-100,-30,70,0.029999999
135,Torre del Monumento,A,Early Imperial Period,8,-30,100,130,0.029999999
135,Torre del Monumento,A,Mid-Imperial Period,9,100,250,150,0.029999999
136,Campana,A,Republican Period,7,-100,-30,70,0.1
136,Campana,A,Early Imperial Period,8,-30,100,130,0.1
136,Campana,A,Mid-Imperial Period,9,100,250,150,0.1
137,Campana,A,Early Iron Age,4,-800,-750,50,0.5
137,Campana,A,Late Iron Age,5,-750,-580,170,0.5
137,Campana,A,Archaic Period,6,-580,-500,80,0.5
137,Campana,B,Republican Period,7,-100,-30,70,0.5
137,Campana,B,Early Imperial Period,8,-30,100,130,0.5
137,Campana,B,Mid-Imperial Period,9,100,300,200,0.5
137,Campana,B,Late Imperial Period,10,300,500,200,0.5
138,Campana,A,Late Iron Age,5,-600,-580,20,0.2
138,Campana,A,Archaic Period,6,-580,-350,230,0.2
138,Campana,A,Republican Period,7,-350,-30,320,0.2
138,Campana,A,Early Imperial Period,8,-30,100,130,0.2
138,Campana,A,Mid-Imperial Period,9,100,250,150,0.2
139,Pelliccione,A,Middle Bronze Age,2,-1350,-1300,50,0.1
139,Pelliccione,A,Late Bronze Age,3,-1300,-1020,280,0.1
140,Depuratore,A,Early Iron Age,4,-800,-750,50,0.30000001
140,Depuratore,A,Late Iron Age,5,-750,-580,170,0.30000001
140,Depuratore,A,Archaic Period,6,-580,-500,80,0.30000001
140,Depuratore,B,Republican Period,7,-350,-30,320,0.30000001
141,Campana,A,Late Iron Age,5,-700,-600,100,0.02
141,Campana,B,Archaic Period,6,-500,-350,150,0.02
141,Campana,C,Early Imperial Period,8,-30,100,130,0.02
141,Campana,C,Mid-Imperial Period,9,100,250,150,0.02
142,Campana,A,Archaic Period,6,-500,-350,150,0.050000001
142,Campana,B,Republican Period,7,-100,-30,70,0.050000001
142,Campana,B,Early Imperial Period,8,-30,100,130,0.050000001
142,Campana,B,Mid-Imperial Period,9,100,250,150,0.050000001
143,Campana,A,Early Iron Age,4,-800,-750,50,0.1
143,Campana,B,Late Iron Age,5,-750,-580,170,0.1
143,Campana,B,Archaic Period,6,-580,-500,80,0.1
144,Campana,A,Republican Period,7,-100,-30,70,0.050000001
144,Campana,A,Early Imperial Period,8,-30,100,130,0.050000001
144,Campana,A,Mid-Imperial Period,9,100,250,150,0.050000001
145,Campana,A,Late Iron Age,5,-700,-580,120,0.5
145,Campana,A,Archaic Period,6,-580,-500,80,0.5
146,Piscina Cardillo,A,Early Iron Age,4,-800,-750,50,0.039999999
146,Piscina Cardillo,A,Late Iron Age,5,-750,-580,170,0.039999999
146,Piscina Cardillo,A,Archaic Period,6,-580,-500,80,0.039999999
147,Piscina Cardillo,A,Early Iron Age,4,-800,-750,50,0.1
147,Piscina Cardillo,A,Late Iron Age,5,-750,-580,170,0.1
147,Piscina Cardillo,A,Archaic Period,6,-580,-350,230,0.1
147,Piscina Cardillo,A,Republican Period,7,-350,-30,320,0.1
148,Rovito,A,Late Iron Age,5,-600,-580,20,0.1
148,Rovito,A,Archaic Period,6,-580,-500,80,0.1
148,Rovito,B,Republican Period,7,-350,-30,320,0.1
148,Rovito,B,Early Imperial Period,8,-30,100,130,0.1
148,Rovito,B,Mid-Imperial Period,9,100,250,150,0.1
149,Tre Cancelli,A,Early Iron Age,4,-800,-750,50,0.2
149,Tre Cancelli,A,Late Iron Age,5,-750,-600,150,0.2
150,Piscina Cardillo,A,Early Iron Age,4,-800,-750,50,0.2
150,Piscina Cardillo,A,Late Iron Age,5,-750,-700,50,0.2
151,Villa Verdiana/Scopone,A,Late Iron Age,5,-600,-580,20,0.1
151,Villa Verdiana/Scopone,A,Archaic Period,6,-580,-350,230,0.1
151,Villa Verdiana/Scopone,A,Republican Period,7,-350,-30,320,0.1
151,Villa Verdiana/Scopone,A,Early Imperial Period,8,-30,100,130,0.1
151,Villa Verdiana/Scopone,A,Mid-Imperial Period,9,100,250,150,0.1
152,Villa Borghese,A,Early Imperial Period,8,-30,100,130,0.1
153,Zucchetti,A,Late Iron Age,5,-700,-580,120,0.1
153,Zucchetti,A,Archaic Period,6,-580,-350,230,0.1
153,Zucchetti,A,Republican Period,7,-350,-30,320,0.1
153,Zucchetti,A,Early Imperial Period,8,-30,100,130,0.1
153,Zucchetti,A,Mid-Imperial Period,9,100,250,150,0.1
154,Nettuno,A,Early Imperial Period,8,-30,100,130,0.050000001
154,Nettuno,A,Mid-Imperial Period,9,100,250,150,0.050000001
155,Nettuno,A,Early Imperial Period,8,-30,100,130,0.029999999
155,Nettuno,A,Mid-Imperial Period,9,100,250,150,0.029999999
156,I Marmi,A,Republican Period,7,-100,-30,70,0.2
156,I Marmi,A,Early Imperial Period,8,-30,100,130,0.2
156,I Marmi,A,Mid-Imperial Period,9,100,250,150,0.2
157,Fosso Foglino,A,Early Bronze Age,1,-1750,-1700,50,0.1
157,Fosso Foglino,A,Middle Bronze Age,2,-1700,-1350,350,0.1
158,Le Grugnole,A,Middle Bronze Age,2,-1350,-1300,50,0.1
158,Le Grugnole,A,Late Bronze Age,3,-1300,-1020,280,0.1
159,Campana,A,Middle Bronze Age,2,-1700,-1300,400,0.1
159,Campana,A,Late Bronze Age,3,-1300,-1020,280,0.1
160,Bosco di Nettuno,A,Middle Bronze Age,2,-1700,-1300,400,0.1
160,Bosco di Nettuno,A,Late Bronze Age,3,-1300,-1020,280,0.1
161,Granieri,A,Middle Bronze Age,2,-1700,-1300,400,0.1
161,Granieri,A,Late Bronze Age,3,-1300,-1020,280,0.1
162,Sughereto,A,Middle Bronze Age,2,-1700,-1300,400,0.1
162,Sughereto,A,Late Bronze Age,3,-1300,-1020,280,0.1
163,,A,Late Iron Age,5,-600,-580,20,0.1
163,,A,Archaic Period,6,-580,-350,230,0.1
163,,A,Republican Period,7,-300,-30,270,0.1
164,Quarto del Cerrone,A,Late Iron Age,5,-600,-580,20,0.5
164,Quarto del Cerrone,A,Archaic Period,6,-580,-350,230,0.5
164,Quarto del Cerrone,B,Republican Period,7,-300,-30,270,0.5
165,Quarto del Cerrone,A,Late Iron Age,5,-600,-580,20,0.1
165,Quarto del Cerrone,A,Archaic Period,6,-580,-350,230,0.1
165,Quarto del Cerrone,A,Republican Period,7,-350,-30,320,0.1
165,Quarto del Cerrone,A,Early Imperial Period,8,-30,100,130,0.1
165,Quarto del Cerrone,A,Mid-Imperial Period,9,100,200,100,0.1
166,Quarto del Cerrone,A,Republican Period,7,-350,-30,320,0.02
166,Quarto del Cerrone,A,Early Imperial Period,8,-30,100,130,0.02
166,Quarto del Cerrone,A,Mid-Imperial Period,9,100,300,200,0.02
166,Quarto del Cerrone,A,Late Imperial Period,10,300,400,100,0.02
167,Quarto del Cerrone,A,Archaic Period,6,-500,-350,150,0.039999999
167,Quarto del Cerrone,A,Republican Period,7,-350,-30,320,0.039999999
168,Quarto del Cerrone,A,Late Iron Age,5,-600,-580,20,0.029999999
168,Quarto del Cerrone,A,Archaic Period,6,-580,-350,230,0.029999999
168,Quarto del Cerrone,A,Republican Period,7,-350,-30,320,0.029999999
169,Quarto delle Cinfonare,A,Late Iron Age,5,-600,-580,20,0.1
169,Quarto delle Cinfonare,A,Archaic Period,6,-580,-500,80,0.1
169,Quarto delle Cinfonare,B,Republican Period,7,-350,-30,320,0.1
169,Quarto delle Cinfonare,B,Early Imperial Period,8,-30,100,130,0.1
169,Quarto delle Cinfonare,B,Mid-Imperial Period,9,100,300,200,0.1
169,Quarto delle Cinfonare,B,Late Imperial Period,10,300,400,100,0.1
170,Quarto delle Cinfonare,A,Late Iron Age,5,-600,-580,20,0.80000001
170,Quarto delle Cinfonare,A,Archaic Period,6,-580,-350,230,0.80000001
170,Quarto delle Cinfonare,A,Republican Period,7,-350,-30,320,0.80000001
171,Casale Nuovo,A,Late Iron Age,5,-600,-580,20,0.44
171,Casale Nuovo,A,Archaic Period,6,-580,-500,80,0.44
172,,A,Late Iron Age,5,-600,-580,20,0.1
172,,A,Archaic Period,6,-580,-500,80,0.1
173,Quarto del Cerrone,A,Late Iron Age,5,-600,-580,20,0.1
173,Quarto del Cerrone,A,Archaic Period,6,-580,-500,80,0.1
174,Quarto del Cerrone,A,Archaic Period,6,-500,-350,150,0.1
174,Quarto del Cerrone,A,Republican Period,7,-350,-30,320,0.1
174,Quarto del Cerrone,A,Early Imperial Period,8,-30,100,130,0.1
175,Quarto del Cerrone,A,Republican Period,7,-350,-30,320,0.1
176,,A,Republican Period,7,-350,-30,320,0.1
177,,A,Late Iron Age,5,-600,-580,20,0.1
177,,A,Archaic Period,6,-580,-500,80,0.1
178,Spinacceto,A,Late Iron Age,5,-600,-580,20,0.1
178,Spinacceto,A,Archaic Period,6,-580,-500,80,0.1
178,Spinacceto,B,Republican Period,7,-350,-30,320,0.1
179,Fico Mancino,A,Archaic Period,6,-500,-350,150,0.1
179,Fico Mancino,A,Republican Period,7,-350,-30,320,0.1
180,Casale Nuovo,A,Archaic Period,6,-500,-350,150,0.1
180,Casale Nuovo,A,Republican Period,7,-350,-30,320,0.1
180,Casale Nuovo,A,Early Imperial Period,8,-30,100,130,0.1
180,Casale Nuovo,A,Mid-Imperial Period,9,100,250,150,0.1
181,Acciarella,A,Republican Period,7,-350,-30,320,0.1
182,,A,Archaic Period,6,-500,-350,150,0.1
182,,A,Republican Period,7,-350,-30,320,0.1
183,,A,Archaic Period,6,-500,-350,150,0.1
184,,A,Archaic Period,6,-500,-350,150,0.1
184,,A,Republican Period,7,-350,-30,320,0.1
184,,A,Early Imperial Period,8,-30,100,130,0.1
184,,A,Mid-Imperial Period,9,100,200,100,0.1
185,Colle Falcone,A,Republican Period,7,-200,-30,170,0.30000001
185,Colle Falcone,A,Early Imperial Period,8,-30,100,130,0.30000001
185,Colle Falcone,A,Mid-Imperial Period,9,100,200,100,0.30000001
186,Colle del Pero,A,Republican Period,7,-350,-200,150,0.1
186,,A,Early Imperial Period,8,-30,100,130,0.2
186,,A,Mid-Imperial Period,9,100,250,150,0.2
187,Colle del Pero,A,Republican Period,7,-350,-30,320,0.2
187,Colle del Pero,A,Early Imperial Period,8,-30,100,130,0.2
187,Colle del Pero,A,Mid-Imperial Period,9,100,250,150,0.2
188,Colle del Pero,A,Late Iron Age,5,-600,-580,20,0.1
188,Colle del Pero,A,Archaic Period,6,-580,-350,230,0.1
188,Colle del Pero,A,Republican Period,7,-350,-30,320,0.1
189,,A,Republican Period,7,-350,-30,320,0.2
189,,A,Early Imperial Period,8,-30,100,130,0.2
189,,A,Mid-Imperial Period,9,100,250,150,0.2
190,I Norcini,A,Republican Period,7,-350,-30,320,0.1
190,I Norcini,A,Early Imperial Period,8,-30,100,130,0.1
190,I Norcini,A,Mid-Imperial Period,9,100,250,150,0.1
191,S. Antonio,A,Archaic Period,6,-500,-350,150,0.1
191,S. Antonio,A,Republican Period,7,-350,-30,320,0.1
191,S. Antonio,A,Early Imperial Period,8,-30,100,130,0.1
192,,A,Archaic Period,6,-500,-350,150,0.1
192,,A,Republican Period,7,-350,-30,320,0.1
192,,A,Early Imperial Period,8,-30,100,130,0.1
192,,A,Mid-Imperial Period,9,100,250,150,0.1
193,Canneto di Rodi,A,Archaic Period,6,-500,-350,150,0.1
193,Canneto di Rodi,A,Republican Period,7,-350,-30,320,0.1
193,Canneto di Rodi,A,Early Imperial Period,8,-30,100,130,0.1
194,Canneto di Rodi,A,Late Iron Age,5,-600,-580,20,0.1
194,Canneto di Rodi,A,Archaic Period,6,-580,-350,230,0.1
194,Canneto di Rodi,A,Republican Period,7,-350,-30,320,0.1
194,,A,Early Imperial Period,8,-30,100,130,0.1
194,,A,Mid-Imperial Period,9,100,250,150,0.1
195,Canneto di Rodi,A,Archaic Period,6,-500,-350,150,0.1
195,Canneto di Rodi,A,Republican Period,7,-350,-30,320,0.1
195,Canneto di Rodi,A,Early Imperial Period,8,-30,100,130,0.1
195,Canneto di Rodi,A,Mid-Imperial Period,9,100,250,150,0.1
196,,A,Archaic Period,6,-500,-350,150,0.1
196,,A,Republican Period,7,-350,-30,320,0.1
197,,A,Archaic Period,6,-500,-350,150,0.1
197,,A,Republican Period,7,-350,-30,320,0.1
197,,A,Early Imperial Period,8,-30,100,130,0.1
198,,A,Republican Period,7,-350,-30,320,0.1
198,,A,Early Imperial Period,8,-30,100,130,0.1
198,,A,Mid-Imperial Period,9,100,300,200,0.1
198,,A,Late Imperial Period,10,300,400,100,0.1
199,Castelverde,A,Late Iron Age,5,-600,-580,20,0.1
199,Castelverde,A,Archaic Period,6,-580,-350,230,0.1
200,,A,Late Iron Age,5,-600,-580,20,0.1
200,,A,Archaic Period,6,-580,-350,230,0.1
200,,A,Republican Period,7,-350,-30,320,0.1
201,,A,Archaic Period,6,-500,-350,150,0.1
201,,B,Republican Period,7,-350,-30,320,0.1
202,,A,Archaic Period,6,-500,-350,150,0.1
202,,A,Republican Period,7,-350,-30,320,0.1
203,Moscarello,A,Archaic Period,6,-500,-350,150,0.1
203,Moscarello,A,Republican Period,7,-350,-30,320,0.1
204,Macchia Grande,A,Archaic Period,6,-500,-350,150,0.1
204,Macchia Grande,A,Republican Period,7,-350,-30,320,0.1
205,,A,Archaic Period,6,-500,-350,150,0.1
205,,A,Republican Period,7,-350,-30,320,0.1
205,,A,Early Imperial Period,8,-30,100,130,0.1
205,,A,Mid-Imperial Period,9,100,250,150,0.1
206,Macchia Grande,A,Archaic Period,6,-500,-350,150,0.1
206,Macchia Grande,A,Republican Period,7,-350,-30,320,0.1
206,Macchia Grande,A,Early Imperial Period,8,-30,100,130,0.1
207,,A,Archaic Period,6,-500,-350,150,0.1
207,,A,Republican Period,7,-350,-30,320,0.1
207,,A,Early Imperial Period,8,-30,100,130,0.1
208,,A,Archaic Period,6,-500,-350,150,0.1
208,,B,Republican Period,7,-200,-30,170,0.1
208,,B,Early Imperial Period,8,-30,100,130,0.1
209,,A,Late Iron Age,5,-600,-580,20,0.1
209,,A,Archaic Period,6,-580,-350,230,0.1
209,,A,Republican Period,7,-350,-30,320,0.1
210,,A,Late Iron Age,5,-600,-580,20,0.1
210,,A,Archaic Period,6,-580,-350,230,0.1
210,,A,Republican Period,7,-350,-30,320,0.1
211,,A,Mid-Imperial Period,9,100,250,150,0.1
212,Borgo Sabotino,A,Archaic Period,6,-500,-350,150,0.1
212,Borgo Sabotino,A,Republican Period,7,-350,-30,320,0.1
212,Borgo Sabotino,A,Early Imperial Period,8,-30,100,130,0.1
213,,A,Late Iron Age,5,-600,-580,20,0.1
213,,A,Archaic Period,6,-580,-500,80,0.1
213,,B,Early Imperial Period,8,-30,100,130,0.1
214,,A,Early Imperial Period,8,-30,100,130,0.1
215,La Fibbia,A,Archaic Period,6,-500,-350,150,0.1
215,La Fibbia,A,Republican Period,7,-350,-30,320,0.1
216,La Fibbia,A,Late Iron Age,5,-600,-580,20,0.1
216,La Fibbia,A,Archaic Period,6,-580,-500,80,0.1
217,,A,Archaic Period,6,-500,-350,150,0.1
217,,A,Republican Period,7,-350,-30,320,0.1
218,Cannucceto,A,Republican Period,7,-350,-30,320,0.1
218,Cannucceto,A,Early Imperial Period,8,-30,100,130,0.1
218,Cannucceto,A,Mid-Imperial Period,9,100,250,150,0.1
219,Antium,A,Early Iron Age,4,-1020,-750,270,26
219,Antium,A,Late Iron Age,5,-750,-580,170,26
219,Antium,A,Archaic Period,6,-580,-350,230,15
219,Antium,A,Republican Period,7,-350,-30,320,15
219,Antium,A,Early Imperial Period,8,-30,100,130,55
219,Antium,A,Mid-Imperial Period,9,100,300,200,55
219,Antium,A,Late Imperial Period,10,300,400,100,55
220,Borgo le Ferriere (Satricum),A,Late Iron Age,5,-700,-580,120,35
220,Borgo le Ferriere (Satricum),A,Archaic Period,6,-580,-350,230,20
220,Borgo le Ferriere (Satricum),A,Republican Period,7,-350,-30,320,8
220,Borgo le Ferriere (Satricum),A,Early Imperial Period,8,-30,100,130,3
220,Borgo le Ferriere (Satricum),A,Mid-Imperial Period,9,100,300,200,3
220,Borgo le Ferriere (Satricum),A,Late Imperial Period,10,300,500,200,3
220,Borgo le Ferriere (Satricum),A,Late Antique Period,11,500,700,200,3
221,Casale,A,Archaic Period,6,-500,-350,150,0.1
221,Casale,A,Republican Period,7,-350,-30,320,0.1
221,Casale,A,Early Imperial Period,8,-30,100,130,0.1
222,Costa Casale,A,Late Iron Age,5,-600,-580,20,0.1
222,Costa Casale,A,Archaic Period,6,-580,-350,230,0.1
222,Costa Casale,A,Republican Period,7,-350,-30,320,0.1
223,,A,Late Iron Age,5,-600,-580,20,0.2
223,,A,Archaic Period,6,-580,-350,230,0.2
223,,A,Republican Period,7,-350,-30,320,0.2
224,,A,Early Iron Age,4,-1020,-750,270,0.1
224,,A,Late Iron Age,5,-750,-580,170,0.1
224,,A,Archaic Period,6,-580,-500,80,0.1
225,,A,Late Iron Age,5,-600,-580,20,0.1
225,,A,Archaic Period,6,-580,-350,230,0.1
225,,A,Republican Period,7,-350,-30,320,0.1
226,Pezze di Ninfa,A,Late Iron Age,5,-600,-580,20,0.1
226,Pezze di Ninfa,A,Archaic Period,6,-580,-350,230,0.1
226,Pezze di Ninfa,A,Republican Period,7,-350,-30,320,0.1
226,Pezze di Ninfa,A,Early Imperial Period,8,-30,100,130,0.1
226,Pezze di Ninfa,A,Mid-Imperial Period,9,100,200,100,0.1
227,Fossateglio,A,Late Iron Age,5,-600,-580,20,0.02
227,Fossateglio,A,Archaic Period,6,-580,-350,230,0.02
227,Fossateglio,A,Republican Period,7,-350,-30,320,0.02
228,,A,Late Iron Age,5,-600,-580,20,0.1
228,,A,Archaic Period,6,-580,-350,230,0.1
229,Pezze di Ninfa,A,Late Iron Age,5,-600,-580,20,0.2
229,Pezze di Ninfa,A,Archaic Period,6,-580,-350,230,0.2
229,Pezze di Ninfa,A,Republican Period,7,-350,-30,320,0.2
230,Pezze di Ninfa,A,Late Iron Age,5,-600,-580,20,0.15000001
230,Pezze di Ninfa,A,Archaic Period,6,-580,-500,80,0.15000001
231,,A,Late Iron Age,5,-600,-580,20,4
231,,A,Archaic Period,6,-580,-350,230,4
231,,A,Republican Period,7,-350,-30,320,4
231,,A,Early Imperial Period,8,-30,100,130,4
231,,A,Mid-Imperial Period,9,100,250,150,4
232,Pezze di Ninfa,A,Late Iron Age,5,-600,-580,20,0.1
232,Pezze di Ninfa,A,Archaic Period,6,-580,-350,230,0.1
232,Pezze di Ninfa,A,Republican Period,7,-350,-30,320,0.1
232,Pezze di Ninfa,A,Early Imperial Period,8,-30,100,130,0.1
232,Pezze di Ninfa,A,Mid-Imperial Period,9,100,200,100,0.1
233,,A,Late Iron Age,5,-600,-580,20,0.12
233,,A,Archaic Period,6,-580,-350,230,0.12
233,,A,Republican Period,7,-350,-30,320,0.12
233,,A,Early Imperial Period,8,30,100,70,0.12
234,,A,Early Iron Age,4,-1020,-750,270,0.050000001
234,,A,Late Iron Age,5,-750,-600,150,0.050000001
235,,A,Late Iron Age,5,-600,-580,20,0.1
235,,A,Archaic Period,6,-580,-350,230,0.1
235,,A,Republican Period,7,-350,-30,320,0.1
235,,A,Early Imperial Period,8,-30,100,130,0.1
236,,A,Late Iron Age,5,-600,-580,20,0.1
236,,A,Archaic Period,6,-580,-500,80,0.1
238,,A,Late Iron Age,5,-600,-580,20,0.12
238,,A,Archaic Period,6,-580,-350,230,0.12
238,,A,Republican Period,7,-350,-30,320,0.12
238,,A,Early Imperial Period,8,-30,100,130,0.12
239,,A,Late Iron Age,5,-600,-580,20,0.1
239,,A,Archaic Period,6,-580,-500,80,0.1
240,Serrone di Bove,A,Late Iron Age,5,-600,-580,20,0.80000001
240,Serrone di Bove,A,Archaic Period,6,-580,-350,230,0.80000001
241,Serrone di Bove,A,Late Iron Age,5,-600,-580,20,0.1
241,Serrone di Bove,A,Archaic Period,6,-580,-500,80,0.1
242,Capanna la Pezza,A,Late Iron Age,5,-700,-580,120,0.30000001
242,Capanna la Pezza,A,Archaic Period,6,-580,-350,230,0.30000001
242,Capanna la Pezza,A,Republican Period,7,-350,-30,320,0.30000001
242,Capanna la Pezza,A,Early Imperial Period,8,-30,100,130,0.30000001
242,Capanna la Pezza,A,Mid-Imperial Period,9,100,200,100,0.30000001
243,,A,Late Iron Age,5,-600,-580,20,0.1
243,,A,Archaic Period,6,-580,-500,80,0.1
244,,A,Late Iron Age,5,-600,-580,20,0.1
244,,A,Archaic Period,6,-580,-500,80,0.1
244,,B,Republican Period,7,-350,-30,320,0.1
245,,A,Early Iron Age,4,-1020,-750,270,0.1
245,,A,Late Iron Age,5,-750,-580,170,0.1
245,,A,Archaic Period,6,-580,-350,230,0.1
245,,A,Republican Period,7,-350,-30,320,0.1
246,,A,Late Iron Age,5,-600,-580,20,0.2
246,,A,Archaic Period,6,-580,-500,80,0.2
247,,A,Early Iron Age,4,-1020,-750,270,1
247,,A,Late Iron Age,5,-750,-580,170,1
247,,A,Archaic Period,6,-580,-500,80,1
247,,B,Republican Period,7,-350,-30,320,1
247,,B,Early Imperial Period,8,-30,100,130,1
247,,B,Mid-Imperial Period,9,100,300,200,1
247,,B,Late Imperial Period,10,300,400,100,1
248,Stazione di Norma,A,Late Iron Age,5,-700,-580,120,1
248,Stazione di Norma,A,Archaic Period,6,-580,-350,230,1
248,Stazione di Norma,A,Republican Period,7,-350,-30,320,1
248,Stazione di Norma,A,Early Imperial Period,8,-30,100,130,1
248,Stazione di Norma,A,Mid-Imperial Period,9,100,200,100,1
249,,A,Late Iron Age,5,-700,-600,100,0.039999999
250,,A,Late Iron Age,5,-700,-580,120,0.1
250,,A,Archaic Period,6,-580,-500,80,0.1
251,,A,Late Iron Age,5,-600,-580,20,0.1
251,,A,Archaic Period,6,-580,-350,230,0.1
251,,A,Republican Period,7,-350,-30,320,0.1
251,,A,Early Imperial Period,8,-30,100,130,0.1
251,,A,Mid-Imperial Period,9,100,200,100,0.1
252,,A,Late Iron Age,5,-600,-580,20,0.1
252,,A,Archaic Period,6,-580,-350,230,0.1
252,,A,Republican Period,7,-350,-30,320,0.1
253,Colle Gentile,A,Late Iron Age,5,-600,-580,20,0.1
253,Colle Gentile,A,Archaic Period,6,-580,-350,230,0.1
253,Colle Gentile,A,Republican Period,7,-350,-30,320,0.1
254,,A,Late Iron Age,5,-600,-580,20,0.1
254,,A,Archaic Period,6,-580,-350,230,0.1
254,,B,Republican Period,7,-350,-30,320,0.1
255,,A,Late Iron Age,5,-600,-580,20,0.5
255,,A,Archaic Period,6,-580,-350,230,0.5
255,,A,Republican Period,7,-350,-30,320,0.5
256,,A,Late Iron Age,5,-600,-580,20,0.039999999
256,,A,Archaic Period,6,-580,-350,230,0.039999999
256,,A,Republican Period,7,-350,-30,320,0.039999999
257,,A,Late Iron Age,5,-600,-580,20,0.2
257,,A,Archaic Period,6,-580,-350,230,0.2
257,,A,Republican Period,7,-350,-30,320,0.2
258,Sorgenti Sulfuree,A,Late Iron Age,5,-600,-580,20,0.1
258,Sorgenti Sulfuree,A,Archaic Period,6,-580,-500,80,0.1
259,Monticchio,A,Late Iron Age,5,-600,-580,20,0.1
259,Monticchio,A,Archaic Period,6,-580,-350,230,0.1
259,Monticchio,A,Republican Period,7,-350,-30,320,0.1
259,Monticchio,A,Early Imperial Period,8,-30,100,130,0.1
259,Monticchio,A,Mid-Imperial Period,9,100,200,100,0.1
260,Contrada Casali,A,Late Iron Age,5,-600,-580,20,8.5
260,Contrada Casali,A,Archaic Period,6,-580,-350,230,8.5
260,Contrada Casali,A,Republican Period,7,-350,-30,320,8.5
261,Pozzo Picchioni,A,Republican Period,7,-350,-30,320,1
262,Vigne Vecchie,A,Early Imperial Period,8,-30,100,130,0.1
262,Vigne Vecchie,A,Mid-Imperial Period,9,100,300,200,0.1
262,Vigne Vecchie,A,Late Imperial Period,10,300,400,100,0.1
263,Fossateglio,A,Republican Period,7,-350,-30,320,0.1
263,Fossateglio,A,Early Imperial Period,8,-30,100,130,0.1
263,Fossateglio,A,Mid-Imperial Period,9,100,300,200,0.1
263,Fossateglio,A,Late Imperial Period,10,300,400,100,0.1
264,Quarto Grande,A,Early Imperial Period,8,-30,100,130,0.30000001
265,Castellone b,A,Republican Period,7,-350,-30,320,3
266,Castellone,A,Republican Period,7,-350,-30,320,0.1
267,Doganella,A,Republican Period,7,-350,-30,320,0.1
267,Doganella,A,Early Imperial Period,8,-30,100,130,0.1
268,,A,Republican Period,7,-350,-30,320,0.1
269,,A,Republican Period,7,-350,-30,320,0.1
270,Pezze di Ninfa,A,Republican Period,7,-350,-30,320,0.1
271,Pozzo del Rosario,A,Archaic Period,6,-500,-350,150,0.1
271,Pozzo del Rosario,A,Republican Period,7,-350,-30,320,0.1
272,Serrone di Bove,A,Republican Period,7,-350,-30,320,0.1
273,,A,Republican Period,7,-350,-30,320,0.5
273,,A,Early Imperial Period,8,-30,100,130,0.5
274,"Vado La Mola, Pallanti",A,Republican Period,7,-350,-30,320,0.2
275,,A,Late Iron Age,5,-600,-580,20,0.1
275,,A,Archaic Period,6,-580,-350,230,0.1
276,,A,Republican Period,7,-350,-30,320,0.1
277,Contrada Trentossa,A,Archaic Period,6,-500,-350,150,0.1
277,Contrada Trentossa,A,Republican Period,7,-350,-30,320,0.1
278,Caracupa-Valvisciolo,A,Early Iron Age,4,-800,-750,50,48
278,Caracupa-Valvisciolo,A,Late Iron Age,5,-750,-580,170,30
278,Caracupa-Valvisciolo,A,Archaic Period,6,-580,-350,230,4
278,Caracupa-Valvisciolo,A,Republican Period,7,-350,-30,320,10
278,Caracupa-Valvisciolo,A,Early Imperial Period,8,-30,100,130,10
279,Norba,A,Archaic Period,6,-500,-350,150,38
279,Norba,A,Republican Period,7,-350,-30,320,38
279,Norba,A,Early Imperial Period,8,-30,100,130,20
280,Stazione di Norma/Ninfa,A,Late Iron Age,5,-700,-580,120,0.2
280,Stazione di Norma/Ninfa,A,Archaic Period,6,-580,-350,230,0.2
280,Stazione di Norma/Ninfa,A,Republican Period,7,-350,-30,320,0.2
280,Stazione di Norma/Ninfa,A,Early Imperial Period,8,-30,100,130,0.2
280,Stazione di Norma/Ninfa,A,Mid-Imperial Period,9,100,200,100,0.2
281,Capanna La Pezza,A,Late Iron Age,5,-600,-580,20,0.30000001
281,Capanna La Pezza,A,Archaic Period,6,-580,-350,230,0.30000001
281,Capanna La Pezza,A,Republican Period,7,-350,-30,320,0.30000001
281,Capanna La Pezza,A,Early Imperial Period,8,-30,100,130,0.30000001
281,Capanna La Pezza,A,Mid-Imperial Period,9,100,200,100,0.30000001
282,Capanna del Marchese,A,Late Iron Age,5,-600,-580,20,0.1
282,Capanna del Marchese,A,Archaic Period,6,-580,-500,80,0.1
283,,A,Late Iron Age,5,-600,-580,20,0.1
283,,A,Archaic Period,6,-580,-500,80,0.1
284,Colle dei Tufi,A,Republican Period,7,-250,-100,150,0.2
284,Colle dei Tufi,B,Mid-Imperial Period,9,100,200,100,0.2
285,Doganella,A,Early Imperial Period,8,-30,100,130,0.52999997
285,Doganella,A,Mid-Imperial Period,9,100,200,100,0.52999997
286,Muro Pocoraro,A,Republican Period,7,-100,-30,70,0.15000001
286,Muro Pocoraro,A,Early Imperial Period,8,-30,100,130,0.15000001
286,Muro Pocoraro,A,Mid-Imperial Period,9,100,200,100,0.15000001
287,Doganella,A,Late Iron Age,5,-600,-580,20,0.40000001
287,Doganella,A,Archaic Period,6,-580,-350,230,0.40000001
287,Doganella,A,Republican Period,7,-350,-30,320,0.40000001
287,Doganella,A,Early Imperial Period,8,-30,100,130,0.40000001
287,Doganella,A,Mid-Imperial Period,9,100,200,100,0.40000001
288,Doganella,A,Republican Period,7,-250,-30,220,0.079999998
289,,A,Late Iron Age,5,-600,-580,20,0.5
289,,A,Archaic Period,6,-580,-500,80,0.5
289,Doganella,A,Republican Period,7,-250,-30,220,0.1
289,,B,Early Imperial Period,8,-30,100,130,0.5
289,,B,Mid-Imperial Period,9,100,200,100,0.5
290,Doganella,A,Early Imperial Period,8,-30,100,130,0.1
290,Doganella,A,Mid-Imperial Period,9,100,200,100,0.1
291,,A,Late Iron Age,5,-600,-580,20,0.2
291,,A,Archaic Period,6,-580,-350,230,0.2
291,,A,Republican Period,7,-350,-30,320,0.2
291,,A,Early Imperial Period,8,-30,100,130,0.2
291,,A,Mid-Imperial Period,9,100,200,100,0.2
292,,A,Archaic Period,6,-500,-350,150,0.2
292,,A,Republican Period,7,-350,-30,320,0.2
292,,A,Early Imperial Period,8,-30,100,130,0.2
292,,A,Mid-Imperial Period,9,100,200,100,0.2
293,,A,Archaic Period,6,-500,-350,150,0.30000001
293,,A,Republican Period,7,-350,-30,320,0.30000001
293,,A,Early Imperial Period,8,-30,100,130,0.30000001
294,,A,Republican Period,7,-250,-30,220,0.2
294,,A,Early Imperial Period,8,-30,100,130,0.2
295,Passo di San Donato,A,Republican Period,7,-100,-30,70,0.2
295,Passo di San Donato,A,Early Imperial Period,8,-30,100,130,0.2
295,Passo di San Donato,A,Mid-Imperial Period,9,100,300,200,0.2
295,Passo di San Donato,A,Late Imperial Period,10,300,400,100,0.2
296,Lestra della Vecchia Dispoensa,A,Republican Period,7,-200,-30,170,0.1
296,Lestra della Vecchia Dispoensa,A,Early Imperial Period,8,-30,100,130,0.1
296,Lestra della Vecchia Dispoensa,A,Mid-Imperial Period,9,100,200,100,0.1
297,Bonifica Torre di Padiglione,A,Archaic Period,6,-500,-350,150,0.40000001
297,Bonifica Torre di Padiglione,A,Republican Period,7,-350,-30,320,0.40000001
298,Bonifica Torre di Padiglione,A,Archaic Period,6,-500,-350,150,0.2
298,Bonifica Torre di Padiglione,A,Republican Period,7,-350,-30,320,0.2
298,Bonifica Torre di Padiglione,A,Early Imperial Period,8,-30,100,130,0.2
298,Bonifica Torre di Padiglione,A,Mid-Imperial Period,9,100,200,100,0.2
299,Bonifica Torre di Padiglione,A,Early Imperial Period,8,-30,100,130,0.1
299,Bonifica Torre di Padiglione,A,Mid-Imperial Period,9,100,200,100,0.1
300,Bonifica Torre di Padiglione,A,Republican Period,7,-100,-30,70,0.2
301,Bonifica Torre di Padiglione,A,Archaic Period,6,-500,-350,150,0.40000001
301,Bonifica Torre di Padiglione,A,Republican Period,7,-350,-30,320,0.40000001
302,Bonifica Torre di Padiglione,A,Archaic Period,6,-500,-350,150,0.2
302,Bonifica Torre di Padiglione,A,Republican Period,7,-350,-30,320,0.2
303,Riserva Pedata Chuisa,A,Late Iron Age,5,-700,-580,120,2
303,Riserva Pedata Chuisa,A,Archaic Period,6,-580,-500,80,2
303,Riserva Pedata Chuisa,B,Republican Period,7,-200,-30,170,2
303,Riserva Pedata Chuisa,B,Early Imperial Period,8,-30,100,130,2
304,Riserva Pantan d'Amici,A,Late Iron Age,5,-700,-580,120,1
304,Riserva Pantan d'Amici,A,Archaic Period,6,-580,-350,230,1
304,Riserva Pantan d'Amici,A,Republican Period,7,-350,-30,320,1
305,Riserva Pantan d'Amici,A,Late Iron Age,5,-600,-580,20,0.2
305,Riserva Pantan d'Amici,A,Archaic Period,6,-580,-350,230,0.2
305,Riserva Pantan d'Amici,A,Republican Period,7,-350,-30,320,0.2
306,,A,Republican Period,7,-350,-30,320,0.1
306,,A,Early Imperial Period,8,-30,100,130,0.1
306,,A,Mid-Imperial Period,9,100,300,200,0.1
306,,A,Late Imperial Period,10,300,400,100,0.1
307,Lubro,A,Late Iron Age,5,-600,-580,20,0.5
307,Lubro,A,Archaic Period,6,-580,-350,230,0.5
307,Lubro,A,Republican Period,7,-350,-30,320,0.5
307,Lubro,A,Early Imperial Period,8,-30,100,130,0.5
307,Lubro,A,Mid-Imperial Period,9,100,300,200,0.5
307,Lubro,A,Late Imperial Period,10,300,500,200,0.5
308,12945 Casa Gaetanaccio,A,Republican Period,7,-350,-30,320,0.1
309,Campo di Segni I,A,Republican Period,7,-350,-30,320,0.30000001
309,Campo di Segni I,A,Early Imperial Period,8,-30,100,130,0.30000001
309,Campo di Segni I,A,Mid-Imperial Period,9,100,300,200,0.30000001
309,Campo di Segni I,A,Late Imperial Period,10,300,400,100,0.30000001
310,,A,Early Iron Age,4,-800,-750,50,0.30000001
310,,A,Late Iron Age,5,-750,-580,170,0.30000001
310,,A,Archaic Period,6,-580,-350,230,0.30000001
310,,A,Republican Period,7,-350,-30,320,0.30000001
310,,A,Early Imperial Period,8,-30,100,130,0.30000001
310,,A,Mid-Imperial Period,9,100,300,200,0.30000001
310,,A,Late Imperial Period,10,300,400,100,0.30000001
311,,A,Republican Period,7,-350,-30,320,4
311,,A,Early Imperial Period,8,-30,100,130,4
311,,A,Mid-Imperial Period,9,100,300,200,4
311,,A,Late Imperial Period,10,300,400,100,4
312,I Casali,A,Republican Period,7,-350,-30,320,1.3
313,I Campanelli,A,Republican Period,7,-350,-30,320,0.1
314,La Vetica,A,Republican Period,7,-350,-30,320,1.3
314,La Vetica,A,Early Imperial Period,8,-30,100,130,1.3
314,La Vetica,A,Mid-Imperial Period,9,100,300,200,1.3
314,La Vetica,A,Late Imperial Period,10,300,400,100,1.3
315,Valle Cisterna 2,A,Republican Period,7,-350,-30,320,0.1
316,Arcellone / Valle Cisterna 1,A,Republican Period,7,-350,-30,320,0.40000001
316,Arcellone / Valle Cisterna 1,A,Early Imperial Period,8,-30,100,130,0.40000001
316,Arcellone / Valle Cisterna 1,A,Mid-Imperial Period,9,100,300,200,0.40000001
316,Arcellone / Valle Cisterna 1,A,Late Imperial Period,10,300,400,100,0.40000001
317,Valle Cisterna 3,A,Republican Period,7,-350,-30,320,0.1
318,Valle Cisterna 4,A,Republican Period,7,-350,-30,320,0.1
318,Valle Cisterna 4,A,Early Imperial Period,8,-30,100,130,0.1
318,Valle Cisterna 4,A,Mid-Imperial Period,9,100,300,200,0.1
318,Valle Cisterna 4,A,Late Imperial Period,10,300,400,100,0.1
319,Collemezzo,A,Republican Period,7,-350,-30,320,0.2
319,Collemezzo,A,Early Imperial Period,8,-30,100,130,0.2
319,Collemezzo,A,Mid-Imperial Period,9,100,300,200,0.2
319,Collemezzo,A,Late Imperial Period,10,300,400,100,0.2
320,Muro Antico,A,Republican Period,7,-350,-30,320,0.1
321,,A,Republican Period,7,-350,-30,320,0.1
322,Pian Della Croce,A,Republican Period,7,-350,-30,320,0.1
322,Pian Della Croce,A,Early Imperial Period,8,-30,100,130,0.1
322,Pian Della Croce,A,Mid-Imperial Period,9,100,300,200,0.1
322,Pian Della Croce,A,Late Imperial Period,10,300,400,100,0.1
323,Monte Locca dei Pellecini 2,A,Republican Period,7,-350,-30,320,0.1
324,Monte Locca dei Pellecini 1,A,Republican Period,7,-350,-30,320,0.2
324,Monte Locca dei Pellecini 2,A,Early Imperial Period,8,-30,100,130,0.1
324,Monte Locca dei Pellecini 2,A,Mid-Imperial Period,9,100,300,200,0.1
324,Monte Locca dei Pellecini 2,A,Late Imperial Period,10,300,400,100,0.1
325,Fontana del Prato,A,Republican Period,7,-350,-30,320,0.2
326,Prato di San Iaco,A,Republican Period,7,-350,-30,320,0.1
327,Ospedaletto I,A,Middle Bronze Age,2,-1700,-1300,400,0.1
327,Ospedaletto I,A,Late Bronze Age,3,-1300,-1020,280,0.1
327,Ospedaletto I,A,Early Iron Age,4,-1020,-800,220,0.1
328,Volubro,A,Republican Period,7,-350,-30,320,0.1
329,Le Caravelle,A,Republican Period,7,-350,-30,320,0.1
330,Serrone di Bove,A,Early Iron Age,4,-800,-750,50,0.1
330,Serrone di Bove,A,Late Iron Age,5,-750,-580,170,0.1
330,Serrone di Bove,A,Archaic Period,6,-580,-350,230,0.1
331,Serrone di Bove 2,A,Republican Period,7,-350,-30,320,0.1
331,Serrone di Bove 2,A,Early Imperial Period,8,-30,100,130,0.1
331,Serrone di Bove 2,A,Mid-Imperial Period,9,100,300,200,0.1
331,Serrone di Bove 2,A,Late Imperial Period,10,300,400,100,0.1
332,Le Murella,A,Republican Period,7,-350,-30,320,0.5
333,Colle Ferrato,A,Middle Bronze Age,2,-1700,-1300,400,2
333,Colle Ferrato,A,Late Bronze Age,3,-1300,-1020,280,2
333,Colle Ferrato,A,Early Iron Age,4,-1020,-750,270,2
333,Colle Ferrato,A,Late Iron Age,5,-750,-580,170,2
333,Colle Ferrato,A,Archaic Period,6,-580,-500,80,2
333,Colle Ferrato,B,Republican Period,7,-350,-30,320,2
334,Contrada Torricella,A,Early Iron Age,4,-1020,-750,270,2
334,Contrada Torricella,A,Late Iron Age,5,-750,-580,170,2
334,Contrada Torricella,A,Archaic Period,6,-580,-500,80,2
334,Contrada Torricella,B,Republican Period,7,-350,-30,320,2
335,Colle Maria Giangola D,A,Early Iron Age,4,-800,-750,50,0.5
335,Colle Maria Giangola D,A,Late Iron Age,5,-750,-580,170,0.5
335,Colle Maria Giangola D,A,Archaic Period,6,-580,-500,80,0.5
335,Colle Maria Giangola D,B,Republican Period,7,-350,-30,320,0.5
336,Colle Maria Giangola A,A,Middle Bronze Age,2,-1700,-1300,400,0.40000001
336,Colle Maria Giangola A,A,Late Bronze Age,3,-1300,-1020,280,0.40000001
336,Colle Maria Giangola A,A,Early Iron Age,4,-1020,-750,270,0.40000001
336,Colle Maria Giangola A,A,Late Iron Age,5,-750,-580,170,0.40000001
336,Colle Maria Giangola A,A,Archaic Period,6,-580,-500,80,0.40000001
336,Colle Maria Giangola A,B,Republican Period,7,-350,-30,320,0.40000001
337,Colle Maria Giancola C,A,Republican Period,7,-350,-30,320,0.1
337,Colle Maria Giancola C,A,Early Imperial Period,8,-30,100,130,0.1
337,Colle Maria Giancola C,A,Mid-Imperial Period,9,100,300,200,0.1
337,Colle Maria Giancola C,A,Late Imperial Period,10,300,400,100,0.1
338,Colle Coppo,A,Republican Period,7,-350,-30,320,0.1
338,Colle Coppo,A,Early Imperial Period,8,-30,100,130,0.1
338,Colle Coppo,A,Mid-Imperial Period,9,100,300,200,0.1
338,Colle Coppo,A,Late Imperial Period,10,300,400,100,0.1
339,Valle Carella,A,Republican Period,7,-350,-30,320,0.1
340,Colle Cantocchio,A,Middle Bronze Age,2,-1700,-1300,400,0.40000001
340,Colle Cantocchio,A,Late Bronze Age,3,-1300,-1020,280,0.40000001
340,Colle Cantocchio,A,Early Iron Age,4,-1020,-800,220,0.40000001
341,Monte Carbolino,A,Middle Bronze Age,2,-1700,-1300,400,0.30000001
341,Monte Carbolino,A,Late Bronze Age,3,-1300,-1020,280,0.30000001
341,Monte Carbolino,A,Early Iron Age,4,-1020,-800,220,0.30000001
342,La Faggeta 1,A,Republican Period,7,-350,-30,320,0.1
343,Monte Acuto,A,Republican Period,7,-350,-30,320,0.80000001
344,Valle Sant'Angelo,A,Republican Period,7,-350,-30,320,0.40000001
344,Valle Sant'Angelo,A,Early Imperial Period,8,-30,100,130,0.40000001
344,Valle Sant'Angelo,A,Mid-Imperial Period,9,100,300,200,0.40000001
344,Valle Sant'Angelo,A,Late Imperial Period,10,300,400,100,0.40000001
345,Strazzete,A,Republican Period,7,-350,-30,320,1
346,Pian Della Croce,A,Late Imperial Period,10,400,500,100,0.1
347,Monte Nero di Roccagorga,A,Middle Bronze Age,2,-1700,-1300,400,2.5
347,Monte Nero di Roccagorga,A,Late Bronze Age,3,-1300,-1020,280,2.5
347,Monte Nero di Roccagorga,A,Early Iron Age,4,-1020,-750,270,2.5
347,Monte Nero di Roccagorga,A,Late Iron Age,5,-750,-580,170,2.5
347,Monte Nero di Roccagorga,A,Archaic Period,6,-580,-500,80,2.5
348,Prati Pronacci 2,A,Late Imperial Period,10,400,500,100,0.1
349,Il Recinto 1,A,Republican Period,7,-350,-30,320,2
349,Il Recinto 1,A,Early Imperial Period,8,-30,100,130,2
349,Il Recinto 1,A,Mid-Imperial Period,9,100,300,200,2
349,Il Recinto 1,A,Late Imperial Period,10,300,500,200,2
350,Proprieta' Loris,A,Early Imperial Period,8,-30,100,130,0.40000001
350,Proprieta' Loris,A,Mid-Imperial Period,9,100,300,200,0.40000001
350,Proprieta' Loris,A,Late Imperial Period,10,300,500,200,0.40000001
351,Casa Lofre,A,Early Imperial Period,8,-30,100,130,0.1
351,Casa Lofre,A,Mid-Imperial Period,9,100,300,200,0.1
351,Casa Lofre,A,Late Imperial Period,10,300,400,100,0.1
352,Monte S. Angelo Complex 1,A,Republican Period,7,-350,-30,320,1.5
352,Monte S. Angelo Complex 1,B,Late Imperial Period,10,400,500,100,1.5
353,Prati Pronacci 1,A,Early Imperial Period,8,-30,100,130,0.1
353,Prati Pronacci 1,A,Mid-Imperial Period,9,100,300,200,0.1
353,Prati Pronacci 1,A,Late Imperial Period,10,300,500,200,0.1
354,Valle Fronza,A,Early Imperial Period,8,-30,100,130,0.1
354,Valle Fronza,A,Mid-Imperial Period,9,100,300,200,0.1
354,Valle Fronza,A,Late Imperial Period,10,300,400,100,0.1
355,Colle Intella,A,Early Imperial Period,8,-30,100,130,0.1
355,Colle Intella,A,Mid-Imperial Period,9,100,300,200,0.1
355,Colle Intella,A,Late Imperial Period,10,300,400,100,0.1
356,Selva Forcella 4+5,A,Early Iron Age,4,-800,-750,50,0.1
356,Selva Forcella 4+5,A,Late Iron Age,5,-750,-580,170,0.1
356,Selva Forcella 4+5,A,Archaic Period,6,-580,-500,80,0.1
356,Selva Forcella 4+5,A,Republican Period,7,-350,-30,320,0.1
357,Selva Forcella 1,A,Middle Bronze Age,2,-1700,-1300,400,2.5
357,Selva Forcella 1,A,Late Bronze Age,3,-1300,-1020,280,2.5
357,Selva Forcella 1,A,Early Iron Age,4,-1020,-800,220,2.5
358,Selva Forcella 7,A,Republican Period,7,-350,-30,320,0.1
358,Selva Forcella 7,A,Early Imperial Period,8,-30,100,130,0.1
358,Selva Forcella 7,A,Mid-Imperial Period,9,100,300,200,0.1
358,Selva Forcella 7,A,Late Imperial Period,10,300,500,200,0.1
359,Contrada Valle Ota 1,A,Early Iron Age,4,-800,-750,50,0.1
359,ContradaValle Ota 1,A,Late Iron Age,5,-750,-580,170,0.1
359,ContradaValle Ota 1,A,Archaic Period,6,-580,-500,80,0.1
359,ContradaValle Ota 1,B,Republican Period,7,-350,-30,320,0.1
360,Monte del Cerro,A,Middle Bronze Age,2,-1700,-1300,400,0.30000001
360,Monte del Cerro,A,Late Bronze Age,3,-1300,-1020,280,0.30000001
360,Monte del Cerro,A,Early Iron Age,4,-1020,-800,220,0.30000001
361,Antignana 1,A,Republican Period,7,-350,-30,320,0.69999999
361,Antignana 1,A,Early Imperial Period,8,-30,100,130,0.69999999
361,Antignana 1,A,Mid-Imperial Period,9,100,300,200,0.69999999
361,Antignana 1,A,Late Imperial Period,10,300,400,100,0.69999999
362,Acqua Zolfa,A,Late Iron Age,5,-600,-580,20,0.1
362,Acqua Zolfa,A,Archaic Period,6,-580,-350,230,0.1
362,Acqua Zolfa,A,Republican Period,7,-350,-30,320,0.1
362,Acqua Zolfa,A,Early Imperial Period,8,-30,100,130,0.1
362,Acqua Zolfa,A,Mid-Imperial Period,9,100,300,200,0.1
362,Acqua Zolfa,A,Late Imperial Period,10,300,400,100,0.1
363,Acqua Zolfa,A,Archaic Period,6,-500,-350,150,0.30000001
363,Acqua Zolfa,A,Republican Period,7,-350,-30,320,0.30000001
363,Acqua Zolfa,A,Early Imperial Period,8,-30,100,130,0.30000001
363,Acqua Zolfa,A,Mid-Imperial Period,9,100,300,200,0.30000001
363,Acqua Zolfa,A,Late Imperial Period,10,300,400,100,0.30000001
364,Acqua Zolfa,A,Republican Period,7,-350,-30,320,0.40000001
364,Acqua Zolfa,A,Early Imperial Period,8,-30,100,130,0.40000001
364,Acqua Zolfa,A,Mid-Imperial Period,9,100,300,200,0.40000001
364,Acqua Zolfa,A,Late Imperial Period,10,300,400,100,0.40000001
365,,A,Republican Period,7,-350,-30,320,0.059999999
365,,A,Early Imperial Period,8,-30,100,130,0.059999999
365,,A,Mid-Imperial Period,9,100,300,200,0.059999999
365,,A,Late Imperial Period,10,300,400,100,0.059999999
366,Tratturo Canio',A,Republican Period,7,-350,-30,320,0.2
366,Tratturo Canio',A,Early Imperial Period,8,-30,100,130,0.2
366,Tratturo Canio',A,Mid-Imperial Period,9,100,300,200,0.2
366,Tratturo Canio',A,Late Imperial Period,10,300,400,100,0.2
367,Tratturo Canio',A,Republican Period,7,-350,-30,320,0.80000001
367,Tratturo Canio',A,Early Imperial Period,8,-30,100,130,0.80000001
367,Tratturo Canio',A,Mid-Imperial Period,9,100,300,200,0.80000001
367,Tratturo Canio',A,Late Imperial Period,10,300,400,100,0.80000001
368,Migliara 41,A,Republican Period,7,-350,-30,320,0.1
368,Migliara 41,A,Early Imperial Period,8,-30,100,130,0.1
368,Migliara 41,A,Mid-Imperial Period,9,100,300,200,0.1
368,Migliara 41,A,Late Imperial Period,10,300,400,100,0.1
369,Gli Archi,A,Republican Period,7,-350,-30,320,0.050000001
369,Gli Archi,A,Early Imperial Period,8,-30,100,130,0.050000001
369,Gli Archi,A,Mid-Imperial Period,9,100,300,200,0.050000001
369,Gli Archi,A,Late Imperial Period,10,300,400,100,0.050000001
370,Gli Archi,A,Republican Period,7,-350,-30,320,0.2
370,Gli Archi,A,Early Imperial Period,8,-30,100,130,0.2
370,Gli Archi,A,Mid-Imperial Period,9,100,300,200,0.2
370,Gli Archi,A,Late Imperial Period,10,300,400,100,0.2
371,Gli Archi,A,Republican Period,7,-350,-30,320,0.050000001
371,Gli Archi,A,Early Imperial Period,8,-30,100,130,0.050000001
371,Gli Archi,A,Mid-Imperial Period,9,100,300,200,0.050000001
371,Gli Archi,A,Late Imperial Period,10,300,400,100,0.050000001
372,Gli Archi,A,Republican Period,7,-350,-30,320,0.2
372,Gli Archi,A,Early Imperial Period,8,-30,100,130,0.2
372,Gli Archi,A,Mid-Imperial Period,9,100,300,200,0.2
372,Gli Archi,A,Late Imperial Period,10,300,400,100,0.2
373,Prato Coppola,A,Republican Period,7,-350,-30,320,0.40000001
374,Podere la Fonte,A,Republican Period,7,-350,-30,320,2.5
374,Podere la Fonte,A,Early Imperial Period,8,-30,100,130,2.5
374,Podere la Fonte,A,Mid-Imperial Period,9,100,300,200,2.5
374,Podere la Fonte,A,Late Imperial Period,10,300,400,100,2.5
375,,A,Republican Period,7,-350,-30,320,0.050000001
375,,A,Early Imperial Period,8,-30,100,130,0.050000001
375,,A,Mid-Imperial Period,9,100,300,200,0.050000001
375,,A,Late Imperial Period,10,300,400,100,0.050000001
376,Fosso Venereo,A,Republican Period,7,-350,-30,320,0.2
376,Fosso Venereo,A,Early Imperial Period,8,-30,100,130,0.2
376,Fosso Venereo,A,Mid-Imperial Period,9,100,300,200,0.2
376,Fosso Venereo,A,Late Imperial Period,10,300,400,100,0.2
377,Fosso Venereo,A,Republican Period,7,-200,-30,170,0.30000001
377,Fosso Venereo,A,Early Imperial Period,8,-30,100,130,0.30000001
378,Campo Inferiore,A,Republican Period,7,-100,-30,70,0.1
378,Campo Inferiore,A,Early Imperial Period,8,-30,100,130,0.1
379,Campo Inferiore,A,Republican Period,7,-350,-30,320,0.1
379,Campo Inferiore,A,Early Imperial Period,8,-30,100,130,0.1
379,Campo Inferiore,A,Mid-Imperial Period,9,100,300,200,0.1
379,Campo Inferiore,A,Late Imperial Period,10,300,400,100,0.1
380,Acqua Zolfa,A,Republican Period,7,-350,-30,320,0.1
381,Podere Pantanello,A,Republican Period,7,-350,-30,320,0.1
382,Contrada Antoniana,A,Archaic Period,6,-500,-350,150,0.1
382,Contrada Antoniana,A,Republican Period,7,-350,-30,320,0.1
383,Pizzarolo,A,Republican Period,7,-350,-30,320,0.1
384,Sezze (Setia),A,Republican Period,7,-350,-30,320,14
384,Sezze (Setia),A,Early Imperial Period,8,-30,100,130,14
384,Sezze (Setia),A,Mid-Imperial Period,9,100,300,200,14
384,Sezze (Setia),A,Late Imperial Period,10,300,500,200,14
385,Prato Coppola,A,Archaic Period,6,-500,-350,150,0.25
385,Prato Coppola,A,Republican Period,7,-350,-30,320,0.25
385,Prato Coppola,A,Early Imperial Period,8,-30,100,130,0.25
385,Prato Coppola,A,Mid-Imperial Period,9,100,200,100,0.25
386,Prato Coppola,A,Archaic Period,6,-500,-350,150,0.050000001
386,Prato Coppola,A,Republican Period,7,-350,-30,320,0.050000001
386,Prato Coppola,A,Early Imperial Period,8,-30,100,130,0.050000001
387,Colle Parito,A,Early Iron Age,4,-800,-750,50,0.1
387,Colle Parito,A,Late Iron Age,5,-750,-580,170,0.1
387,Colle Parito,A,Archaic Period,6,-580,-500,80,0.1
388,,A,Early Iron Age,4,-800,-750,50,1.3
388,,A,Late Iron Age,5,-750,-580,170,1.3
388,,A,Archaic Period,6,-580,-500,80,1.3
389,Colle Parito,A,Early Iron Age,4,-800,-750,50,2
389,Colle Parito,A,Late Iron Age,5,-750,-580,170,2
389,Colle Parito,A,Archaic Period,6,-580,-350,230,2
389,Colle Parito,A,Republican Period,7,-350,-30,320,2
389,Colle Parito,A,Early Imperial Period,8,-30,100,130,2
389,Colle Parito,A,Mid-Imperial Period,9,100,200,100,2
390,,A,Early Iron Age,4,-800,-750,50,0.30000001
390,,A,Late Iron Age,5,-750,-580,170,0.30000001
390,,A,Archaic Period,6,-580,-500,80,0.30000001
391,,A,Republican Period,7,-100,-30,70,0.1
391,,A,Early Imperial Period,8,-30,100,130,0.1
392,,A,Late Iron Age,5,-600,-580,20,0.059999999
392,,A,Archaic Period,6,-580,-500,80,0.059999999
393,,A,Late Iron Age,5,-600,-580,20,0.1
393,,A,Archaic Period,6,-580,-350,230,0.1
393,,A,Republican Period,7,-350,-30,320,0.1
393,,A,Early Imperial Period,8,-30,100,130,0.1
394,,A,Late Iron Age,5,-600,-580,20,0.2
394,,A,Archaic Period,6,-580,-350,230,0.2
394,,A,Republican Period,7,-350,-30,320,0.2
394,,A,Early Imperial Period,8,-30,100,130,0.2
395,,A,Late Iron Age,5,-600,-580,20,2
395,,A,Archaic Period,6,-580,-350,230,2
396,,A,Archaic Period,6,-500,-350,150,0.1
396,,A,Republican Period,7,-350,-30,320,0.02
396,,A,Early Imperial Period,8,-30,100,130,0.02
397,,A,Republican Period,7,-350,-30,320,0.1
397,,A,Early Imperial Period,8,-30,100,130,0.1
398,,A,Late Iron Age,5,-600,-580,20,0.69999999
398,,A,Archaic Period,6,-580,-350,230,0.69999999
398,,A,Republican Period,7,-350,-30,320,0.69999999
398,,A,Early Imperial Period,8,-30,100,130,0.69999999
399,,A,Late Iron Age,5,-600,-580,20,0.60000002
399,,A,Archaic Period,6,-580,-350,230,0.60000002
399,,A,Republican Period,7,-350,-30,320,0.60000002
399,,A,Early Imperial Period,8,-30,100,130,0.60000002
399,,A,Mid-Imperial Period,9,100,200,100,0.60000002
400,,A,Late Iron Age,5,-600,-580,20,0.5
400,,A,Archaic Period,6,-580,-350,230,0.5
400,,A,Republican Period,7,-350,-30,320,0.5
400,,A,Early Imperial Period,8,-30,100,130,0.5
400,,A,Mid-Imperial Period,9,100,200,100,0.5
401,,A,Republican Period,7,-350,-30,320,5
401,,A,Early Imperial Period,8,-30,100,130,5
401,,A,Mid-Imperial Period,9,100,200,100,5
402,La Fossella,A,Republican Period,7,-350,-30,320,0.30000001
402,La Fossella,A,Early Imperial Period,8,-30,100,130,0.30000001
402,La Fossella,A,Mid-Imperial Period,9,100,200,100,0.30000001
403,,A,Late Iron Age,5,-600,-580,20,0.1
403,,A,Archaic Period,6,-580,-350,230,0.1
404,La Fossella/Colle dei Porchi,A,Late Iron Age,5,-600,-580,20,0.30000001
404,La Fossella/Colle dei Porchi,A,Archaic Period,6,-580,-350,230,0.30000001
404,La Fossella/Colle dei Porchi,A,Republican Period,7,-350,-30,320,0.30000001
404,La Fossella/Colle dei Porchi,A,Early Imperial Period,8,-30,100,130,0.30000001
404,La Fossella/Colle dei Porchi,A,Mid-Imperial Period,9,100,200,100,0.30000001
405,,A,Republican Period,7,-350,-30,320,0.029999999
405,,A,Early Imperial Period,8,-30,100,130,0.029999999
406,,A,Late Iron Age,5,-600,-580,20,0.029999999
406,,A,Archaic Period,6,-580,-350,230,0.029999999
407,,A,Archaic Period,6,-500,-350,150,0.1
407,,A,Republican Period,7,-350,-30,320,0.1
407,,A,Early Imperial Period,8,-30,100,130,0.1
408,,A,Early Iron Age,4,-1020,-750,270,0.1
408,,A,Late Iron Age,5,-750,-580,170,0.1
408,,A,Archaic Period,6,-580,-500,80,0.1
409,,A,Late Iron Age,5,-600,-580,20,0.80000001
409,,A,Archaic Period,6,-580,-350,230,0.80000001
409,,A,Republican Period,7,-350,-30,320,0.80000001
409,,A,Early Imperial Period,8,-30,100,130,0.80000001
410,,A,Early Iron Age,4,-1020,-750,270,0.5
410,,A,Late Iron Age,5,-750,-600,150,0.5
411,,A,Middle Bronze Age,2,-1700,-1300,400,0.5
411,,A,Late Bronze Age,3,-1300,-1020,280,0.5
411,,A,Early Iron Age,4,-1020,-750,270,0.5
411,,A,Late Iron Age,5,-750,-580,170,0.5
411,,A,Archaic Period,6,-580,-500,80,0.5
412,,A,Late Iron Age,5,-600,-580,20,0.1
412,,A,Archaic Period,6,-580,-350,230,0.1
412,,A,Republican Period,7,-350,-30,320,0.1
413,,A,Late Iron Age,5,-600,-580,20,0.5
413,,A,Archaic Period,6,-580,-350,230,0.5
413,,A,Republican Period,7,-350,-30,320,0.5
413,,A,Early Imperial Period,8,-30,100,130,0.5
414,Bella Farnia,A,Republican Period,7,-350,-30,320,0.1
414,Bella Farnia,A,Early Imperial Period,8,-30,100,130,0.1
415,Ficana,A,Middle Bronze Age,2,-1400,-1300,100,0.5
415,Ficana,A,Late Bronze Age,3,-1300,-1020,280,0.5
415,Ficana,A,Early Iron Age,4,-1020,-750,270,0.5
415,Ficana,A,Late Iron Age,5,-750,-700,50,0.5
416,Ostia Antica Collettore,A,Late Bronze Age,3,-1200,-1020,180,0.1
416,Ostia Antica Collettore,A,Early Iron Age,4,-1020,-1000,20,0.1
417,Castel di Decima,A,Early Iron Age,4,-800,-750,50,3
417,Castel di Decima,A,Late Iron Age,5,-750,-580,170,6
417,Castel di Decima,A,Archaic Period,6,-580,-500,80,6
418,Monte di Leva,A,Late Bronze Age,3,-1300,-1020,280,1.2
418,Monte di Leva,A,Early Iron Age,4,-1020,-1000,20,1.2
419,Pratica di Mare (Lavinium),A,Middle Bronze Age,2,-1400,-1300,100,1
419,Pratica di Mare (Lavinium),A,Late Bronze Age,3,-1300,-1020,280,1
419,Pratica di Mare (Lavinium),A,Early Iron Age,4,-1020,-750,270,12
419,Pratica di Mare (Lavinium),A,Late Iron Age,5,-750,-580,170,12
419,Pratica di Mare (Lavinium),A,Archaic Period,6,-580,-350,230,12
419,Pratica di Mare (Lavinium),A,Republican Period,7,-350,-30,320,1
419,Pratica di Mare (Lavinium),A,Early Imperial Period,8,-30,100,130,1
419,Pratica di Mare (Lavinium),A,Mid-Imperial Period,9,100,300,200,1
419,Pratica di Mare (Lavinium),A,Late Imperial Period,10,300,400,100,1
420,Ardea,A,Late Bronze Age,3,-1300,-1020,280,5
420,Ardea,A,Early Iron Age,4,-1020,-750,270,15
420,Ardea,A,Late Iron Age,5,-750,-580,170,15
420,Ardea,A,Archaic Period,6,-580,-350,230,35
420,Ardea,A,Republican Period,7,-350,-30,320,35
420,Ardea,A,Early Imperial Period,8,-30,100,130,35
420,Ardea,A,Mid-Imperial Period,9,100,300,200,35
420,Ardea,A,Late Imperial Period,10,300,500,200,35
421,L'Altare,A,Early Iron Age,4,-800,-750,50,2.5
421,L'Altare,A,Late Iron Age,5,-750,-600,150,2.5
422,Fosso della Bottaccia,A,Late Bronze Age,3,-1200,-1020,180,1
422,Fosso della Bottaccia,A,Early Iron Age,4,-1020,-1000,20,1
423,Spiagge S. Lorenzo,A,Middle Bronze Age,2,-1700,-1300,400,0.1
424,Colle Rotondo,A,Late Bronze Age,3,-1200,-1020,180,5
424,Colle Rotondo,A,Early Iron Age,4,-1020,-750,270,5
424,Colle Rotondo,A,Late Iron Age,5,-750,-600,150,5
425,Tor Caldara,A,Late Bronze Age,3,-1200,-1020,180,3
425,Tor Caldara,A,Early Iron Age,4,-1020,-1000,20,3
426,Fosso Moscarello,A,Late Bronze Age,3,-1200,-1020,180,0.40000001
426,Fosso Moscarello,A,Early Iron Age,4,-1020,-1000,20,0.40000001
427,Caprolace,A,Middle Bronze Age,2,-1700,-1300,400,0.1
427,Caprolace,A,Late Bronze Age,3,-1300,-1200,100,0.1
428,Caterattino,A,Middle Bronze Age,2,-1700,-1300,400,0.1
428,Caterattino,A,Late Bronze Age,3,-1300,-1200,100,0.1
429,Molella,A,Late Bronze Age,3,-1300,-1200,100,0.1
430,Torre Paola,A,Late Bronze Age,3,-1200,-1020,180,0.1
430,Torre Paola,A,Early Iron Age,4,-1020,-900,120,0.1
431,La Casarina,A,Early Bronze Age,1,-2300,-1700,600,0.1
432,Quarto Freddo,A,Late Bronze Age,3,-1200,-1020,180,1
432,Quarto Freddo,A,Early Iron Age,4,-1020,-1000,20,1
433,Borgo Ermada,A,Middle Bronze Age,2,-1700,-1300,400,0.1
434,Spiaggia delle Bambole,A,Middle Bronze Age,2,-1700,-1400,300,0.1
436,Monte d'Argento,A,Late Bronze Age,3,-1200,-1020,180,1
436,Monte d'Argento,A,Early Iron Age,4,-1020,-750,270,1
436,Monte d'Argento,A,Late Iron Age,5,-750,-580,170,1
436,Monte d'Argento,A,Archaic Period,6,-580,-500,80,1
437,Colle dei Cappuccini,A,Middle Bronze Age,2,-1400,-1300,100,0.1
437,Colle dei Cappuccini,A,Late Bronze Age,3,-1300,-1020,280,0.1
437,Colle dei Cappuccini,A,Early Iron Age,4,-1020,-750,270,0.1
437,Colle dei Cappuccini,A,Late Iron Age,5,-750,-700,50,0.1
438,Monte Savello,A,Early Iron Age,4,-1000,-750,250,0.2
438,Monte Savello,A,Late Iron Age,5,-750,-700,50,0.2
439,Paluzzi,A,Late Bronze Age,3,-1200,-1020,180,0.1
439,Paluzzi,A,Early Iron Age,4,-1020,-900,120,0.1
440,Pescaccio,A,Early Iron Age,4,-800,-750,50,0.050000001
440,Pescaccio,A,Late Iron Age,5,-750,-600,150,0.050000001
442,Cacamele,A,Middle Bronze Age,2,-1700,-1500,200,1
443,Torre del Padiglione Nord,A,Middle Bronze Age,2,-1400,-1300,100,0.1
444,Torre del Padiglione Sud,A,Late Bronze Age,3,-1200,-1020,180,0.1
444,Torre del Padiglione Sud,A,Early Iron Age,4,-1020,-1000,20,0.1
444,Torre del Padiglione Sud,B,Late Iron Age,5,-700,-600,100,0.1
445,Colli della Coedra,A,Early Iron Age,4,-900,-750,150,0.1
445,Colli della Coedra,A,Late Iron Age,5,-750,-600,150,0.1
446,Orti Torlonia,A,Late Bronze Age,3,-1300,-1200,100,0.1
446,Orti Torlonia,B,Early Iron Age,4,-900,-750,150,0.1
446,Orti Torlonia,B,Late Iron Age,5,-750,-700,50,0.1
447,"Lago di Albano, Spiaggetta",A,Middle Bronze Age,2,-1500,-1300,200,0.1
447,"Lago di Albano, Spiaggetta",A,Late Bronze Age,3,-1300,-1200,100,0.1
447,"Lago di Albano, Spiaggetta",B,Early Iron Age,4,-1000,-750,250,0.1
447,"Lago di Albano, Spiaggetta",B,Late Iron Age,5,-750,-700,50,0.1
448,Villaggio delle Macine,A,Early Bronze Age,1,-2300,-1700,600,0.1
448,Villaggio delle Macine,A,Middle Bronze Age,2,-1700,-1400,300,0.1
449,Cisterna di Latina,A,Early Iron Age,4,-1000,-750,250,0.1
449,Cisterna di Latina,A,Late Iron Age,5,-750,-580,170,0.1
449,Cisterna di Latina,A,Archaic Period,6,-580,-350,230,0.1
450,Colle S. Andrea,A,Middle Bronze Age,2,-1400,-1300,100,0.1
451,Colonna,A,Early Iron Age,4,-1000,-750,250,0.1
451,Colonna,A,Late Iron Age,5,-750,-600,150,0.1
452,Colonna,A,Early Iron Age,4,-1000,-750,250,0.1
452,Colonna,A,Late Iron Age,5,-750,-700,50,0.1
453,"Cori,Tempio di Ercole",A,Early Iron Age,4,-1000,-750,250,0.1
453,"Cori,Tempio di Ercole",A,Late Iron Age,5,-750,-600,150,0.1
454,Colle dell'Asino,A,Middle Bronze Age,2,-1400,-1300,100,0.1
454,Colle dell'Asino,B,Late Bronze Age,3,-1100,-1020,80,0.1
454,Colle dell'Asino,B,Early Iron Age,4,-1020,-1000,20,0.1
455,Sorgente Preziosa,A,Early Iron Age,4,-1000,-900,100,0.1
456,"Tuscolo, Acropoli",A,Early Iron Age,4,-1000,-750,250,0.5
456,"Tuscolo, Acropoli",A,Late Iron Age,5,-750,-700,50,0.5
457,Valle Violata,A,Early Iron Age,4,-900,-800,100,0.1
458,Colle dell'Uomo Morto,A,Middle Bronze Age,2,-1500,-1400,100,0.1
459,"Lariano, Campo Sportivo",A,Middle Bronze Age,2,-1500,-1400,100,0.1
460,Cima La Torre,A,Early Iron Age,4,-1000,-750,250,0.1
460,Cima La Torre,A,Late Iron Age,5,-750,-600,150,0.1
461,Coste Caselle,A,Early Iron Age,4,-1000,-900,100,0.1
462,I Ciufoli,A,Middle Bronze Age,2,-1700,-1300,400,0.1
462,I Ciufoli,A,Late Bronze Age,3,-1300,-1020,280,0.095414892
462,I Ciufoli,A,Early Iron Age,4,-1020,-750,270,0.095414892
462,I Ciufoli,A,Late Iron Age,5,-750,-600,150,0.095414892
463,I Camaldoli,A,Early Iron Age,4,-1000,-750,250,0.029999999
463,I Camaldoli,A,Late Iron Age,5,-750,-600,150,0.029999999
464,Camposelva,A,Late Bronze Age,3,-1200,-1020,180,0.1
464,Camposelva,A,Early Iron Age,4,-1020,-1000,20,0.1
465,Migliara 52,A,Middle Bronze Age,2,-1400,-1300,100,0.1
465,Migliara 52,B,Early Iron Age,4,-1000,-900,100,0.1
466,Colle Pistasale,A,Middle Bronze Age,2,-1700,-1500,200,0.1
467,Valle Fredda,A,Middle Bronze Age,2,-1700,-1300,400,0.1
468,"Rocca di Papa, Divin Maestro",A,Early Iron Age,4,-900,-750,150,0.1
468,"Rocca di Papa, Divin Maestro",A,Late Iron Age,5,-750,-600,150,0.1
469,Colle della Mola,A,Middle Bronze Age,2,-1400,-1300,100,0.1
469,Colle della Mola,A,Late Bronze Age,3,-1300,-1020,280,0.1
469,Colle della Mola,A,Early Iron Age,4,-1020,-1000,20,0.1
470,Fosso della Cavatella,A,Late Bronze Age,3,-1200,-1020,180,0.1
470,Fosso della Cavatella,A,Early Iron Age,4,-1020,-900,120,0.1
471,La Selva di Roccagorga,A,Middle Bronze Age,2,-1400,-1300,100,0.1
472,Monte la Difesa,A,Early Iron Age,4,-1000,-750,250,0.1
472,Monte la Difesa,A,Late Iron Age,5,-750,-600,150,0.1
473,Mola dell'Abbadia,A,Middle Bronze Age,2,-1700,-1500,200,0.1
474,Vado Fiume,A,Early Iron Age,4,-1000,-750,250,0.1
474,Vado Fiume,A,Late Iron Age,5,-750,-700,50,0.1
475,Casa Calda,A,Late Bronze Age,3,-1200,-1020,180,0.1
475,Casa Calda,A,Early Iron Age,4,-1020,-1000,20,0.1
476,Casale della Perna,A,Late Bronze Age,3,-1200,-1020,180,0.1
476,Casale della Perna,A,Early Iron Age,4,-1020,-1000,20,0.1
477,Casale di Torre Spaccata,A,Early Bronze Age,1,-2300,-1700,600,0.1
478,Casali Mancini,A,Middle Bronze Age,2,-1700,-1500,200,0.1
479,Castiglione,A,Middle Bronze Age,2,-1400,-1300,100,0.1
479,Castiglione,A,Late Bronze Age,3,-1300,-1200,100,0.1
480,Colle Mattia,A,Middle Bronze Age,2,-1700,-1300,400,0.1
480,Colle Mattia,A,Late Bronze Age,3,-1300,-1200,100,0.1
481,Fosso della Torre,A,Early Bronze Age,1,-2300,-1700,600,0.1
482,Fosso di Torre Spaccata,A,Early Bronze Age,1,-2300,-1700,600,0.1
483,La Rustica,A,Late Bronze Age,3,-1200,-1020,180,0.1
483,La Rustica,A,Early Iron Age,4,-1020,-1000,20,0.1
484,Fosso Mole di Corcolle,A,Early Bronze Age,1,-2300,-1700,600,0.1
485,Osteria del Malpasso,A,Early Bronze Age,1,-2300,-1700,600,0.1
486,Tenuta della Falcognana,A,Middle Bronze Age,2,-1700,-1500,200,0.1
487,Tenuta di Valleranello,A,Middle Bronze Age,2,-1700,-1500,200,0.1
488,Torre di Mezzavia,A,Late Bronze Age,3,-1200,-1020,180,0.1
488,Torre di Mezzavia,A,Early Iron Age,4,-1020,-1000,20,0.1
489,Torrino,A,Late Bronze Age,3,-1200,-1020,180,0.1
489,Torrino,A,Early Iron Age,4,-1020,-1000,20,0.1
490,Quadraro,A,Early Bronze Age,1,-2300,-1700,600,0.1
490,Quadraro,B,Late Bronze Age,3,-1200,-1020,180,0.1
490,Quadraro,B,Early Iron Age,4,-1020,-1000,20,0.1
491,Valle Porcina,A,Early Bronze Age,1,-2300,-1700,600,0.1
492,"Colle S. Lorenzo, Sommita'",A,Late Bronze Age,3,-1200,-1020,180,10
492,"Colle S. Lorenzo, Sommita'",A,Early Iron Age,4,-1020,-800,220,10
493,Acqua Acetosa Laurentina,A,Late Bronze Age,3,-1300,-1020,280,2
493,Acqua Acetosa Laurentina,B,Early Iron Age,4,-1020,-750,270,0.40000001
493,Acqua Acetosa Laurentina,C,Late Iron Age,5,-750,-580,170,0.5
493,Acqua Acetosa Laurentina,C,Archaic Period,6,-580,-500,80,0.5
494,Antemnae,A,Early Iron Age,4,-900,-750,150,13
494,Antemnae,A,Late Iron Age,5,-750,-580,170,13
494,Antemnae,A,Archaic Period,6,-580,-350,230,13
494,Antemnae,A,Republican Period,7,-350,-200,150,13
495,Gabii,A,Early Iron Age,4,-900,-750,150,50
495,Gabii,A,Late Iron Age,5,-750,-580,170,50
495,Gabii,A,Archaic Period,6,-580,-350,230,50
495,Gabii,A,Republican Period,7,-350,-30,320,20
495,Gabii,A,Early Imperial Period,8,-30,100,130,10
495,Gabii,A,Mid-Imperial Period,9,100,300,200,10
495,Gabii,A,Late Imperial Period,10,300,400,100,10
496,Roma,A,Early Bronze Age,1,-2300,-1700,600,4
496,Roma,A,Middle Bronze Age,2,-1700,-1300,400,8
496,Roma,A,Late Bronze Age,3,-1300,-1020,280,22
496,Roma,A,Early Iron Age,4,-1020,-750,270,54
496,Roma,A,Late Iron Age,5,-750,-580,170,150
496,Roma,A,Archaic Period,6,-580,-350,230,380
496,Roma,A,Republican Period,7,-350,-30,320,380
496,Roma,A,Early Imperial Period,8,-30,100,130,2540.1299
496,Roma,A,Mid-Imperial Period,9,100,300,200,2540.1299
496,Roma,A,Late Imperial Period,10,300,500,200,2540.1299
497,,A,Republican Period,7,-100,-30,70,0.5
497,,A,Early Imperial Period,8,-30,100,130,0.5
498,,A,Republican Period,7,-100,-30,70,0.5
498,,A,Early Imperial Period,8,-30,100,130,0.5
499,,A,Republican Period,7,-100,-30,70,0.5
499,,A,Early Imperial Period,8,-30,100,130,0.5
500,,A,Republican Period,7,-100,-30,70,1.5
500,,A,Early Imperial Period,8,-30,100,130,1.5
501,,A,Republican Period,7,-100,-30,70,1
501,,A,Early Imperial Period,8,-30,100,130,1
502,Torretta,A,Republican Period,7,-100,-30,70,0.5
502,Torretta,A,Early Imperial Period,8,-30,100,130,0.5
503,Rave Rosse,A,Republican Period,7,-100,-30,70,0.5
503,Rave Rosse,A,Early Imperial Period,8,-30,100,130,0.5
504,Livastrito,A,Republican Period,7,-100,-30,70,1
504,Livastrito,A,Early Imperial Period,8,-30,100,130,1
505,Prato Pisciarello,A,Republican Period,7,-100,-30,70,0.5
505,Prato Pisciarello,A,Early Imperial Period,8,-30,100,130,0.5
506,Colle Margherita,A,Republican Period,7,-100,-30,70,0.5
506,Colle Margherita,A,Early Imperial Period,8,-30,100,130,0.5
507,Grotticelle,A,Republican Period,7,-100,-30,70,0.5
507,Grotticelle,A,Early Imperial Period,8,-30,100,130,0.5
508,Locca e Pellecini,A,Republican Period,7,-100,-30,70,1
508,Locca e Pellecini,A,Early Imperial Period,8,-30,100,130,1
509,Fontana del Prato,A,Republican Period,7,-100,-30,70,1
509,Fontana del Prato,A,Early Imperial Period,8,-30,100,130,1
510,Costa S. Nicola,A,Republican Period,7,-100,-30,70,1
510,Costa S. Nicola,A,Early Imperial Period,8,-30,100,130,1
511,Torrecchia Vecchia,A,Republican Period,7,-100,-30,70,0.5
511,Torrecchia Vecchia,A,Early Imperial Period,8,-30,100,130,0.5
512,Fontana Grottarola,A,Republican Period,7,-100,-30,70,1
512,Fontana Grottarola,A,Early Imperial Period,8,-30,100,130,1
513,Filippani,A,Republican Period,7,-100,-30,70,0.5
513,Filippani,A,Early Imperial Period,8,-30,100,130,0.5
514,Costa S. Nicola,A,Republican Period,7,-100,-30,70,1
514,Costa S. Nicola,A,Early Imperial Period,8,-30,100,130,1
516,Costa Campana,A,Republican Period,7,-100,-30,70,1
516,Costa Campana,A,Early Imperial Period,8,-30,100,130,1
517,Mille Foci,A,Republican Period,7,-100,-30,70,1.5
517,Mille Foci,A,Early Imperial Period,8,-30,100,130,1.5
518,Le Forme,A,Republican Period,7,-100,-30,70,0.5
518,Le Forme,A,Early Imperial Period,8,-30,100,130,0.5
519,Colle Medico,A,Republican Period,7,-100,-30,70,2
520,,A,Republican Period,7,-100,-30,70,1
520,,A,Early Imperial Period,8,-30,100,130,1
521,Valle della Pescara,A,Republican Period,7,-100,-30,70,1
521,Valle della Pescara,A,Early Imperial Period,8,-30,100,130,1
522,Capo la Mora,A,Republican Period,7,-100,-30,70,1
522,Capo la Mora,A,Early Imperial Period,8,-30,100,130,1
523,Cisternola,A,Republican Period,7,-100,-30,70,1.5
523,Cisternola,A,Early Imperial Period,8,-30,100,130,1.5
524,Canalicchi,A,Republican Period,7,-100,-30,70,0.30000001
524,Canalicchi,A,Early Imperial Period,8,-30,100,130,0.30000001
525,Casale,A,Republican Period,7,-100,-30,70,0.5
525,Casale,A,Early Imperial Period,8,-30,100,130,0.5
526,,A,Republican Period,7,-100,-30,70,0.1
526,,A,Early Imperial Period,8,-30,100,130,0.1
527,Colle Borgia,A,Republican Period,7,-100,-30,70,0.30000001
527,Colle Borgia,A,Early Imperial Period,8,-30,100,130,0.30000001
528,S. Giorgio,A,Republican Period,7,-100,-30,70,1
528,S. Giorgio,A,Early Imperial Period,8,-30,100,130,1
529,Contrada Chiusa,A,Republican Period,7,-100,-30,70,0.5
529,Contrada Chiusa,A,Early Imperial Period,8,-30,100,130,0.5
530,Forum Appii,A,Republican Period,7,-300,-30,270,10
530,Forum Appii,A,Early Imperial Period,8,-30,100,130,10
530,Forum Appii,A,Mid-Imperial Period,9,100,300,200,10
530,Forum Appii,A,Late Imperial Period,10,300,500,200,10
531,Ad Medias,A,Republican Period,7,-300,-30,270,3
531,Ad Medias,A,Early Imperial Period,8,-30,100,130,3
532,Il Pizzo,A,Middle Bronze Age,2,-1700,-1300,400,0.5
532,Il Pizzo,A,Late Bronze Age,3,-1300,-1020,280,0.5
532,Il Pizzo,A,Early Iron Age,4,-1020,-750,270,0.2
532,Il Pizzo,A,Late Iron Age,5,-750,-600,150,0.2
539,Riserva Capanna Murata,A,Middle Bronze Age,2,-1500,-1300,200,0.1
539,Riserva Capanna Murata,A,Late Bronze Age,3,-1300,-1020,280,0.1
539,Riserva Capanna Murata,A,Early Iron Age,4,-1020,-1000,20,0.1
540,Monte Roncione,A,Late Bronze Age,3,-1200,-1020,180,1
540,Monte Roncione,A,Early Iron Age,4,-1020,-1000,20,1
541,Casale Bruciato,A,Early Bronze Age,1,-2300,-1700,600,0.1
541,Casale Bruciato,B,Late Bronze Age,3,-1200,-1020,180,0.1
541,Casale Bruciato,B,Early Iron Age,4,-1020,-1000,20,0.1
544,Quarto della Vipera,A,Early Iron Age,4,-1000,-750,250,0.1
544,Quarto della Vipera,A,Late Iron Age,5,-750,-600,150,0.1
546,Le Pantanelle,A,Middle Bronze Age,2,-1700,-1300,400,0.1
546,Le Pantanelle,A,Late Bronze Age,3,-1300,-1020,280,0.1
546,Le Pantanelle,A,Early Iron Age,4,-1020,-750,270,0.1
546,Le Pantanelle,A,Late Iron Age,5,-750,-600,150,0.1
550,Cave di Breccia,A,Late Bronze Age,3,-1200,-1020,180,0.1
550,Cave di Breccia,A,Early Iron Age,4,-1020,-1000,20,0.1
553,,A,Early Bronze Age,1,-2300,-1700,600,0.050000001
554,Quarto della Zolforatella,A,Early Bronze Age,1,-2300,-1700,600,0.1
555,Quarto della Zolforatella,A,Early Bronze Age,1,-2300,-1700,600,0.1
558,Fosso del Pratone,A,Early Bronze Age,1,-2300,-1700,600,0.050000001
559,Quadrato di Torre Spaccata,A,Early Bronze Age,1,-2300,-1700,600,1
559,Quadrato di Torre Spaccata,B,Late Bronze Age,3,-1300,-1200,100,1
560,Quadrato,A,Late Bronze Age,3,-1200,-1020,180,0.1
560,Quadrato,A,Early Iron Age,4,-1020,-1000,20,0.1
561,Fosso della Torre,A,Early Bronze Age,1,-2300,-1700,600,0.1
564,Orti Poli,A,Late Bronze Age,3,-1300,-1200,100,0.1
565,Tenuta di Torre Nova,A,Late Bronze Age,3,-1300,-1200,100,0.1
569,Fosso di Settebagni,A,Middle Bronze Age,2,-1700,-1300,400,0.1
571,,A,Middle Bronze Age,2,-1700,-1300,400,0.1
572,,A,Middle Bronze Age,2,-1700,-1300,400,0.1
573,Fosso di Tor S. Giovanni,A,Middle Bronze Age,2,-1700,-1300,400,0.1
573,Fosso di Tor S. Giovanni,A,Late Bronze Age,3,-1300,-1200,100,0.1
575,,A,Middle Bronze Age,2,-1700,-1300,400,0.1
576,Casele Cairo,A,Republican Period,7,-350,-30,320,0.1
577,Le Starze,A,Republican Period,7,-200,-30,170,1.5
577,Le Starze,B,Mid-Imperial Period,9,100,300,200,1.5
578,S. Cataldo,A,Mid-Imperial Period,9,100,300,200,0.1
578,S. Cataldo,A,Late Imperial Period,10,300,500,200,0.1
579,S. Cataldo,A,Early Imperial Period,8,-30,100,130,0.2
579,S. Cataldo,A,Mid-Imperial Period,9,100,300,200,0.2
580,Colle Cesare,A,Early Imperial Period,8,-30,100,130,0.30000001
580,Colle Cesare,A,Mid-Imperial Period,9,100,300,200,0.30000001
581,Lademagne,A,Early Imperial Period,8,-30,100,130,0.1
581,Lademagne,A,Mid-Imperial Period,9,100,300,200,0.1
581,Lademagne,A,Late Imperial Period,10,300,400,100,0.1
582,Limata Tenda,A,Republican Period,7,-350,-30,320,0.1
582,Limata Tenda,B,Mid-Imperial Period,9,100,300,200,0.1
583,S. Vignito,A,Republican Period,7,-100,-30,70,0.1
583,S. Vignito,A,Early Imperial Period,8,-30,100,130,0.1
584,,A,Republican Period,7,-300,-30,270,1
584,,A,Early Imperial Period,8,-30,100,130,1
584,,A,Mid-Imperial Period,9,100,300,200,1
585,,A,Republican Period,7,-350,-30,320,0.30000001
585,,A,Early Imperial Period,8,-30,100,130,0.30000001
586,Starza Casale,A,Republican Period,7,-300,-200,100,0.40000001
586,Starza Casale,B,Mid-Imperial Period,9,100,300,200,0.40000001
586,Starza Casale,B,Late Imperial Period,10,300,500,200,0.40000001
587,,A,Republican Period,7,-300,-30,270,0.2
587,,A,Early Imperial Period,8,-30,100,130,0.2
587,,A,Mid-Imperial Period,9,100,300,200,0.2
587,,A,Late Imperial Period,10,300,400,100,0.2
588,,A,Early Iron Age,4,-1000,-750,250,0.30000001
588,,A,Late Iron Age,5,-750,-600,150,0.30000001
588,,B,Republican Period,7,-350,-30,320,0.30000001
588,,B,Early Imperial Period,8,-30,100,130,0.30000001
588,,B,Mid-Imperial Period,9,100,300,200,0.30000001
589,Bosco Scopetele,A,Republican Period,7,-350,-30,320,0.1
589,Bosco Scopetele,A,Early Imperial Period,8,-30,100,130,0.1
589,Bosco Scopetele,A,Mid-Imperial Period,9,100,300,200,0.1
590,Fontana di Lecce,A,Early Imperial Period,8,-30,100,130,0.1
590,Fontana di Lecce,A,Mid-Imperial Period,9,100,300,200,0.1
591,,A,Republican Period,7,-350,-30,320,0.050000001
591,,A,Early Imperial Period,8,-30,100,130,0.050000001
591,,A,Mid-Imperial Period,9,100,300,200,0.050000001
592,Scolpeto,A,Republican Period,7,-350,-30,320,0.1
592,Scolpeto,B,Mid-Imperial Period,9,100,300,200,0.1
593,Scolpeto,A,Early Imperial Period,8,-30,100,130,0.1
593,Scolpeto,A,Mid-Imperial Period,9,100,300,200,0.1
594,Selva Rotonda,A,Republican Period,7,-350,-30,320,0.029999999
595,Melfi di Sopra,A,Republican Period,7,-350,-30,320,0.1
595,Melfi di Sopra,A,Early Imperial Period,8,-30,100,130,0.1
596,,A,Mid-Imperial Period,9,100,300,200,0.2
597,Tore,A,Republican Period,7,-350,-30,320,0.30000001
597,Tore,A,Early Imperial Period,8,-30,100,130,0.30000001
597,Tore,A,Mid-Imperial Period,9,100,300,200,0.30000001
598,Tore,A,Republican Period,7,-350,-30,320,0.050000001
598,Tore,A,Early Imperial Period,8,-30,100,130,0.050000001
598,Tore,A,Mid-Imperial Period,9,100,300,200,0.050000001
598,Tore,A,Late Imperial Period,10,300,500,200,0.050000001
599,B. la Pannucciara,A,Republican Period,7,-100,-30,70,0.15000001
599,B. la Pannucciara,A,Early Imperial Period,8,-30,100,130,0.15000001
599,B. la Pannucciara,A,Mid-Imperial Period,9,100,300,200,0.15000001
599,B. la Pannucciara,A,Late Imperial Period,10,300,500,200,0.15000001
600,B. Commone,A,Republican Period,7,-100,-30,70,0.1
600,B. Commone,A,Early Imperial Period,8,-30,100,130,0.1
601,B. Commone,A,Republican Period,7,-350,-30,320,0.30000001
601,B. Commone,A,Early Imperial Period,8,-30,100,130,0.30000001
601,B. Commone,A,Mid-Imperial Period,9,100,300,200,0.30000001
602,B. Commone,A,Early Imperial Period,8,-30,100,130,0.60000002
602,B. Commone,A,Mid-Imperial Period,9,100,300,200,0.60000002
603,,A,Republican Period,7,-350,-30,320,0.050000001
603,,A,Early Imperial Period,8,-30,100,130,0.050000001
603,,A,Mid-Imperial Period,9,100,300,200,0.050000001
603,,A,Late Imperial Period,10,300,400,100,0.050000001
604,Torre del Duco,A,Early Imperial Period,8,-30,100,130,0.029999999
604,Torre del Duco,A,Mid-Imperial Period,9,100,300,200,0.029999999
605,,A,Republican Period,7,-350,-30,320,0.40000001
605,,A,Early Imperial Period,8,-30,100,130,0.40000001
606,Campo Minonno,A,Republican Period,7,-100,-30,70,0.050000001
606,Campo Minonno,A,Early Imperial Period,8,-30,100,130,0.050000001
607,Panniglia,A,Republican Period,7,-350,-30,320,0.2
607,Panniglia,A,Early Imperial Period,8,-30,100,130,0.2
607,Panniglia,A,Mid-Imperial Period,9,100,300,200,0.2
607,Panniglia,A,Late Imperial Period,10,300,400,100,0.2
608,San Vito,A,Republican Period,7,-350,-30,320,0.2
608,San Vito,A,Early Imperial Period,8,-30,100,130,0.2
608,San Vito,A,Mid-Imperial Period,9,100,300,200,0.2
608,San Vito,A,Late Imperial Period,10,300,400,100,0.2
609,San Vito,A,Early Imperial Period,8,-30,100,130,0.2
609,San Vito,A,Mid-Imperial Period,9,100,300,200,0.2
609,San Vito,A,Late Imperial Period,10,300,400,100,0.2
610,Ara Murata,A,Republican Period,7,-350,-30,320,0.69999999
610,Ara Murata,A,Early Imperial Period,8,-30,100,130,0.69999999
610,Ara Murata,A,Mid-Imperial Period,9,100,300,200,0.69999999
610,Ara Murata,A,Late Imperial Period,10,300,500,200,0.69999999
611,,A,Republican Period,7,-100,-30,70,0.029999999
611,,A,Early Imperial Period,8,-30,100,130,0.029999999
612,Monticelli del Carmine,A,Middle Bronze Age,2,-1700,-1300,400,0.02
612,Monticelli del Carmine,A,Late Bronze Age,3,-1300,-1020,280,0.02
612,Monticelli del Carmine,A,Early Iron Age,4,-1020,-750,270,0.02
612,Monticelli del Carmine,A,Late Iron Age,5,-750,-600,150,0.02
612,Monticelli del Carmine,A,Republican Period,7,-350,-30,320,0.02
612,Monticelli del Carmine,A,Early Imperial Period,8,-30,100,130,0.02
612,Monticelli del Carmine,A,Mid-Imperial Period,9,100,300,200,0.02
612,Monticelli del Carmine,A,Late Imperial Period,10,300,400,100,0.02
613,Monticelli del Carmine,A,Early Iron Age,4,-1000,-750,250,0.1
613,Monticelli del Carmine,A,Late Iron Age,5,-750,-600,150,0.1
613,Monticelli del Carmine,B,Republican Period,7,-350,-30,320,0.1
613,Monticelli del Carmine,B,Early Imperial Period,8,-30,100,130,0.1
613,Monticelli del Carmine,B,Mid-Imperial Period,9,100,300,200,0.1
613,Monticelli del Carmine,B,Late Imperial Period,10,300,400,100,0.1
614,Monticelli del Carmine,A,Republican Period,7,-350,-30,320,0.40000001
614,Monticelli del Carmine,A,Early Imperial Period,8,-30,100,130,0.40000001
614,Monticelli del Carmine,A,Mid-Imperial Period,9,100,300,200,0.40000001
614,Monticelli del Carmine,A,Late Imperial Period,10,300,400,100,0.40000001
615,M. Felice,A,Late Iron Age,5,-700,-600,100,1
615,M. Felice,B,Republican Period,7,-350,-30,320,1
615,M. Felice,B,Early Imperial Period,8,-30,100,130,1
615,M. Felice,B,Mid-Imperial Period,9,100,300,200,1
615,M. Felice,B,Late Imperial Period,10,300,500,200,1
616,M. Felice,A,Late Iron Age,5,-700,-600,100,0.69999999
616,M. Felice,B,Republican Period,7,-350,-30,320,0.69999999
616,M. Felice,B,Early Imperial Period,8,-30,100,130,0.69999999
616,M. Felice,B,Mid-Imperial Period,9,100,300,200,0.69999999
616,M. Felice,B,Late Imperial Period,10,300,500,200,0.69999999
617,,A,Republican Period,7,-350,-30,320,0.2
617,,A,Early Imperial Period,8,-30,100,130,0.2
617,,A,Mid-Imperial Period,9,100,300,200,0.2
617,,A,Late Imperial Period,10,300,400,100,0.2
618,,A,Republican Period,7,-350,-30,320,0.2
618,,A,Early Imperial Period,8,-30,100,130,0.2
618,,A,Mid-Imperial Period,9,100,300,200,0.2
618,,A,Late Imperial Period,10,300,400,100,0.2
619,,A,Early Iron Age,4,-1000,-750,250,0.02
619,,A,Late Iron Age,5,-750,-600,150,0.02
620,,A,Republican Period,7,-350,-200,150,0.02
621,S. Pietro a Campea,A,Republican Period,7,-100,-30,70,0.40000001
621,S. Pietro a Campea,A,Early Imperial Period,8,-30,100,130,0.40000001
622,,A,Early Iron Age,4,-1000,-750,250,0.07
622,,A,Late Iron Age,5,-750,-600,150,0.07
623,,A,Early Iron Age,4,-1000,-750,250,0.07
623,,A,Late Iron Age,5,-750,-600,150,0.07
623,,B,Republican Period,7,-350,-30,320,0.07
623,,B,Early Imperial Period,8,-30,100,130,0.07
623,,B,Mid-Imperial Period,9,100,300,200,0.07
623,,B,Late Imperial Period,10,300,400,100,0.07
624,,A,Republican Period,7,-100,-30,70,0.5
624,,A,Early Imperial Period,8,-30,100,130,0.5
624,,A,Mid-Imperial Period,9,100,300,200,0.5
624,,A,Late Imperial Period,10,300,500,200,0.5
625,,A,Early Iron Age,4,-1000,-750,250,0.1
625,,A,Late Iron Age,5,-750,-600,150,0.1
625,,B,Republican Period,7,-350,-200,150,0.1
626,,A,Early Iron Age,4,-1000,-750,250,0.69999999
626,,A,Late Iron Age,5,-750,-600,150,0.69999999
626,,B,Republican Period,7,-350,-30,320,0.69999999
626,,B,Early Imperial Period,8,-30,100,130,0.69999999
626,,B,Mid-Imperial Period,9,100,300,200,0.69999999
626,,B,Late Imperial Period,10,300,400,100,0.69999999
627,,A,Early Iron Age,4,-1000,-750,250,0.02
627,,A,Late Iron Age,5,-750,-600,150,0.02
628,,A,Republican Period,7,-350,-30,320,0.30000001
628,,A,Early Imperial Period,8,-30,100,130,0.30000001
628,,A,Mid-Imperial Period,9,100,300,200,0.30000001
628,,A,Late Imperial Period,10,300,500,200,0.30000001
629,,A,Late Iron Age,5,-700,-600,100,0.059999999
629,,B,Republican Period,7,-350,-200,150,0.059999999
630,La Sedia Piana,A,Republican Period,7,-350,-30,320,5
630,La Sedia Piana,A,Early Imperial Period,8,-30,100,130,5
630,La Sedia Piana,A,Mid-Imperial Period,9,100,300,200,5
630,La Sedia Piana,A,Late Imperial Period,10,300,500,200,5
631,La Sedia Piana,A,Early Iron Age,4,-1000,-750,250,1
631,La Sedia Piana,A,Late Iron Age,5,-750,-600,150,1
632,La Sedia Piana,A,Early Iron Age,4,-1000,-750,250,0.69999999
632,La Sedia Piana,A,Late Iron Age,5,-750,-600,150,0.69999999
633,La Sedia Piana,A,Republican Period,7,-350,-30,320,8
633,La Sedia Piana,A,Early Imperial Period,8,-30,100,130,7
633,La Sedia Piana,A,Mid-Imperial Period,9,100,300,200,6
633,La Sedia Piana,A,Late Imperial Period,10,300,500,200,6
634,,A,Republican Period,7,-350,-30,320,0.1
634,,A,Early Imperial Period,8,-30,100,130,0.1
634,,A,Mid-Imperial Period,9,100,300,200,0.1
634,,A,Late Imperial Period,10,300,500,200,0.1
635,,A,Republican Period,7,-350,-30,320,0.1
636,,A,Early Iron Age,4,-1000,-750,250,0.2
636,,A,Late Iron Age,5,-750,-600,150,0.2
637,,A,Early Iron Age,4,-1000,-750,250,0.1
637,,A,Late Iron Age,5,-750,-600,150,0.1
638,,A,Republican Period,7,-350,-30,320,1
638,,A,Early Imperial Period,8,-30,100,130,1
638,,A,Mid-Imperial Period,9,100,300,200,1
639,,A,Republican Period,7,-350,-30,320,0.30000001
639,,A,Early Imperial Period,8,-30,100,130,0.30000001
639,,A,Mid-Imperial Period,9,100,300,200,0.30000001
640,Villa Eucheria,A,Republican Period,7,-350,-30,320,0.2
640,Villa Eucheria,A,Early Imperial Period,8,-30,100,130,0.2
640,Villa Eucheria,A,Mid-Imperial Period,9,100,300,200,0.2
640,Villa Eucheria,A,Late Imperial Period,10,300,500,200,0.2
641,,A,Early Iron Age,4,-1000,-750,250,1
641,,A,Late Iron Age,5,-750,-600,150,1
641,,B,Republican Period,7,-350,-200,150,1
642,,A,Early Iron Age,4,-1000,-750,250,0.30000001
642,,A,Late Iron Age,5,-750,-600,150,0.30000001
642,,B,Republican Period,7,-350,-30,320,0.2
642,,B,Early Imperial Period,8,-30,100,130,0.2
642,,B,Mid-Imperial Period,9,100,300,200,0.2
643,,A,Late Iron Age,5,-700,-600,100,0.050000001
643,,B,Republican Period,7,-350,-30,320,0.050000001
643,,B,Early Imperial Period,8,-30,100,130,0.050000001
644,,A,Republican Period,7,-350,-30,320,0.1
645,Mandra,A,Republican Period,7,-350,-30,320,0.30000001
645,Mandra,A,Early Imperial Period,8,-30,100,130,0.30000001
645,Mandra,A,Mid-Imperial Period,9,100,300,200,0.30000001
648,La Starza,A,Republican Period,7,-350,-30,320,0.050000001
649,,A,Early Iron Age,4,-1000,-750,250,0.050000001
649,,A,Late Iron Age,5,-750,-600,150,0.050000001
649,,B,Republican Period,7,-350,-200,150,0.050000001
650,,A,Early Iron Age,4,-1000,-750,250,0.1
650,,A,Late Iron Age,5,-750,-600,150,0.1
650,,B,Republican Period,7,-350,-30,320,0.1
650,,B,Early Imperial Period,8,-30,100,130,0.1
651,,A,Early Bronze Age,1,-2300,-1700,600,0.1
651,,A,Middle Bronze Age,2,-1700,-1300,400,0.1
651,,A,Late Bronze Age,3,-1300,-1020,280,0.1
651,,A,Early Iron Age,4,-1020,-750,270,0.1
651,,A,Late Iron Age,5,-750,-600,150,0.1
652,,A,Republican Period,7,-100,-30,70,0.1
652,,A,Early Imperial Period,8,-30,100,130,0.1
652,,A,Mid-Imperial Period,9,100,300,200,0.1
652,,A,Late Imperial Period,10,300,500,200,0.1
653,,A,Early Bronze Age,1,-2300,-1700,600,0.2
653,,A,Middle Bronze Age,2,-1700,-1300,400,0.2
653,,A,Late Bronze Age,3,-1300,-1020,280,0.2
653,,A,Early Iron Age,4,-1020,-1000,20,0.2
654,,A,Early Iron Age,4,-1000,-750,250,0.050000001
654,,A,Late Iron Age,5,-750,-600,150,0.050000001
655,,A,Late Iron Age,5,-700,-600,100,1
655,,B,Republican Period,7,-350,-30,320,1
656,,A,Early Iron Age,4,-1000,-750,250,0.1
656,,A,Late Iron Age,5,-750,-600,150,0.1
656,,B,Republican Period,7,-350,-30,320,0.1
656,,B,Early Imperial Period,8,-30,100,130,0.1
656,,B,Mid-Imperial Period,9,100,300,200,0.1
656,,B,Late Imperial Period,10,300,500,200,0.1
657,,A,Late Iron Age,5,-700,-600,100,0.1
657,,B,Republican Period,7,-350,-30,320,0.1
657,,B,Early Imperial Period,8,-30,100,130,0.1
657,,B,Mid-Imperial Period,9,100,300,200,0.1
657,,B,Late Imperial Period,10,300,500,200,0.1
658,,A,Early Imperial Period,8,-30,100,130,1
658,,A,Mid-Imperial Period,9,100,300,200,1
659,,A,Republican Period,7,-350,-30,320,0.69999999
659,,A,Early Imperial Period,8,-30,100,130,0.69999999
659,,A,Mid-Imperial Period,9,100,300,200,0.69999999
660,,A,Early Iron Age,4,-1000,-750,250,0.2
660,,A,Late Iron Age,5,-750,-600,150,0.2
660,,B,Republican Period,7,-350,-30,320,0.2
661,,A,Early Iron Age,4,-1000,-750,250,0.1
661,,A,Late Iron Age,5,-750,-600,150,0.1
661,,B,Republican Period,7,-350,-30,320,0.1
661,,B,Early Imperial Period,8,-30,100,130,0.1
662,,A,Early Imperial Period,8,-30,100,130,0.2
662,,A,Mid-Imperial Period,9,100,300,200,0.2
663,,A,Republican Period,7,-100,-30,70,0.69999999
663,,A,Early Imperial Period,8,-30,100,130,0.69999999
663,,A,Mid-Imperial Period,9,100,300,200,0.69999999
663,,A,Late Imperial Period,10,300,500,200,0.69999999
665,Parito,A,Republican Period,7,-350,-30,320,0.5
665,Parito,A,Early Imperial Period,8,-30,100,130,0.5
665,Parito,A,Mid-Imperial Period,9,100,300,200,0.5
665,Parito,A,Late Imperial Period,10,300,500,200,0.5
666,Parito,A,Republican Period,7,-100,-30,70,4
666,Parito,A,Early Imperial Period,8,-30,100,130,4
666,Parito,A,Mid-Imperial Period,9,100,300,200,4
666,Parito,A,Late Imperial Period,10,300,500,200,4
667,,A,Early Iron Age,4,-1000,-750,250,0.050000001
667,,A,Late Iron Age,5,-750,-600,150,0.050000001
667,,B,Republican Period,7,-350,-200,150,0.050000001
668,,A,Republican Period,7,-350,-30,320,0.050000001
668,,A,Early Imperial Period,8,-30,100,130,0.050000001
668,,A,Mid-Imperial Period,9,100,300,200,0.050000001
668,,A,Late Imperial Period,10,300,500,200,0.050000001
669,,A,Republican Period,7,-350,-30,320,1.5
669,,A,Early Imperial Period,8,-30,100,130,1.5
669,,A,Mid-Imperial Period,9,100,300,200,1.5
669,,A,Late Imperial Period,10,300,500,200,1.5
670,,A,Early Bronze Age,1,-2300,-1700,600,0.050000001
670,,A,Middle Bronze Age,2,-1700,-1300,400,0.050000001
670,,A,Late Bronze Age,3,-1300,-1020,280,0.050000001
670,,A,Early Iron Age,4,-1020,-750,270,0.050000001
670,,A,Late Iron Age,5,-750,-600,150,0.050000001
671,,A,Early Iron Age,4,-1000,-750,250,0.050000001
671,,A,Late Iron Age,5,-750,-600,150,0.050000001
672,,A,Republican Period,7,-100,-30,70,0.30000001
672,,A,Early Imperial Period,8,-30,100,130,0.30000001
673,,A,Early Iron Age,4,-1000,-750,250,0.1
673,,A,Late Iron Age,5,-750,-600,150,0.1
674,,A,Republican Period,7,-350,-30,320,0.050000001
675,,A,Republican Period,7,-350,-30,320,0.40000001
675,,A,Early Imperial Period,8,-30,100,130,0.40000001
676,,A,Republican Period,7,-100,-30,70,0.050000001
676,,A,Early Imperial Period,8,-30,100,130,0.050000001
677,,A,Republican Period,7,-350,-30,320,0.2
677,,A,Early Imperial Period,8,-30,100,130,0.2
677,,A,Mid-Imperial Period,9,100,300,200,0.2
678,,A,Republican Period,7,-350,-30,320,1.5
678,,A,Early Imperial Period,8,-30,100,130,1.5
678,,A,Mid-Imperial Period,9,100,300,200,1.5
678,,A,Late Imperial Period,10,300,500,200,1.5
679,,A,Late Iron Age,5,-700,-600,100,1.5
679,,B,Republican Period,7,-350,-30,320,1.5
679,,B,Early Imperial Period,8,-30,100,130,1.5
679,,B,Mid-Imperial Period,9,100,300,200,1.5
679,,B,Late Imperial Period,10,300,500,200,1.5
680,S. Scolastica,A,Early Iron Age,4,-1000,-750,250,1
680,S. Scolastica,A,Late Iron Age,5,-750,-600,150,1
680,S. Scolastica,B,Republican Period,7,-350,-30,320,0.2
680,S. Scolastica,B,Early Imperial Period,8,-30,100,130,0.2
680,S. Scolastica,B,Mid-Imperial Period,9,100,300,200,0.2
680,S. Scolastica,B,Late Imperial Period,10,300,500,200,0.2
681,,A,Republican Period,7,-100,-30,70,0.30000001
681,,A,Early Imperial Period,8,-30,100,130,0.30000001
681,,A,Mid-Imperial Period,9,100,300,200,0.30000001
681,,A,Late Imperial Period,10,300,500,200,0.30000001
682,,A,Republican Period,7,-100,-30,70,0.2
682,,A,Early Imperial Period,8,-30,100,130,0.2
682,,A,Mid-Imperial Period,9,100,300,200,0.2
682,,A,Late Imperial Period,10,300,500,200,0.2
683,,A,Republican Period,7,-100,-30,70,0.050000001
683,,A,Early Imperial Period,8,-30,100,130,0.050000001
683,,A,Mid-Imperial Period,9,100,300,200,0.050000001
684,,A,Republican Period,7,-100,-30,70,0.69999999
684,,A,Early Imperial Period,8,-30,100,130,0.69999999
684,,A,Mid-Imperial Period,9,100,300,200,0.69999999
684,,A,Late Imperial Period,10,300,500,200,0.69999999
685,,A,Republican Period,7,-100,-30,70,0.1
685,,A,Early Imperial Period,8,-30,100,130,0.1
685,,A,Mid-Imperial Period,9,100,300,200,0.1
685,,A,Late Imperial Period,10,300,500,200,0.1
686,,A,Republican Period,7,-350,-30,320,0.2
686,,A,Early Imperial Period,8,-30,100,130,0.2
686,,A,Mid-Imperial Period,9,100,300,200,0.2
686,,A,Late Imperial Period,10,300,500,200,0.2
687,,A,Republican Period,7,-100,-30,70,0.2
687,,A,Early Imperial Period,8,-30,100,130,0.2
687,,A,Mid-Imperial Period,9,100,300,200,0.2
687,,A,Late Imperial Period,10,300,500,200,0.2
688,,A,Republican Period,7,-100,-30,70,0.40000001
688,,A,Early Imperial Period,8,-30,100,130,0.40000001
688,,A,Mid-Imperial Period,9,100,300,200,0.40000001
688,,A,Late Imperial Period,10,300,500,200,0.40000001
689,,A,Republican Period,7,-100,-30,70,0.5
689,,A,Early Imperial Period,8,-30,100,130,0.5
689,,A,Mid-Imperial Period,9,100,300,200,0.5
689,,A,Late Imperial Period,10,300,500,200,0.5
690,,A,Republican Period,7,-100,-30,70,0.2
690,,A,Early Imperial Period,8,-30,100,130,0.2
690,,A,Mid-Imperial Period,9,100,300,200,0.2
690,,A,Late Imperial Period,10,300,500,200,0.2
691,,A,Republican Period,7,-100,-30,70,0.039999999
691,,A,Early Imperial Period,8,-30,100,130,0.039999999
691,,A,Mid-Imperial Period,9,100,300,200,0.039999999
691,,A,Late Imperial Period,10,300,500,200,0.039999999
692,,A,Republican Period,7,-350,-30,320,0.2
692,,A,Early Imperial Period,8,-30,100,130,0.2
692,,A,Mid-Imperial Period,9,100,300,200,0.2
692,,A,Late Imperial Period,10,300,500,200,0.2
693,,A,Republican Period,7,-100,-30,70,0.2
693,,A,Early Imperial Period,8,-30,100,130,0.2
694,,A,Republican Period,7,-100,-30,70,0.5
694,,A,Early Imperial Period,8,-30,100,130,0.5
694,,A,Mid-Imperial Period,9,100,300,200,0.5
694,,A,Late Imperial Period,10,300,500,200,0.5
695,,A,Republican Period,7,-100,-30,70,0.89999998
695,,A,Early Imperial Period,8,-30,100,130,0.89999998
695,,A,Mid-Imperial Period,9,100,300,200,0.89999998
696,,A,Early Imperial Period,8,-30,100,130,0.1
696,,A,Mid-Imperial Period,9,100,300,200,0.1
696,,A,Late Imperial Period,10,300,500,200,0.1
697,,A,Late Iron Age,5,-700,-600,100,0.1
697,,B,Republican Period,7,-350,-200,150,0.1
698,,A,Republican Period,7,-100,-30,70,0.40000001
698,,A,Early Imperial Period,8,-30,100,130,0.40000001
698,,A,Mid-Imperial Period,9,100,300,200,0.40000001
698,,A,Late Imperial Period,10,300,500,200,0.40000001
699,,A,Early Iron Age,4,-1000,-750,250,0.40000001
699,,A,Late Iron Age,5,-750,-600,150,0.40000001
699,,B,Republican Period,7,-350,-30,320,0.40000001
700,Ponte Fraiola,A,Republican Period,7,-350,-30,320,0.2
700,Ponte Fraiola,A,Early Imperial Period,8,-30,100,130,0.2
700,Ponte Fraiola,A,Mid-Imperial Period,9,100,300,200,0.2
700,Ponte Fraiola,A,Late Imperial Period,10,300,500,200,0.2
701,,A,Republican Period,7,-350,-30,320,0.5
701,,A,Early Imperial Period,8,-30,100,130,0.5
701,,A,Mid-Imperial Period,9,100,300,200,0.5
702,,A,Republican Period,7,-100,-30,70,0.059999999
702,,A,Early Imperial Period,8,-30,100,130,0.059999999
703,,A,Republican Period,7,-100,-30,70,0.40000001
703,,A,Early Imperial Period,8,-30,100,130,0.40000001
703,,A,Mid-Imperial Period,9,100,300,200,0.40000001
704,,A,Republican Period,7,-350,-30,320,0.1
704,,A,Early Imperial Period,8,-30,100,130,0.1
704,,A,Mid-Imperial Period,9,100,300,200,0.1
704,,A,Late Imperial Period,10,300,500,200,0.1
705,,A,Republican Period,7,-100,-30,70,0.5
705,,A,Early Imperial Period,8,-30,100,130,0.5
705,,A,Mid-Imperial Period,9,100,300,200,0.5
705,,A,Late Imperial Period,10,300,500,200,0.5
706,,A,Republican Period,7,-100,-30,70,0.1
706,,A,Early Imperial Period,8,-30,100,130,0.1
706,,A,Mid-Imperial Period,9,100,300,200,0.1
707,,A,Republican Period,7,-350,-30,320,0.1
707,,A,Early Imperial Period,8,-30,100,130,0.1
707,,A,Mid-Imperial Period,9,100,300,200,0.1
707,,A,Late Imperial Period,10,300,500,200,0.1
708,,A,Republican Period,7,-100,-30,70,2
708,,A,Early Imperial Period,8,-30,100,130,2
708,,A,Mid-Imperial Period,9,100,300,200,2
709,,A,Republican Period,7,-350,-30,320,0.5
709,,A,Early Imperial Period,8,-30,100,130,0.5
709,,A,Mid-Imperial Period,9,100,300,200,0.5
709,,A,Late Imperial Period,10,300,500,200,0.5
710,,A,Republican Period,7,-350,-30,320,0.1
710,,B,Mid-Imperial Period,9,100,300,200,0.1
711,,A,Republican Period,7,-350,-30,320,0.2
711,,A,Early Imperial Period,8,-30,100,130,0.2
711,,A,Mid-Imperial Period,9,100,300,200,0.2
712,,A,Mid-Imperial Period,9,100,300,200,0.1
712,,A,Late Imperial Period,10,300,500,200,0.1
713,,A,Republican Period,7,-350,-30,320,0.69999999
714,,A,Republican Period,7,-350,-30,320,2
714,,A,Early Imperial Period,8,-30,100,130,2
714,,A,Mid-Imperial Period,9,100,300,200,2
714,,A,Late Imperial Period,10,300,500,200,2
715,,A,Republican Period,7,-350,-30,320,0.5
715,,A,Early Imperial Period,8,-30,100,130,0.5
715,,A,Mid-Imperial Period,9,100,300,200,0.5
715,,A,Late Imperial Period,10,300,500,200,0.5
716,,A,Republican Period,7,-350,-30,320,0.1
716,,A,Early Imperial Period,8,-30,100,130,0.1
716,,A,Mid-Imperial Period,9,100,300,200,0.1
717,,A,Republican Period,7,-100,-30,70,0.69999999
718,,A,Republican Period,7,-350,-30,320,1
718,,A,Early Imperial Period,8,-30,100,130,1
718,,A,Mid-Imperial Period,9,100,300,200,1
718,,A,Late Imperial Period,10,300,500,200,1
719,,A,Republican Period,7,-350,-30,320,3
719,,A,Early Imperial Period,8,-30,100,130,3
719,,A,Mid-Imperial Period,9,100,300,200,3
719,,A,Late Imperial Period,10,300,500,200,3
720,,A,Republican Period,7,-100,-30,70,0.050000001
720,,A,Early Imperial Period,8,-30,100,130,0.050000001
720,,A,Mid-Imperial Period,9,100,300,200,0.050000001
721,,A,Republican Period,7,-350,-30,320,0.5
721,,A,Early Imperial Period,8,-30,100,130,0.5
721,,A,Mid-Imperial Period,9,100,300,200,0.5
721,,A,Late Imperial Period,10,300,500,200,0.5
722,,A,Republican Period,7,-350,-30,320,0.5
722,,A,Early Imperial Period,8,-30,100,130,0.5
722,,A,Mid-Imperial Period,9,100,300,200,0.5
722,,A,Late Imperial Period,10,300,500,200,0.5
723,,A,Republican Period,7,-200,-30,170,0.5
723,,A,Early Imperial Period,8,-30,100,130,0.5
723,,A,Mid-Imperial Period,9,100,300,200,0.5
724,,A,Republican Period,7,-100,-30,70,0.1
724,,A,Early Imperial Period,8,-30,100,130,0.1
725,,A,Republican Period,7,-100,-30,70,0.1
725,,A,Early Imperial Period,8,-30,100,130,0.1
726,,A,Republican Period,7,-350,-30,320,0.5
727,,A,Republican Period,7,-350,-30,320,0.1
727,,A,Early Imperial Period,8,-30,100,130,0.1
727,,A,Mid-Imperial Period,9,100,300,200,0.1
727,,A,Late Imperial Period,10,300,500,200,0.1
728,,A,Republican Period,7,-350,-30,320,0.1
728,,A,Early Imperial Period,8,-30,100,130,0.1
728,,A,Mid-Imperial Period,9,100,300,200,0.1
728,,A,Late Imperial Period,10,300,500,200,0.1
729,,A,Republican Period,7,-350,-30,320,0.1
729,,A,Early Imperial Period,8,-30,100,130,0.1
729,,A,Mid-Imperial Period,9,100,300,200,0.1
729,,A,Late Imperial Period,10,300,500,200,0.1
730,,A,Republican Period,7,-350,-30,320,0.1
730,,A,Early Imperial Period,8,-30,100,130,0.1
730,,A,Mid-Imperial Period,9,100,300,200,0.1
730,,A,Late Imperial Period,10,300,500,200,0.1
731,,A,Republican Period,7,-100,-30,70,0.1
731,,A,Early Imperial Period,8,-30,100,130,0.1
731,,A,Mid-Imperial Period,9,100,300,200,0.1
732,,A,Republican Period,7,-100,-30,70,0.30000001
732,,A,Early Imperial Period,8,-30,100,130,0.30000001
732,,A,Mid-Imperial Period,9,100,300,200,0.30000001
733,,A,Republican Period,7,-100,-30,70,0.69999999
733,,A,Early Imperial Period,8,-30,100,130,0.69999999
733,,A,Mid-Imperial Period,9,100,300,200,0.69999999
733,,A,Late Imperial Period,10,300,500,200,0.69999999
734,,A,Republican Period,7,-100,-30,70,0.1
734,,A,Early Imperial Period,8,-30,100,130,0.1
735,,A,Mid-Imperial Period,9,100,300,200,0.5
735,,A,Late Imperial Period,10,300,500,200,0.5
736,,A,Early Imperial Period,8,-30,100,130,0.2
736,,A,Mid-Imperial Period,9,100,300,200,0.2
737,,A,Republican Period,7,-350,-30,320,0.1
737,,A,Early Imperial Period,8,-30,100,130,0.1
738,,A,Republican Period,7,-350,-30,320,0.1
739,,A,Republican Period,7,-350,-30,320,0.1
739,,A,Early Imperial Period,8,-30,100,130,0.1
739,,A,Mid-Imperial Period,9,100,300,200,0.1
740,,A,Republican Period,7,-100,-30,70,0.5
740,,A,Early Imperial Period,8,-30,100,130,0.5
740,,A,Mid-Imperial Period,9,100,300,200,0.5
741,,A,Republican Period,7,-100,-30,70,0.40000001
741,,A,Early Imperial Period,8,-30,100,130,0.40000001
742,,A,Republican Period,7,-350,-30,320,0.2
742,,A,Early Imperial Period,8,-30,100,130,0.2
742,,A,Mid-Imperial Period,9,100,300,200,0.2
742,,A,Late Imperial Period,10,300,500,200,0.2
743,,A,Republican Period,7,-100,-30,70,1
743,,A,Early Imperial Period,8,-30,100,130,1
743,,A,Mid-Imperial Period,9,100,300,200,1
744,,A,Republican Period,7,-100,-30,70,0.2
744,,A,Early Imperial Period,8,-30,100,130,0.2
744,,A,Mid-Imperial Period,9,100,300,200,0.2
744,,A,Late Imperial Period,10,300,500,200,0.2
745,,A,Republican Period,7,-100,-30,70,0.2
745,,A,Early Imperial Period,8,-30,100,130,0.2
745,,A,Mid-Imperial Period,9,100,300,200,0.2
745,,A,Late Imperial Period,10,300,500,200,0.2
746,,A,Republican Period,7,-100,-30,70,1.5
746,,A,Early Imperial Period,8,-30,100,130,1.5
746,,A,Mid-Imperial Period,9,100,300,200,1.5
747,,A,Republican Period,7,-350,-30,320,0.2
747,,A,Early Imperial Period,8,-30,100,130,0.2
747,,A,Mid-Imperial Period,9,100,300,200,0.2
747,,A,Late Imperial Period,10,300,500,200,0.2
748,,A,Republican Period,7,-350,-30,320,0.30000001
748,,A,Early Imperial Period,8,-30,100,130,0.30000001
748,,A,Mid-Imperial Period,9,100,300,200,0.30000001
748,,A,Late Imperial Period,10,300,500,200,0.30000001
749,,A,Republican Period,7,-350,-30,320,0.1
749,,A,Early Imperial Period,8,-30,100,130,0.1
749,,A,Mid-Imperial Period,9,100,300,200,0.1
749,,A,Late Imperial Period,10,300,500,200,0.1
750,,A,Republican Period,7,-350,-30,320,0.1
750,,A,Early Imperial Period,8,-30,100,130,0.1
750,,A,Mid-Imperial Period,9,100,300,200,0.1
751,,A,Republican Period,7,-350,-30,320,0.30000001
751,,A,Early Imperial Period,8,-30,100,130,0.30000001
751,,A,Mid-Imperial Period,9,100,300,200,0.30000001
751,,A,Late Imperial Period,10,300,500,200,0.30000001
752,,A,Republican Period,7,-100,-30,70,0.40000001
752,,A,Early Imperial Period,8,-30,100,130,0.40000001
752,,A,Mid-Imperial Period,9,100,300,200,0.40000001
753,,A,Republican Period,7,-350,-30,320,0.1
753,,A,Early Imperial Period,8,-30,100,130,0.1
753,,A,Mid-Imperial Period,9,100,300,200,0.1
753,,A,Late Imperial Period,10,300,500,200,0.1
754,,A,Republican Period,7,-350,-30,320,0.30000001
754,,A,Early Imperial Period,8,-30,100,130,0.30000001
754,,A,Mid-Imperial Period,9,100,300,200,0.30000001
754,,A,Late Imperial Period,10,300,500,200,0.30000001
755,,A,Republican Period,7,-350,-30,320,0.1
755,,A,Early Imperial Period,8,-30,100,130,0.1
755,,A,Mid-Imperial Period,9,100,300,200,0.1
755,,A,Late Imperial Period,10,300,500,200,0.1
756,,A,Early Imperial Period,8,-30,100,130,0.1
756,,A,Mid-Imperial Period,9,100,300,200,0.1
757,,A,Republican Period,7,-350,-30,320,1
758,,A,Republican Period,7,-350,-30,320,0.2
758,,A,Early Imperial Period,8,-30,100,130,0.2
758,,A,Mid-Imperial Period,9,100,300,200,0.2
758,,A,Late Imperial Period,10,300,500,200,0.2
759,,A,Republican Period,7,-350,-30,320,0.1
759,,A,Early Imperial Period,8,-30,100,130,0.1
759,,A,Mid-Imperial Period,9,100,300,200,0.1
759,,A,Late Imperial Period,10,300,500,200,0.1
760,,A,Early Imperial Period,8,-30,100,130,0.5
760,,A,Mid-Imperial Period,9,100,300,200,0.5
761,,A,Early Imperial Period,8,-30,100,130,0.80000001
761,,A,Mid-Imperial Period,9,100,300,200,0.80000001
762,,A,Republican Period,7,-100,-30,70,2
762,,A,Early Imperial Period,8,-30,100,130,2
762,,A,Mid-Imperial Period,9,100,300,200,2
762,,A,Late Imperial Period,10,300,500,200,2
763,,A,Republican Period,7,-350,-30,320,0.1
763,,A,Early Imperial Period,8,-30,100,130,0.1
764,,A,Early Iron Age,4,-1000,-750,250,0.1
764,,A,Late Iron Age,5,-750,-600,150,0.1
764,,B,Republican Period,7,-350,-30,320,0.1
764,,B,Early Imperial Period,8,-30,100,130,0.1
764,,B,Mid-Imperial Period,9,100,300,200,0.1
765,,A,Republican Period,7,-350,-30,320,0.60000002
765,,A,Early Imperial Period,8,-30,100,130,0.60000002
766,,A,Republican Period,7,-100,-30,70,1
766,,A,Early Imperial Period,8,-30,100,130,1
766,,A,Mid-Imperial Period,9,100,300,200,1
767,,A,Republican Period,7,-100,-30,70,0.2
767,,A,Early Imperial Period,8,-30,100,130,0.2
767,,A,Mid-Imperial Period,9,100,300,200,0.2
768,,A,Mid-Imperial Period,9,100,300,200,1
769,,A,Republican Period,7,-100,-30,70,0.1
769,,A,Early Imperial Period,8,-30,100,130,0.1
769,,A,Mid-Imperial Period,9,100,300,200,0.1
769,,A,Late Imperial Period,10,300,500,200,0.1
770,,A,Republican Period,7,-350,-30,320,0.1
770,,A,Early Imperial Period,8,-30,100,130,0.1
770,,A,Mid-Imperial Period,9,100,300,200,0.1
771,,A,Republican Period,7,-100,-30,70,0.5
771,,A,Early Imperial Period,8,-30,100,130,0.5
771,,A,Mid-Imperial Period,9,100,300,200,0.5
771,,A,Late Imperial Period,10,300,500,200,0.5
772,,A,Republican Period,7,-100,-30,70,0.1
772,,A,Early Imperial Period,8,-30,100,130,0.1
772,,A,Mid-Imperial Period,9,100,300,200,0.1
773,,A,Republican Period,7,-100,-30,70,0.89999998
773,,A,Early Imperial Period,8,-30,100,130,0.89999998
773,,A,Mid-Imperial Period,9,100,300,200,0.89999998
774,,A,Republican Period,7,-100,-30,70,0.1
774,,A,Early Imperial Period,8,-30,100,130,0.1
774,,A,Mid-Imperial Period,9,100,300,200,0.1
774,,A,Late Imperial Period,10,300,500,200,0.1
775,,A,Republican Period,7,-100,-30,70,1
775,,A,Early Imperial Period,8,-30,100,130,1
775,,A,Mid-Imperial Period,9,100,300,200,1
775,,A,Late Imperial Period,10,300,500,200,1
776,,A,Early Iron Age,4,-1000,-750,250,0.1
776,,A,Late Iron Age,5,-750,-600,150,0.1
776,,B,Republican Period,7,-100,-30,70,0.1
776,,B,Early Imperial Period,8,-30,100,130,0.1
776,,B,Mid-Imperial Period,9,100,300,200,0.1
776,,B,Late Imperial Period,10,300,500,200,0.1
777,,A,Republican Period,7,-100,-30,70,0.80000001
777,,A,Early Imperial Period,8,-30,100,130,0.80000001
777,,A,Mid-Imperial Period,9,100,300,200,0.80000001
778,,A,Early Iron Age,4,-1000,-750,250,0.5
778,,A,Late Iron Age,5,-750,-600,150,0.5
779,,A,Early Iron Age,4,-1000,-750,250,0.1
779,,A,Late Iron Age,5,-750,-600,150,0.1
780,,A,Early Iron Age,4,-1000,-750,250,0.1
780,,A,Late Iron Age,5,-750,-600,150,0.1
781,,A,Republican Period,7,-350,-30,320,0.1
781,,A,Early Imperial Period,8,-30,100,130,0.1
782,,A,Early Iron Age,4,-1000,-750,250,0.2
782,,A,Late Iron Age,5,-750,-600,150,0.2
782,,B,Republican Period,7,-100,-30,70,0.2
782,,B,Early Imperial Period,8,-30,100,130,0.2
783,,A,Republican Period,7,-350,-30,320,0.1
783,,A,Early Imperial Period,8,-30,100,130,0.1
784,,A,Republican Period,7,-100,-30,70,0.5
784,,A,Early Imperial Period,8,-30,100,130,0.5
784,,A,Mid-Imperial Period,9,100,300,200,0.5
785,,A,Early Iron Age,4,-1000,-750,250,0.1
785,,A,Late Iron Age,5,-750,-600,150,0.1
785,,B,Republican Period,7,-100,-30,70,0.1
785,,B,Early Imperial Period,8,-30,100,130,0.1
785,,B,Mid-Imperial Period,9,100,300,200,0.1
786,,A,Early Imperial Period,8,-30,100,130,0.1
786,,A,Mid-Imperial Period,9,100,300,200,0.1
786,,A,Late Imperial Period,10,300,500,200,0.1
787,,A,Early Iron Age,4,-1000,-750,250,0.2
787,,A,Late Iron Age,5,-750,-600,150,0.2
787,,B,Republican Period,7,-350,-30,320,0.2
787,,B,Early Imperial Period,8,-30,100,130,0.2
787,,B,Mid-Imperial Period,9,100,300,200,0.2
787,,B,Late Imperial Period,10,300,500,200,0.2
788,Morroni,A,Early Bronze Age,1,-2300,-1700,600,0.2
788,Morroni,A,Middle Bronze Age,2,-1700,-1300,400,0.2
788,Morroni,A,Late Bronze Age,3,-1300,-1020,280,0.2
788,Morroni,B,Early Iron Age,4,-1020,-750,270,0.2
788,Morroni,B,Late Iron Age,5,-750,-600,150,0.2
788,Morroni,C,Republican Period,7,-350,-30,320,0.2
789,Monte Trocchio,A,Early Iron Age,4,-1000,-750,250,0.1
789,Monte Trocchio,A,Late Iron Age,5,-750,-600,150,0.1
790,,A,Early Iron Age,4,-1000,-750,250,0.2
790,,A,Late Iron Age,5,-750,-600,150,0.2
791,,A,Republican Period,7,-100,-30,70,0.30000001
791,,A,Early Imperial Period,8,-30,100,130,0.30000001
791,,A,Mid-Imperial Period,9,100,300,200,0.30000001
791,,A,Late Imperial Period,10,300,500,200,0.2
792,,A,Republican Period,7,-350,-30,320,4
792,,A,Early Imperial Period,8,-30,100,130,4
792,,A,Mid-Imperial Period,9,100,300,200,4
792,,A,Late Imperial Period,10,300,500,200,4
793,,A,Republican Period,7,-100,-30,70,1
793,,A,Early Imperial Period,8,-30,100,130,1
794,,A,Republican Period,7,-350,-30,320,0.1
794,,A,Early Imperial Period,8,-30,100,130,0.1
794,,A,Mid-Imperial Period,9,100,300,200,0.1
794,,A,Late Imperial Period,10,300,500,200,0.1
795,,A,Republican Period,7,-350,-30,320,0.1
795,,A,Early Imperial Period,8,-30,100,130,0.1
795,,A,Mid-Imperial Period,9,100,300,200,0.1
796,,A,Early Imperial Period,8,-30,100,130,0.1
796,,A,Mid-Imperial Period,9,100,300,200,0.1
797,,A,Republican Period,7,-350,-30,320,1.5
797,,A,Early Imperial Period,8,-30,100,130,1.5
797,,A,Mid-Imperial Period,9,100,300,200,1.5
797,,A,Late Imperial Period,10,300,500,200,1.5
798,,A,Republican Period,7,-100,-30,70,0.1
798,,A,Early Imperial Period,8,-30,100,130,0.1
798,,A,Mid-Imperial Period,9,100,300,200,0.1
799,,A,Republican Period,7,-100,-30,70,0.1
800,,A,Republican Period,7,-100,-30,70,0.2
800,,A,Early Imperial Period,8,-30,100,130,0.2
800,,A,Mid-Imperial Period,9,100,300,200,0.2
801,,A,Republican Period,7,-350,-30,320,0.2
801,,A,Early Imperial Period,8,-30,100,130,0.2
801,,A,Mid-Imperial Period,9,100,300,200,0.2
801,,A,Late Imperial Period,10,300,500,200,0.2
802,,A,Republican Period,7,-350,-30,320,0.1
802,,A,Early Imperial Period,8,-30,100,130,0.1
802,,A,Mid-Imperial Period,9,100,300,200,0.1
802,,A,Late Imperial Period,10,300,500,200,0.1
803,,A,Republican Period,7,-350,-30,320,0.30000001
803,,A,Early Imperial Period,8,-30,100,130,0.30000001
803,,A,Mid-Imperial Period,9,100,300,200,0.30000001
804,,A,Early Imperial Period,8,-30,100,130,0.30000001
804,,A,Mid-Imperial Period,9,100,300,200,0.30000001
804,,A,Late Imperial Period,10,300,500,200,0.30000001
805,,A,Early Imperial Period,8,-30,100,130,0.2
806,,A,Early Imperial Period,8,-30,100,130,0.2
806,,A,Mid-Imperial Period,9,100,200,100,0.2
807,,A,Early Imperial Period,8,-30,100,130,0.2
808,,A,Late Iron Age,5,-600,-580,20,0.40000001
808,,A,Archaic Period,6,-580,-350,230,0.40000001
808,,A,Republican Period,7,-350,-300,50,0.40000001
809,,A,Early Imperial Period,8,-30,100,130,0.5
810,Monte Fil di Ferro,A,Late Iron Age,5,-600,-580,20,0.69999999
810,Monte Fil di Ferro,A,Archaic Period,6,-580,-350,230,0.69999999
810,Monte Fil di Ferro,A,Republican Period,7,-350,-200,150,0.69999999
811,Monte Fil di Ferro,A,Republican Period,7,-200,-30,170,0.69999999
811,Monte Fil di Ferro,A,Early Imperial Period,8,-30,100,130,0.69999999
811,Monte Fil di Ferro,A,Mid-Imperial Period,9,100,300,200,0.69999999
811,Monte Fil di Ferro,A,Late Imperial Period,10,300,500,200,0.69999999
812,Monte Fil di Ferro,A,Republican Period,7,-200,-30,170,0.30000001
812,Monte Fil di Ferro,A,Early Imperial Period,8,-30,100,130,0.30000001
813,,A,Early Iron Age,4,-1000,-750,250,0.1
813,,A,Late Iron Age,5,-750,-700,50,0.1
814,Quarto della Torre,A,Late Iron Age,5,-600,-580,20,0.2
814,Quarto della Torre,A,Archaic Period,6,-580,-500,80,0.2
815,Piano Trippone,A,Late Iron Age,5,-600,-580,20,0.2
815,Piano Trippone,A,Archaic Period,6,-580,-500,80,0.2
815,Piano Trippone,B,Republican Period,7,-200,-30,170,0.2
816,Piano Trippone,A,Republican Period,7,-100,-30,70,0.30000001
816,Piano Trippone,A,Early Imperial Period,8,-30,100,130,0.30000001
816,Piano Trippone,A,Mid-Imperial Period,9,100,300,200,0.30000001
816,Piano Trippone,A,Late Imperial Period,10,300,500,200,0.30000001
817,Tragliatella C.le Nuovo,A,Republican Period,7,-100,-30,70,0.40000001
817,Tragliatella C.le Nuovo,A,Early Imperial Period,8,-30,100,130,0.40000001
817,Tragliatella C.le Nuovo,A,Mid-Imperial Period,9,100,300,200,0.40000001
817,Tragliatella C.le Nuovo,A,Late Imperial Period,10,300,500,200,0.40000001
818,Vitellonara,A,Late Iron Age,5,-600,-580,20,0.40000001
818,Vitellonara,A,Archaic Period,6,-580,-500,80,0.40000001
818,Vitellonara,B,Republican Period,7,-200,-30,170,0.40000001
818,Vitellonara,C,Late Imperial Period,10,300,500,200,0.40000001
819,Piano Trippone,A,Late Iron Age,5,-600,-580,20,1
819,Piano Trippone,A,Archaic Period,6,-580,-350,230,1
819,Piano Trippone,A,Republican Period,7,-350,-300,50,1
819,Piano Trippone,B,Mid-Imperial Period,9,200,300,100,1
819,Piano Trippone,B,Late Imperial Period,10,300,500,200,1
820,,A,Late Bronze Age,3,-1200,-1020,180,0.1
820,,A,Early Iron Age,4,-1020,-1000,20,0.1
820,,B,Late Iron Age,5,-700,-600,100,0.1
821,Torre Pascolaro,A,Late Bronze Age,3,-1200,-1020,180,0.5
821,Torre Pascolaro,A,Early Iron Age,4,-1020,-1000,20,0.5
821,Torre Pascolaro,B,Republican Period,7,-100,-30,70,0.5
821,Torre Pascolaro,B,Early Imperial Period,8,-30,100,130,0.5
821,Torre Pascolaro,B,Mid-Imperial Period,9,100,300,200,0.5
821,Torre Pascolaro,B,Late Imperial Period,10,300,500,200,0.5
822,Vitellonara,A,Republican Period,7,-100,-30,70,1
822,Vitellonara,A,Early Imperial Period,8,-30,100,130,1
822,Vitellonara,A,Mid-Imperial Period,9,100,300,200,1
822,Vitellonara,A,Late Imperial Period,10,300,500,200,1
823,Vitellonara,A,Late Iron Age,5,-600,-580,20,0.1
823,Vitellonara,A,Archaic Period,6,-580,-350,230,0.1
823,Vitellonara,A,Republican Period,7,-350,-30,320,0.1
823,Vitellonara,A,Early Imperial Period,8,-30,100,130,0.1
823,Vitellonara,A,Mid-Imperial Period,9,100,300,200,0.1
823,Vitellonara,A,Late Imperial Period,10,300,500,200,0.1
824,Rimessini,A,Republican Period,7,-100,-30,70,0.40000001
824,Rimessini,A,Early Imperial Period,8,-30,100,130,0.40000001
825,Rimessini,A,Republican Period,7,-100,-30,70,0.1
825,Rimessini,A,Early Imperial Period,8,-30,100,130,0.1
825,Rimessini,A,Mid-Imperial Period,9,100,300,200,0.1
825,Rimessini,A,Late Imperial Period,10,300,500,200,0.1
826,Rimessini,A,Republican Period,7,-100,-30,70,0.2
827,Rimessini,A,Republican Period,7,-100,-30,70,0.2
827,Rimessini,A,Early Imperial Period,8,-30,100,130,0.2
828,Rimessini,A,Archaic Period,6,-500,-350,150,0.30000001
828,Rimessini,A,Republican Period,7,-350,-30,320,0.30000001
828,Rimessini,A,Early Imperial Period,8,-30,100,130,0.30000001
829,Rimessini,A,Late Iron Age,5,-600,-580,20,0.69999999
829,Rimessini,A,Archaic Period,6,-580,-350,230,0.69999999
829,Rimessini,A,Republican Period,7,-350,-300,50,0.69999999
830,Rimessini,A,Late Iron Age,5,-600,-580,20,1
830,Rimessini,A,Archaic Period,6,-580,-350,230,1
830,Rimessini,A,Republican Period,7,-350,-30,320,1
830,Rimessini,A,Early Imperial Period,8,-30,100,130,1
830,Rimessini,A,Mid-Imperial Period,9,100,300,200,1
830,Rimessini,A,Late Imperial Period,10,300,500,200,1
831,Quarto di S. Giovanni,A,Late Iron Age,5,-600,-580,20,0.60000002
831,Quarto di S. Giovanni,A,Archaic Period,6,-580,-350,230,0.60000002
831,Quarto di S. Giovanni,A,Republican Period,7,-350,-100,250,0.60000002
832,,A,Early Bronze Age,1,-2300,-1700,600,0.2
832,,A,Middle Bronze Age,2,-1700,-1300,400,0.2
832,,A,Late Bronze Age,3,-1300,-1020,280,0.2
832,,A,Early Iron Age,4,-1020,-1000,20,0.2
832,,B,Late Iron Age,5,-600,-580,20,0.2
832,,B,Archaic Period,6,-580,-500,80,0.2
833,Quarto di S. Giovanni,A,Late Iron Age,5,-600,-580,20,0.5
833,Quarto di S. Giovanni,A,Archaic Period,6,-580,-500,80,0.5
833,Quarto di S. Giovanni,B,Republican Period,7,-100,-30,70,0.5
833,Quarto di S. Giovanni,B,Early Imperial Period,8,-30,100,130,0.5
833,Quarto di S. Giovanni,B,Mid-Imperial Period,9,100,300,200,0.5
833,Quarto di S. Giovanni,B,Late Imperial Period,10,300,500,200,0.5
834,Quarto di S. Giovanni,A,Archaic Period,6,-500,-350,150,0.30000001
834,Quarto di S. Giovanni,A,Republican Period,7,-350,-30,320,0.30000001
834,Quarto di S. Giovanni,A,Early Imperial Period,8,-30,100,130,0.30000001
834,Quarto di S. Giovanni,A,Mid-Imperial Period,9,100,300,200,0.30000001
834,Quarto di S. Giovanni,A,Late Imperial Period,10,300,500,200,0.30000001
835,Quarto di S. Giovanni,A,Archaic Period,6,-500,-350,150,0.40000001
835,Quarto di S. Giovanni,A,Republican Period,7,-350,-30,320,0.40000001
836,C.le S. Giovanni,A,Republican Period,7,-200,-30,170,1
836,C.le S. Giovanni,A,Early Imperial Period,8,-30,100,130,1
836,C.le S. Giovanni,A,Mid-Imperial Period,9,100,300,200,1
836,C.le S. Giovanni,A,Late Imperial Period,10,300,500,200,1
837,C.le S. Giovanni,A,Early Imperial Period,8,-30,100,130,0.1
838,Fosso della Caduta,A,Late Iron Age,5,-600,-580,20,0.1
838,Fosso della Caduta,A,Archaic Period,6,-580,-350,230,0.1
838,Fosso della Caduta,A,Republican Period,7,-350,-30,320,0.1
838,Fosso della Caduta,A,Early Imperial Period,8,-30,100,130,0.1
838,Fosso della Caduta,A,Mid-Imperial Period,9,100,300,200,0.1
838,Fosso della Caduta,A,Late Imperial Period,10,300,500,200,0.1
839,Fosso della Caduta,A,Late Bronze Age,3,-1200,-1020,180,0.1
839,Fosso della Caduta,A,Early Iron Age,4,-1020,-1000,20,0.1
840,Fosso della Caduta,A,Archaic Period,6,-500,-350,150,0.30000001
840,Fosso della Caduta,A,Republican Period,7,-350,-30,320,0.30000001
841,Quarto Casette di Tragliatella,A,Late Iron Age,5,-600,-580,20,0.5
841,Quarto Casette di Tragliatella,A,Archaic Period,6,-580,-350,230,0.5
841,Quarto Casette di Tragliatella,A,Republican Period,7,-350,-30,320,0.5
842,Quarto Casette,A,Early Imperial Period,8,-30,100,130,0.5
842,Quarto Casette,A,Mid-Imperial Period,9,100,300,200,0.5
842,Quarto Casette,A,Late Imperial Period,10,300,500,200,0.5
843,Quarto Casette,A,Archaic Period,6,-500,-350,150,0.30000001
843,Quarto Casette,A,Republican Period,7,-350,-30,320,0.30000001
844,Quarto Casette di Tragliatella,A,Republican Period,7,-200,-30,170,0.60000002
844,Quarto Casette di Tragliatella,A,Early Imperial Period,8,-30,100,130,0.60000002
844,Quarto Casette di Tragliatella,A,Mid-Imperial Period,9,100,300,200,0.60000002
844,Quarto Casette di Tragliatella,A,Late Imperial Period,10,300,500,200,0.60000002
845,Quarto Casette,A,Late Iron Age,5,-600,-580,20,0.30000001
845,Quarto Casette,A,Archaic Period,6,-580,-350,230,0.30000001
845,Quarto Casette,A,Republican Period,7,-350,-30,320,0.30000001
845,Quarto Casette,A,Early Imperial Period,8,-30,100,130,0.30000001
846,Fosso della Caduta,A,Republican Period,7,-200,-30,170,0.30000001
846,Fosso della Caduta,B,Late Imperial Period,10,300,500,200,0.30000001
847,Casale delle Quattro Casette,A,Republican Period,7,-200,-30,170,1
847,Casale delle Quattro Casette,A,Early Imperial Period,8,-30,100,130,1
847,Casale delle Quattro Casette,A,Mid-Imperial Period,9,100,300,200,1
848,,A,Archaic Period,6,-500,-400,100,0.21537551
848,Casale delle Quattro Casette,B,Early Imperial Period,8,-30,100,130,1
848,Casale delle Quattro Casette,B,Mid-Imperial Period,9,100,300,200,1
848,Casale delle Quattro Casette,B,Late Imperial Period,10,300,500,200,1
849,Casale delle Quattro Casette,A,Early Bronze Age,1,-2300,-1700,600,0.30000001
849,Casale delle Quattro Casette,A,Middle Bronze Age,2,-1700,-1300,400,0.30000001
849,Casale delle Quattro Casette,A,Late Bronze Age,3,-1300,-1020,280,0.30000001
849,Casale delle Quattro Casette,A,Early Iron Age,4,-1020,-1000,20,0.30000001
849,Casale delle Quattro Casette,B,Late Iron Age,5,-600,-580,20,0.30000001
849,Casale delle Quattro Casette,B,Archaic Period,6,-580,-350,230,0.30000001
849,Casale delle Quattro Casette,B,Republican Period,7,-350,-30,320,0.30000001
849,Casale delle Quattro Casette,B,Early Imperial Period,8,-30,100,130,0.30000001
850,Casale delle Quattro Casette,A,Early Imperial Period,8,-30,100,130,0.30000001
850,Casale delle Quattro Casette,A,Mid-Imperial Period,9,100,300,200,0.30000001
850,Casale delle Quattro Casette,A,Late Imperial Period,10,300,500,200,0.30000001
851,Casale delle Quattro Casette,A,Late Iron Age,5,-600,-580,20,0.30000001
851,Casale delle Quattro Casette,A,Archaic Period,6,-580,-500,80,0.30000001
851,Casale delle Quattro Casette,B,Republican Period,7,-200,-30,170,1.5
851,Casale delle Quattro Casette,B,Early Imperial Period,8,-30,100,130,1.5
851,Casale delle Quattro Casette,B,Mid-Imperial Period,9,100,300,200,1.5
852,C.le di Tragliatella,A,Mid-Imperial Period,9,100,300,200,0.2
853,C.le di Tragliatella,A,Late Iron Age,5,-600,-580,20,0.2
853,C.le di Tragliatella,A,Archaic Period,6,-580,-350,230,0.2
853,C.le di Tragliatella,A,Republican Period,7,-350,-30,320,0.2
853,C.le di Tragliatella,A,Early Imperial Period,8,-30,100,130,0.2
854,le Grotte,A,Early Imperial Period,8,-30,100,130,1
854,le Grotte,A,Mid-Imperial Period,9,100,300,200,1
854,le Grotte,A,Late Imperial Period,10,300,500,200,1
855,le Grotte,A,Archaic Period,6,-500,-350,150,0.2
855,le Grotte,A,Republican Period,7,-350,-30,320,0.2
855,le Grotte,A,Early Imperial Period,8,-30,100,130,0.2
855,le Grotte,A,Mid-Imperial Period,9,100,300,200,0.2
855,le Grotte,A,Late Imperial Period,10,300,500,200,0.2
856,le Grotte,A,Archaic Period,6,-500,-350,150,0.1
856,le Grotte,A,Republican Period,7,-350,-30,320,0.1
856,le Grotte,A,Early Imperial Period,8,-30,100,130,0.1
857,le Grotte,A,Late Iron Age,5,-600,-580,20,0.5
857,le Grotte,A,Archaic Period,6,-580,-350,230,0.5
857,le Grotte,A,Republican Period,7,-350,-30,320,0.5
857,le Grotte,A,Early Imperial Period,8,-30,100,130,0.5
857,le Grotte,A,Mid-Imperial Period,9,100,300,200,0.5
857,le Grotte,A,Late Imperial Period,10,300,500,200,0.5
858,le Grotte,A,Early Bronze Age,1,-2300,-1700,600,1
858,le Grotte,A,Middle Bronze Age,2,-1700,-1300,400,1
858,le Grotte,A,Late Bronze Age,3,-1300,-1020,280,1
858,le Grotte,A,Early Iron Age,4,-1020,-1000,20,1
858,le Grotte,B,Late Iron Age,5,-600,-580,20,1
858,le Grotte,B,Archaic Period,6,-580,-350,230,1
858,le Grotte,B,Republican Period,7,-350,-30,320,1
858,le Grotte,B,Early Imperial Period,8,-30,100,130,1
858,le Grotte,B,Mid-Imperial Period,9,100,300,200,1
859,Quarto della Caduta,A,Late Iron Age,5,-600,-580,20,0.30000001
859,Quarto della Caduta,A,Archaic Period,6,-580,-350,230,0.30000001
859,Quarto della Caduta,A,Republican Period,7,-350,-30,320,0.30000001
859,Quarto della Caduta,A,Early Imperial Period,8,-30,100,130,0.30000001
860,Quarto della Caduta,A,Early Bronze Age,1,-2300,-1700,600,0.30000001
860,Quarto della Caduta,A,Middle Bronze Age,2,-1700,-1300,400,0.30000001
860,Quarto della Caduta,A,Late Bronze Age,3,-1300,-1020,280,0.30000001
860,Quarto della Caduta,A,Early Iron Age,4,-1020,-1000,20,0.30000001
860,Quarto della Caduta,B,Late Iron Age,5,-700,-580,120,0.30000001
860,Quarto della Caduta,B,Archaic Period,6,-580,-350,230,0.30000001
860,Quarto della Caduta,B,Republican Period,7,-350,-30,320,0.30000001
860,Quarto della Caduta,B,Early Imperial Period,8,-30,100,130,0.30000001
860,Quarto della Caduta,B,Mid-Imperial Period,9,100,300,200,0.30000001
860,Quarto della Caduta,B,Late Imperial Period,10,300,500,200,0.30000001
861,Selciatella,A,Late Iron Age,5,-600,-580,20,0.30000001
861,Selciatella,A,Archaic Period,6,-580,-500,80,0.30000001
862,Selciatella,A,Late Iron Age,5,-600,-580,20,0.30000001
862,Selciatella,A,Archaic Period,6,-580,-350,230,0.30000001
862,Selciatella,A,Republican Period,7,-350,-30,320,0.30000001
862,Selciatella,A,Early Imperial Period,8,-30,100,130,0.30000001
863,Quarto della Caduta,A,Middle Bronze Age,2,-1700,-1300,400,0.30000001
863,Quarto della Caduta,B,Late Iron Age,5,-600,-580,20,0.30000001
863,Quarto della Caduta,B,Archaic Period,6,-580,-350,230,0.30000001
863,Quarto della Caduta,B,Republican Period,7,-350,-30,320,0.30000001
863,Quarto della Caduta,B,Early Imperial Period,8,-30,100,130,0.30000001
864,Quarto della Caduta,A,Early Bronze Age,1,-2300,-1700,600,0.2
864,Quarto della Caduta,A,Middle Bronze Age,2,-1700,-1300,400,0.2
864,Quarto della Caduta,A,Late Bronze Age,3,-1300,-1020,280,0.2
864,Quarto della Caduta,A,Early Iron Age,4,-1020,-1000,20,0.2
865,Fosso della Caduta,A,Late Iron Age,5,-600,-580,20,0.050000001
865,Fosso della Caduta,A,Archaic Period,6,-580,-500,80,0.050000001
866,Gestino,A,Republican Period,7,-200,-30,170,0.30000001
866,Gestino,A,Early Imperial Period,8,-30,100,130,0.30000001
866,Gestino,A,Mid-Imperial Period,9,100,200,100,0.30000001
867,,A,Republican Period,7,-100,-30,70,0.2
867,,A,Early Imperial Period,8,-30,100,130,0.2
868,Quarto di S. Andrea,A,Republican Period,7,-100,-30,70,0.60000002
868,Quarto di S. Andrea,A,Early Imperial Period,8,-30,100,130,0.60000002
869,Colle S. Angelo,A,Republican Period,7,-200,-30,170,0.1
870,Quarto di S. Andrea,A,Archaic Period,6,-500,-350,150,0.2
870,Quarto di S. Andrea,A,Republican Period,7,-350,-30,320,0.2
871,Quarto di S. Andrea,A,Late Iron Age,5,-600,-580,20,0.5
871,Quarto di S. Andrea,A,Archaic Period,6,-580,-500,80,0.5
872,i Selci,A,Late Bronze Age,3,-1200,-1020,180,0.1
872,i Selci,A,Early Iron Age,4,-1020,-1000,20,0.1
872,i Selci,B,Late Iron Age,5,-700,-600,100,0.1
873,i Selci,A,Late Iron Age,5,-600,-580,20,0.1
873,i Selci,A,Archaic Period,6,-580,-350,230,0.1
873,i Selci,A,Republican Period,7,-350,-30,320,0.1
873,i Selci,A,Early Imperial Period,8,-30,100,130,0.1
873,i Selci,A,Mid-Imperial Period,9,100,300,200,0.1
873,i Selci,A,Late Imperial Period,10,300,500,200,0.1
874,i Selci,A,Republican Period,7,-100,-30,70,0.60000002
874,i Selci,A,Early Imperial Period,8,-30,100,130,0.60000002
874,i Selci,A,Mid-Imperial Period,9,100,300,200,0.60000002
874,i Selci,A,Late Imperial Period,10,300,500,200,0.60000002
875,il Castellaccio,A,Early Bronze Age,1,-2300,-1700,600,0.2
875,il Castellaccio,A,Middle Bronze Age,2,-1700,-1300,400,0.2
875,il Castellaccio,A,Late Bronze Age,3,-1300,-1020,280,0.2
875,il Castellaccio,A,Early Iron Age,4,-1020,-1000,20,0.2
876,i Selci,A,Late Iron Age,5,-600,-580,20,0.2
876,i Selci,A,Archaic Period,6,-580,-350,230,0.2
876,i Selci,A,Republican Period,7,-350,-30,320,0.2
876,i Selci,A,Early Imperial Period,8,-30,100,130,0.2
876,i Selci,A,Mid-Imperial Period,9,100,300,200,0.2
876,i Selci,A,Late Imperial Period,10,300,500,200,0.2
877,Quarto del Castellaccio,A,Republican Period,7,-100,-30,70,0.5
877,Quarto del Castellaccio,A,Early Imperial Period,8,-30,100,130,0.5
877,Quarto del Castellaccio,A,Mid-Imperial Period,9,100,300,200,0.5
878,la Calcara,A,Archaic Period,6,-500,-350,150,0.60000002
878,la Calcara,A,Republican Period,7,-350,-30,320,0.60000002
878,la Calcara,A,Early Imperial Period,8,-30,100,130,0.60000002
878,la Calcara,A,Mid-Imperial Period,9,100,300,200,0.60000002
878,la Calcara,A,Late Imperial Period,10,300,500,200,0.60000002
879,la Calcara,A,Republican Period,7,-100,-30,70,0.2
879,la Calcara,A,Early Imperial Period,8,-30,100,130,0.2
880,la Calcara,A,Republican Period,7,-100,-30,70,0.30000001
880,la Calcara,A,Early Imperial Period,8,-30,100,130,0.30000001
881,Quarto del Castellaccio,A,Republican Period,7,-200,-30,170,0.30000001
881,Quarto del Castellaccio,A,Early Imperial Period,8,-30,100,130,0.30000001
882,Quarto del Castellaccio,A,Late Iron Age,5,-600,-580,20,1
882,Quarto del Castellaccio,A,Archaic Period,6,-580,-350,230,1
882,Quarto del Castellaccio,A,Republican Period,7,-350,-30,320,1
882,Quarto del Castellaccio,A,Early Imperial Period,8,-30,100,130,1
882,Quarto del Castellaccio,A,Mid-Imperial Period,9,100,300,200,1
882,Quarto del Castellaccio,A,Late Imperial Period,10,300,500,200,1
883,C.Le del Castellaccio,A,Republican Period,7,-200,-30,170,0.1
883,C.Le del Castellaccio,A,Early Imperial Period,8,-30,100,130,0.1
884,C.Le del Castellaccio,A,Archaic Period,6,-500,-350,150,0.2
884,C.Le del Castellaccio,A,Republican Period,7,-350,-200,150,0.2
885,Quarto del Castellaccio,A,Archaic Period,6,-500,-350,150,0.2
885,Quarto del Castellaccio,A,Republican Period,7,-350,-30,320,0.2
885,Quarto del Castellaccio,A,Early Imperial Period,8,-30,100,130,0.2
885,Quarto del Castellaccio,A,Mid-Imperial Period,9,100,300,200,0.2
885,Quarto del Castellaccio,A,Late Imperial Period,10,300,500,200,0.2
886,Fosso della Caduta,A,Republican Period,7,-100,-30,70,0.5
887,Quarto del Castellaccio,A,Republican Period,7,-100,-30,70,0.2
887,Quarto del Castellaccio,A,Early Imperial Period,8,-30,100,130,0.2
888,Quarto del Castellaccio,A,Republican Period,7,-100,-30,70,0.1
888,Quarto del Castellaccio,A,Early Imperial Period,8,-30,100,130,0.1
889,Quarto del Castellaccio,A,Republican Period,7,-200,-30,170,0.60000002
889,Quarto del Castellaccio,A,Early Imperial Period,8,-30,100,130,0.60000002
889,Quarto del Castellaccio,A,Mid-Imperial Period,9,100,300,200,0.60000002
889,Quarto del Castellaccio,A,Late Imperial Period,10,300,500,200,0.60000002
890,Quarto del Castellaccio,A,Republican Period,7,-200,-30,170,0.5
890,Quarto del Castellaccio,A,Early Imperial Period,8,-30,100,130,0.5
890,Quarto del Castellaccio,A,Mid-Imperial Period,9,100,300,200,0.5
890,Quarto del Castellaccio,A,Late Imperial Period,10,300,400,100,0.5
891,,A,Archaic Period,6,-500,-350,150,0.30000001
891,,A,Republican Period,7,-350,-30,320,0.30000001
891,,A,Early Imperial Period,8,-30,100,130,0.30000001
892,,A,Republican Period,7,-100,-30,70,0.30000001
892,,A,Early Imperial Period,8,-30,100,130,0.30000001
892,,A,Mid-Imperial Period,9,100,300,200,0.30000001
893,,A,Late Iron Age,5,-600,-580,20,0.2
893,,A,Archaic Period,6,-580,-350,230,0.2
893,,A,Republican Period,7,-350,-30,320,0.2
894,,A,Late Iron Age,5,-600,-580,20,0.1
894,,A,Archaic Period,6,-580,-350,230,0.1
894,,A,Republican Period,7,-350,-200,150,0.1
895,Castel Lombardo,A,Republican Period,7,-100,-30,70,0.5
895,Castel Lombardo,A,Early Imperial Period,8,-30,100,130,0.5
896,Castel Lombardo,A,Republican Period,7,-100,-30,70,0.2
896,Castel Lombardo,A,Early Imperial Period,8,-30,100,130,0.2
896,Castel Lombardo,A,Mid-Imperial Period,9,100,300,200,0.2
896,Castel Lombardo,A,Late Imperial Period,10,300,500,200,0.2
897,Castel Lombardo,A,Middle Bronze Age,2,-1700,-1300,400,0.2
898,Castel Lombardo,A,Late Imperial Period,10,400,500,100,0.5
899,Castel Lombardo,A,Republican Period,7,-100,-30,70,0.30000001
899,Castel Lombardo,A,Early Imperial Period,8,-30,100,130,0.30000001
900,Castel Lombardo,A,Early Imperial Period,8,-30,100,130,0.2
900,Castel Lombardo,A,Mid-Imperial Period,9,100,300,200,0.2
900,Castel Lombardo,A,Late Imperial Period,10,300,500,200,0.2
901,Castel Lombardo,A,Archaic Period,6,-500,-350,150,0.80000001
901,Castel Lombardo,A,Republican Period,7,-350,-30,320,0.80000001
901,Castel Lombardo,A,Early Imperial Period,8,-30,100,130,0.80000001
901,Castel Lombardo,A,Mid-Imperial Period,9,100,300,200,0.80000001
901,Castel Lombardo,A,Late Imperial Period,10,300,500,200,0.80000001
902,Castel Lombardo,A,Early Imperial Period,8,-30,100,130,0.1
902,Castel Lombardo,A,Mid-Imperial Period,9,100,300,200,0.1
902,Castel Lombardo,A,Late Imperial Period,10,300,500,200,0.1
903,Castel Lombardo,A,Republican Period,7,-100,-30,70,0.1
904,Castel Lombardo,A,Republican Period,7,-200,-30,170,0.40000001
904,Castel Lombardo,A,Early Imperial Period,8,-30,100,130,0.40000001
905,Castel Lombardo,A,Republican Period,7,-100,-30,70,0.2
905,Castel Lombardo,A,Early Imperial Period,8,-30,100,130,0.2
906,Castel Lombardo,A,Archaic Period,6,-500,-350,150,0.80000001
906,Castel Lombardo,A,Republican Period,7,-350,-30,320,0.80000001
906,Castel Lombardo,A,Early Imperial Period,8,-30,100,130,0.80000001
906,Castel Lombardo,A,Mid-Imperial Period,9,100,300,200,0.80000001
906,Castel Lombardo,A,Late Imperial Period,10,300,500,200,0.80000001
907,Castel Lombardo,A,Republican Period,7,-100,-30,70,0.1
907,Castel Lombardo,A,Early Imperial Period,8,-30,100,130,0.1
907,Castel Lombardo,A,Mid-Imperial Period,9,100,300,200,0.1
907,Castel Lombardo,A,Late Imperial Period,10,300,500,200,0.1
908,Castel Lombardo,A,Republican Period,7,-100,-30,70,0.30000001
908,Castel Lombardo,A,Early Imperial Period,8,-30,100,130,0.30000001
908,Castel Lombardo,A,Mid-Imperial Period,9,100,300,200,0.30000001
909,Castel Lombardo,A,Republican Period,7,-100,-30,70,0.2
909,Castel Lombardo,A,Early Imperial Period,8,-30,100,130,0.2
910,,A,Republican Period,7,-100,-30,70,0.1
910,,A,Early Imperial Period,8,-30,100,130,0.1
911,,A,Republican Period,7,-100,-30,70,0.2
911,,A,Early Imperial Period,8,-30,100,130,0.2
911,,A,Mid-Imperial Period,9,100,300,200,0.2
911,,A,Late Imperial Period,10,300,500,200,0.2
912,Pascolaro della Ficoncella,A,Republican Period,7,-100,-30,70,0.1
912,Pascolaro della Ficoncella,A,Early Imperial Period,8,-30,100,130,0.1
913,Pascolaro della Ficoncella,A,Late Iron Age,5,-600,-580,20,0.2
913,Pascolaro della Ficoncella,A,Archaic Period,6,-580,-500,80,0.2
913,Pascolaro della Ficoncella,B,Republican Period,7,-100,-30,70,0.2
913,Pascolaro della Ficoncella,B,Early Imperial Period,8,-30,100,130,0.2
914,Pascolaro della Ficoncella,A,Early Imperial Period,8,-30,100,130,0.1
915,Pascolaro della Ficoncella,A,Republican Period,7,-200,-30,170,0.2
916,la Mola di Torrimpietra,A,Republican Period,7,-200,-30,170,0.40000001
916,la Mola di Torrimpietra,A,Early Imperial Period,8,-30,100,130,0.40000001
917,la Mola di Torrimpietra,A,Republican Period,7,-100,-30,70,0.1
917,la Mola di Torrimpietra,A,Early Imperial Period,8,-30,100,130,0.1
918,C.le S. Angelo,A,Republican Period,7,-100,-30,70,0.5
918,C.le S. Angelo,A,Early Imperial Period,8,-30,100,130,0.5
919,C.le S. Angelo,A,Republican Period,7,-100,-30,70,0.1
920,,A,Republican Period,7,-200,-30,170,1.5
920,,A,Early Imperial Period,8,-30,100,130,1.5
920,,A,Mid-Imperial Period,9,100,300,200,1.5
920,,A,Late Imperial Period,10,300,500,200,1.5
921,Macchia della Signora,A,Archaic Period,6,-500,-350,150,1
921,Macchia della Signora,A,Republican Period,7,-350,-30,320,1
921,Macchia della Signora,A,Early Imperial Period,8,-30,100,130,1
922,Macchia della Signora,A,Republican Period,7,-200,-30,170,0.30000001
922,Macchia della Signora,A,Early Imperial Period,8,-30,100,130,0.30000001
922,Macchia della Signora,A,Mid-Imperial Period,9,100,300,200,0.30000001
923,Granaretto,A,Late Iron Age,5,-600,-580,20,0.1
923,Granaretto,A,Archaic Period,6,-580,-500,80,0.1
924,Granaretto,A,Republican Period,7,-200,-30,170,0.2
924,Granaretto,A,Early Imperial Period,8,-30,100,130,0.2
925,,A,Late Iron Age,5,-600,-580,20,0.1
925,,A,Archaic Period,6,-580,-500,80,0.1
925,,B,Republican Period,7,-100,-30,70,0.1
926,,A,Late Iron Age,5,-600,-580,20,0.30000001
926,,A,Archaic Period,6,-580,-500,80,0.30000001
927,Granaretto,A,Late Iron Age,5,-600,-580,20,0.2
927,Granaretto,A,Archaic Period,6,-580,-500,80,0.2
927,Granaretto,B,Republican Period,7,-300,-100,200,0.2
928,Casale Pianpozzetto,A,Republican Period,7,-200,-30,170,0.30000001
928,Casale Pianpozzetto,A,Early Imperial Period,8,-30,100,130,0.30000001
928,Casale Pianpozzetto,A,Mid-Imperial Period,9,100,300,200,0.30000001
929,Casale Pianpozzetto,A,Late Iron Age,5,-600,-580,20,0.1
929,Casale Pianpozzetto,A,Archaic Period,6,-580,-500,80,0.1
930,,A,Republican Period,7,-200,-30,170,0.1
930,,A,Early Imperial Period,8,-30,100,130,0.1
931,Casale Pianpozzetto,A,Republican Period,7,-200,-30,170,0.30000001
932,,A,Republican Period,7,-200,-30,170,0.60000002
932,,A,Early Imperial Period,8,-30,100,130,0.60000002
932,,A,Mid-Imperial Period,9,100,300,200,0.60000002
933,Quarto di Pianpozzello,A,Republican Period,7,-100,-30,70,0.2
934,Quarto di Tragliata,A,Archaic Period,6,-500,-350,150,0.40000001
934,Quarto di Tragliata,A,Republican Period,7,-350,-30,320,0.40000001
934,Quarto di Tragliata,A,Early Imperial Period,8,-30,100,130,0.40000001
935,Quarto di S. Andrea,A,Archaic Period,6,-500,-350,150,0.1
935,Quarto di S. Andrea,A,Republican Period,7,-350,-30,320,0.1
935,Quarto di S. Andrea,A,Early Imperial Period,8,-30,100,130,0.1
935,Quarto di S. Andrea,A,Mid-Imperial Period,9,100,300,200,0.1
935,Quarto di S. Andrea,A,Late Imperial Period,10,300,500,200,0.1
936,Quarto di S. Andrea,A,Republican Period,7,-100,-30,70,0.1
936,Quarto di S. Andrea,A,Early Imperial Period,8,-30,100,130,0.1
937,Quarto di S. Andrea,A,Republican Period,7,-100,-30,70,0.30000001
937,Quarto di S. Andrea,A,Early Imperial Period,8,-30,100,130,0.30000001
938,C.le di S. Andrea,A,Republican Period,7,-100,-30,70,0.1
938,C.le di S. Andrea,A,Early Imperial Period,8,-30,100,130,0.1
939,,A,Middle Bronze Age,2,-1700,-1300,400,0.1
940,Gestino,A,Republican Period,7,-200,-30,170,0.2
940,Gestino,A,Early Imperial Period,8,-30,100,130,0.2
941,Riserva i Pontoni,A,Archaic Period,6,-500,-350,150,0.2
941,Riserva i Pontoni,A,Republican Period,7,-350,-30,320,0.2
941,Riserva i Pontoni,A,Early Imperial Period,8,-30,100,130,0.2
942,Riserva i Pontoni,A,Republican Period,7,-100,-30,70,0.2
942,Riserva i Pontoni,A,Early Imperial Period,8,-30,100,130,0.2
943,Riserva i Pontoni,A,Late Iron Age,5,-600,-580,20,0.5
943,Riserva i Pontoni,A,Archaic Period,6,-580,-350,230,0.5
943,Riserva i Pontoni,A,Republican Period,7,-350,-30,320,0.5
944,Riserva i Pontoni,A,Late Iron Age,5,-600,-580,20,0.2
944,Riserva i Pontoni,A,Archaic Period,6,-580,-350,230,0.2
944,Riserva i Pontoni,A,Republican Period,7,-350,-300,50,0.2
945,Riserva i Pontoni,A,Archaic Period,6,-500,-350,150,0.40000001
945,Riserva i Pontoni,A,Republican Period,7,-350,-30,320,0.40000001
945,Riserva i Pontoni,A,Early Imperial Period,8,-30,100,130,0.40000001
946,Dorsale di Monte Cardello,A,Archaic Period,6,-500,-350,150,0.2
946,Dorsale di Monte Cardello,A,Republican Period,7,-350,-30,320,0.2
946,Dorsale di Monte Cardello,A,Early Imperial Period,8,-30,100,130,0.2
947,Dorsale di Monte Cardello,A,Republican Period,7,-100,-30,70,0.30000001
947,Dorsale di Monte Cardello,A,Early Imperial Period,8,-30,100,130,0.30000001
947,Dorsale di Monte Cardello,A,Mid-Imperial Period,9,100,300,200,0.30000001
948,Quarto di Tragliata,A,Republican Period,7,-200,-30,170,0.2
949,Quarto di Tragliata,A,Archaic Period,6,-500,-350,150,0.2
949,Quarto di Tragliata,A,Republican Period,7,-350,-30,320,0.2
949,Quarto di Tragliata,A,Early Imperial Period,8,-30,100,130,0.2
949,Quarto di Tragliata,A,Mid-Imperial Period,9,100,300,200,0.2
949,Quarto di Tragliata,A,Late Imperial Period,10,300,500,200,0.2
950,Quarto di Tragliata,A,Republican Period,7,-100,-30,70,0.5
950,Quarto di Tragliata,A,Early Imperial Period,8,-30,100,130,0.5
950,Quarto di Tragliata,A,Mid-Imperial Period,9,100,300,200,0.5
951,C.le dei Ricci,A,Republican Period,7,-200,-30,170,0.5
951,C.le dei Ricci,A,Early Imperial Period,8,-30,100,130,0.5
951,C.le dei Ricci,A,Mid-Imperial Period,9,100,300,200,0.5
951,C.le dei Ricci,A,Late Imperial Period,10,300,500,200,0.5
952,Quarto di Tragliata,A,Early Bronze Age,1,-2300,-1700,600,0.1
952,Quarto di Tragliata,A,Middle Bronze Age,2,-1700,-1300,400,0.1
952,Quarto di Tragliata,A,Late Bronze Age,3,-1300,-1020,280,0.1
952,Quarto di Tragliata,A,Early Iron Age,4,-1020,-1000,20,0.1
952,Quarto di Tragliata,B,Late Iron Age,5,-600,-580,20,0.1
952,Quarto di Tragliata,B,Archaic Period,6,-580,-500,80,0.1
953,,A,Republican Period,7,-200,-30,170,0.40000001
953,,A,Early Imperial Period,8,-30,100,130,0.40000001
953,,A,Mid-Imperial Period,9,100,300,200,0.40000001
953,,A,Late Imperial Period,10,300,500,200,0.40000001
954,C.le dei Ricci,A,Republican Period,7,-200,-30,170,0.2
954,C.le dei Ricci,A,Early Imperial Period,8,-30,100,130,0.2
954,C.le dei Ricci,A,Mid-Imperial Period,9,100,300,200,0.2
954,C.le dei Ricci,A,Late Imperial Period,10,300,500,200,0.2
955,C.le dei Ricci,A,Republican Period,7,-100,-30,70,0.2
955,C.le dei Ricci,A,Early Imperial Period,8,-30,100,130,0.2
956,C.le dei Ricci,A,Late Iron Age,5,-600,-580,20,0.1
956,C.le dei Ricci,A,Archaic Period,6,-580,-500,80,0.1
956,C.le dei Ricci,B,Republican Period,7,-100,-30,70,0.1
956,C.le dei Ricci,B,Early Imperial Period,8,-30,100,130,0.1
957,Cantinaccia,A,Archaic Period,6,-500,-350,150,0.2
957,Cantinaccia,A,Republican Period,7,-350,-30,320,0.2
957,Cantinaccia,A,Early Imperial Period,8,-30,100,130,0.2
957,Cantinaccia,A,Mid-Imperial Period,9,100,300,200,0.2
957,Cantinaccia,A,Late Imperial Period,10,300,500,200,0.2
958,C.le di Castiglione,A,Late Bronze Age,3,-1200,-1020,180,0.1
958,C.le di Castiglione,A,Early Iron Age,4,-1020,-1000,20,0.1
959,Muracciole,A,Republican Period,7,-100,-30,70,0.1
960,Muracciole,A,Republican Period,7,-100,-30,70,0.1
960,Muracciole,A,Early Imperial Period,8,-30,100,130,0.1
960,Muracciole,A,Mid-Imperial Period,9,100,300,200,0.1
960,Muracciole,A,Late Imperial Period,10,300,500,200,0.1
961,Muracciole,A,Late Iron Age,5,-600,-580,20,0.1
961,Muracciole,A,Archaic Period,6,-580,-350,230,0.1
961,Muracciole,A,Republican Period,7,-350,-30,320,0.1
961,Muracciole,A,Early Imperial Period,8,-30,100,130,0.1
961,Muracciole,A,Mid-Imperial Period,9,100,300,200,0.1
961,Muracciole,A,Late Imperial Period,10,300,500,200,0.1
962,Muracciole,A,Late Iron Age,5,-600,-580,20,0.30000001
962,Muracciole,A,Archaic Period,6,-580,-500,80,0.30000001
963,Muracciole,A,Republican Period,7,-100,-30,70,0.1
963,Muracciole,A,Early Imperial Period,8,-30,100,130,0.1
964,Muracciole,A,Early Imperial Period,8,-30,100,130,0.30000001
965,,A,Early Imperial Period,8,-30,100,130,0.1
965,,A,Mid-Imperial Period,9,100,300,200,0.1
965,,A,Late Imperial Period,10,300,500,200,0.1
966,C.le Bruciato,A,Early Imperial Period,8,-30,100,130,0.1
966,C.le Bruciato,A,Mid-Imperial Period,9,100,300,200,0.1
967,C.le Bruciato,A,Republican Period,7,-200,-30,170,0.1
967,C.le Bruciato,A,Early Imperial Period,8,-30,100,130,0.1
968,Riserva del Lupinaro,A,Late Iron Age,5,-600,-580,20,0.1
968,Riserva del Lupinaro,A,Archaic Period,6,-580,-500,80,0.1
969,Riserva del Lupinaro,A,Archaic Period,6,-500,-350,150,0.30000001
969,Riserva del Lupinaro,A,Republican Period,7,-350,-30,320,0.30000001
969,Riserva del Lupinaro,A,Early Imperial Period,8,-30,100,130,0.30000001
970,Riserva del Lupinaro,A,Republican Period,7,-100,-30,70,0.1
970,Riserva del Lupinaro,A,Early Imperial Period,8,-30,100,130,0.1
971,Riserva del Lupinaro,A,Late Iron Age,5,-600,-580,20,0.89999998
971,Riserva del Lupinaro,A,Archaic Period,6,-580,-350,230,0.89999998
971,Riserva del Lupinaro,A,Republican Period,7,-350,-30,320,0.89999998
971,Riserva del Lupinaro,A,Early Imperial Period,8,-30,100,130,0.89999998
971,Riserva del Lupinaro,A,Mid-Imperial Period,9,100,300,200,0.89999998
972,Monte Cacchio,A,Republican Period,7,-100,-30,70,0.1
972,Monte Cacchio,A,Early Imperial Period,8,-30,100,130,0.1
973,Monte Cacchio,A,Republican Period,7,-100,-30,70,0.5
973,Monte Cacchio,A,Early Imperial Period,8,-30,100,130,0.5
974,Quarto Lungo,A,Late Iron Age,5,-600,-580,20,0.60000002
974,Quarto Lungo,A,Archaic Period,6,-580,-350,230,0.60000002
974,Quarto Lungo,A,Republican Period,7,-350,-200,150,0.60000002
975,C.le di Monte Spaccato,A,Republican Period,7,-200,-30,170,0.40000001
975,C.le di Monte Spaccato,A,Early Imperial Period,8,-30,100,130,0.40000001
975,C.le di Monte Spaccato,A,Mid-Imperial Period,9,100,300,200,0.40000001
975,C.le di Monte Spaccato,A,Late Imperial Period,10,300,500,200,0.40000001
976,Monte Spaccato,A,Late Iron Age,5,-600,-580,20,0.30000001
976,Monte Spaccato,A,Archaic Period,6,-580,-350,230,0.30000001
976,Monte Spaccato,A,Republican Period,7,-350,-30,320,0.30000001
976,Monte Spaccato,A,Early Imperial Period,8,-30,100,130,0.30000001
976,Monte Spaccato,A,Mid-Imperial Period,9,100,300,200,0.30000001
977,Perella di sotto,A,Late Iron Age,5,-600,-580,20,0.5
977,Perella di sotto,A,Archaic Period,6,-580,-350,230,0.5
977,Perella di sotto,A,Republican Period,7,-350,-30,320,0.5
977,Perella di sotto,A,Early Imperial Period,8,-30,100,130,0.5
978,Perella di sotto,A,Late Iron Age,5,-600,-580,20,0.30000001
978,Perella di sotto,A,Archaic Period,6,-580,-350,230,0.30000001
978,Perella di sotto,A,Republican Period,7,-350,-30,320,0.30000001
978,Perella di sotto,A,Early Imperial Period,8,-30,100,130,0.30000001
979,Perella di sotto,A,Late Iron Age,5,-600,-580,20,0.1
979,Perella di sotto,A,Archaic Period,6,-580,-350,230,0.1
979,Perella di sotto,A,Republican Period,7,-350,-30,320,0.1
979,Perella di sotto,A,Early Imperial Period,8,-30,100,130,0.1
979,Perella di sotto,A,Mid-Imperial Period,9,100,300,200,0.1
979,Perella di sotto,A,Late Imperial Period,10,300,500,200,0.1
980,Perella,A,Late Iron Age,5,-600,-580,20,0.30000001
980,Perella,A,Archaic Period,6,-580,-350,230,0.30000001
980,Perella,A,Republican Period,7,-350,-30,320,0.30000001
980,Perella,A,Early Imperial Period,8,-30,100,130,0.30000001
981,Perella,A,Archaic Period,6,-500,-350,150,0.2
981,Perella,A,Republican Period,7,-350,-30,320,0.2
981,Perella,A,Early Imperial Period,8,-30,100,130,0.2
981,Perella,A,Mid-Imperial Period,9,100,300,200,0.2
981,Perella,A,Late Imperial Period,10,300,500,200,0.2
982,Perella,A,Archaic Period,6,-500,-350,150,0.1
982,Perella,A,Republican Period,7,-350,-30,320,0.1
982,Perella,A,Early Imperial Period,8,-30,100,130,0.1
982,Perella,A,Mid-Imperial Period,9,100,300,200,0.1
982,Perella,A,Late Imperial Period,10,300,500,200,0.1
983,Farinone,A,Archaic Period,6,-500,-350,150,0.2
983,Farinone,A,Republican Period,7,-350,-30,320,0.2
983,Farinone,A,Early Imperial Period,8,-30,100,130,0.2
983,Farinone,A,Mid-Imperial Period,9,100,300,200,0.2
983,Farinone,A,Late Imperial Period,10,300,500,200,0.2
984,Farinone,A,Archaic Period,6,-500,-350,150,0.1
984,Farinone,A,Republican Period,7,-350,-30,320,0.1
984,Farinone,A,Early Imperial Period,8,-30,100,130,0.1
984,Farinone,A,Mid-Imperial Period,9,100,300,200,0.1
984,Farinone,A,Late Imperial Period,10,300,500,200,0.1
985,Colle Lungo,A,Archaic Period,6,-500,-350,150,0.1
985,Colle Lungo,A,Republican Period,7,-350,-30,320,0.1
985,Colle Lungo,A,Early Imperial Period,8,-30,100,130,0.1
985,Colle Lungo,A,Mid-Imperial Period,9,100,300,200,0.1
985,Colle Lungo,A,Late Imperial Period,10,300,500,200,0.1
986,Colle Lungo,A,Late Iron Age,5,-600,-580,20,0.1
986,Colle Lungo,A,Archaic Period,6,-580,-350,230,0.1
986,Colle Lungo,A,Republican Period,7,-350,-30,320,0.1
986,Colle Lungo,A,Early Imperial Period,8,-30,100,130,0.1
987,Colle Lungo,A,Archaic Period,6,-500,-350,150,0.30000001
987,Colle Lungo,A,Republican Period,7,-350,-30,320,0.30000001
987,Colle Lungo,A,Early Imperial Period,8,-30,100,130,0.30000001
987,Colle Lungo,A,Mid-Imperial Period,9,100,300,200,0.30000001
987,Colle Lungo,A,Late Imperial Period,10,300,500,200,0.30000001
988,,A,Archaic Period,6,-500,-350,150,0.1
988,,A,Republican Period,7,-350,-30,320,0.1
989,,A,Late Iron Age,5,-600,-580,20,0.2
989,,A,Archaic Period,6,-580,-350,230,0.2
989,,A,Republican Period,7,-350,-30,320,0.2
989,,A,Early Imperial Period,8,-30,100,130,0.2
989,,A,Mid-Imperial Period,9,100,300,200,0.2
990,M. di S. Pietro,A,Archaic Period,6,-500,-350,150,0.2
990,M. di S. Pietro,A,Republican Period,7,-350,-30,320,0.2
990,M. di S. Pietro,A,Early Imperial Period,8,-30,100,130,0.2
990,M. di S. Pietro,A,Mid-Imperial Period,9,100,300,200,0.2
990,M. di S. Pietro,A,Late Imperial Period,10,300,500,200,0.2
991,Colonnacce di sopra,A,Early Bronze Age,1,-2300,-1700,600,0.2
991,Colonnacce di sopra,A,Middle Bronze Age,2,-1700,-1300,400,0.2
991,Colonnacce di sopra,A,Late Bronze Age,3,-1300,-1020,280,0.2
991,Colonnacce di sopra,A,Early Iron Age,4,-1020,-1000,20,0.2
991,Colonnacce di sopra,B,Republican Period,7,-100,-30,70,0.2
991,Colonnacce di sopra,B,Early Imperial Period,8,-30,100,130,0.2
991,Colonnacce di sopra,B,Mid-Imperial Period,9,100,300,200,0.2
992,le Colonnacce,A,Late Bronze Age,3,-1200,-1020,180,0.1
992,le Colonnacce,A,Early Iron Age,4,-1020,-750,270,0.1
992,le Colonnacce,A,Late Iron Age,5,-750,-580,170,0.1
992,le Colonnacce,A,Archaic Period,6,-580,-350,230,0.1
992,le Colonnacce,A,Republican Period,7,-350,-100,250,0.1
993,Monte la Ginestra,A,Archaic Period,6,-500,-350,150,0.1
993,Monte la Ginestra,A,Republican Period,7,-350,-30,320,0.1
994,,A,Late Iron Age,5,-600,-580,20,0.1
994,,A,Archaic Period,6,-580,-500,80,0.1
994,,B,Republican Period,7,-200,-30,170,0.1
995,Vitellara,A,Early Bronze Age,1,-2300,-1700,600,0.2
995,Vitellara,A,Middle Bronze Age,2,-1700,-1300,400,0.2
995,Vitellara,A,Late Bronze Age,3,-1300,-1020,280,0.2
995,Vitellara,A,Early Iron Age,4,-1020,-1000,20,0.2
995,Vitellara,B,Late Iron Age,5,-600,-580,20,0.2
995,Vitellara,B,Archaic Period,6,-580,-500,80,0.2
996,Vitellara,A,Late Iron Age,5,-600,-580,20,0.2
996,Vitellara,A,Archaic Period,6,-580,-350,230,0.2
996,Vitellara,A,Republican Period,7,-350,-30,320,0.2
996,Vitellara,A,Early Imperial Period,8,-30,100,130,0.2
996,Vitellara,A,Mid-Imperial Period,9,100,300,200,0.2
996,Vitellara,A,Late Imperial Period,10,300,500,200,0.2
997,S. Antonio di Mezzo,A,Late Iron Age,5,-600,-580,20,0.1
997,S. Antonio di Mezzo,A,Archaic Period,6,-580,-350,230,0.1
997,S. Antonio di Mezzo,A,Republican Period,7,-350,-30,320,0.1
997,S. Antonio di Mezzo,A,Early Imperial Period,8,-30,100,130,0.1
997,S. Antonio di Mezzo,A,Mid-Imperial Period,9,100,300,200,0.1
998,S. Antonio di Mezzo,A,Early Imperial Period,8,-30,100,130,0.1
999,S. Antonio di Mezzo,A,Republican Period,7,-200,-30,170,0.1
999,S. Antonio di Mezzo,A,Early Imperial Period,8,-30,100,130,0.1
1000,S. Antonio di Mezzo,A,Republican Period,7,-200,-30,170,0.1
1000,S. Antonio di Mezzo,A,Early Imperial Period,8,-30,100,130,0.1
1001,S. Antonio di sopra,A,Republican Period,7,-200,-30,170,0.30000001
1001,S. Antonio di sopra,A,Early Imperial Period,8,-30,100,130,0.30000001
1002,S. Antonio di sopra,A,Early Imperial Period,8,-30,100,130,0.1
1003,S. Antonio di sopra,A,Archaic Period,6,-500,-350,150,0.5
1003,S. Antonio di sopra,A,Republican Period,7,-350,-30,320,0.5
1004,C.le Malvicino,A,Late Iron Age,5,-600,-580,20,0.30000001
1004,C.le Malvicino,A,Archaic Period,6,-580,-500,80,0.30000001
1004,C.le Malvicino,B,Republican Period,7,-100,-30,70,0.30000001
1004,C.le Malvicino,B,Early Imperial Period,8,-30,100,130,0.30000001
1005,C.le Malvicino,A,Early Bronze Age,1,-2300,-1700,600,0.5
1005,C.le Malvicino,A,Middle Bronze Age,2,-1700,-1300,400,0.5
1005,C.le Malvicino,A,Late Bronze Age,3,-1300,-1020,280,0.5
1005,C.le Malvicino,A,Early Iron Age,4,-1020,-1000,20,0.5
1005,C.le Malvicino,B,Late Iron Age,5,-600,-580,20,0.5
1005,C.le Malvicino,B,Archaic Period,6,-580,-350,230,0.5
1005,C.le Malvicino,B,Republican Period,7,-350,-30,320,0.5
1005,C.le Malvicino,B,Early Imperial Period,8,-30,100,130,0.5
1005,C.le Malvicino,B,Mid-Imperial Period,9,100,300,200,0.5
1006,Riserva Nuova,A,Republican Period,7,-100,-30,70,0.1
1006,Riserva Nuova,A,Early Imperial Period,8,-30,100,130,0.1
1007,,A,Republican Period,7,-200,-30,170,0.2
1007,,A,Early Imperial Period,8,-30,100,130,0.2
1007,,A,Mid-Imperial Period,9,100,200,100,0.2
1008,Porta Metronia,A,Republican Period,7,-200,-30,170,0.1
1009,Monte Centrone,A,Early Imperial Period,8,-30,100,130,0.1
1009,Monte Centrone,A,Mid-Imperial Period,9,100,300,200,0.1
1009,Monte Centrone,A,Late Imperial Period,10,300,500,200,0.1
1010,fosso di Anselmo,A,Archaic Period,6,-500,-350,150,0.2
1010,fosso di Anselmo,A,Republican Period,7,-350,-30,320,0.2
1010,fosso di Anselmo,A,Early Imperial Period,8,-30,100,130,0.2
1010,fosso di Anselmo,A,Mid-Imperial Period,9,100,300,200,0.2
1011,,A,Republican Period,7,-100,-30,70,0.2
1011,,A,Early Imperial Period,8,-30,100,130,0.2
1011,,A,Mid-Imperial Period,9,100,300,200,0.2
1012,Valle del Corno,A,Republican Period,7,-100,-30,70,0.40000001
1012,Valle del Corno,A,Early Imperial Period,8,-30,100,130,0.40000001
1012,Valle del Corno,A,Mid-Imperial Period,9,100,300,200,0.40000001
1013,Rio dei Lucernari di Malvicino,A,Late Iron Age,5,-700,-580,120,0.2
1013,Rio dei Lucernari di Malvicino,A,Archaic Period,6,-580,-500,80,0.2
1014,Monte Cacchio,A,Republican Period,7,-100,-30,70,0.050000001
1014,Monte Cacchio,A,Early Imperial Period,8,-30,100,130,0.050000001
1014,Monte Cacchio,A,Mid-Imperial Period,9,100,300,200,0.050000001
1015,Rio dei Lucernari di Malvicino,A,Republican Period,7,-200,-30,170,0.30000001
1015,Rio dei Lucernari di Malvicino,A,Early Imperial Period,8,-30,100,130,0.30000001
1015,Rio dei Lucernari di Malvicino,A,Mid-Imperial Period,9,100,300,200,0.30000001
1016,Rio dei Lucernari di Malvicino,A,Republican Period,7,-200,-30,170,0.1
1016,Rio dei Lucernari di Malvicino,A,Early Imperial Period,8,-30,100,130,0.1
1016,Rio dei Lucernari di Malvicino,A,Mid-Imperial Period,9,100,300,200,0.1
1017,Monti del Sasso,A,Republican Period,7,-200,-30,170,0.2
1017,Monti del Sasso,A,Early Imperial Period,8,-30,100,130,0.2
1017,Monti del Sasso,A,Mid-Imperial Period,9,100,300,200,0.2
1018,Monte Cacchio,A,Early Imperial Period,8,-30,100,130,0.2
1018,Monte Cacchio,A,Mid-Imperial Period,9,100,300,200,0.2
1018,Monte Cacchio,A,Late Imperial Period,10,300,500,200,0.2
1019,,A,Early Imperial Period,8,-30,100,130,0.1
1019,,A,Mid-Imperial Period,9,100,300,200,0.1
1019,,A,Late Imperial Period,10,300,500,200,0.1
1020,Monti del Sasso,A,Late Iron Age,5,-600,-580,20,0.1
1020,Monti del Sasso,A,Archaic Period,6,-580,-500,80,0.1
1021,Monte dell'Arrone,A,Republican Period,7,-100,-30,70,0.1
1021,Monte dell'Arrone,A,Early Imperial Period,8,-30,100,130,0.1
1022,Monte dell'Arrone,A,Republican Period,7,-200,-30,170,0.1
1022,Monte dell'Arrone,A,Early Imperial Period,8,-30,100,130,0.1
1023,Monte dell'Arrone,A,Early Imperial Period,8,-30,100,130,0.1
1024,Monte Tondo,A,Late Iron Age,5,-600,-580,20,0.5
1024,Monte Tondo,A,Archaic Period,6,-580,-500,80,0.5
1025,Monte Tondo,A,Late Iron Age,5,-600,-580,20,0.1
1025,Monte Tondo,A,Archaic Period,6,-580,-350,230,0.1
1025,Monte Tondo,A,Republican Period,7,-350,-30,320,0.1
1025,Monte Tondo,A,Early Imperial Period,8,-30,100,130,0.1
1025,Monte Tondo,A,Mid-Imperial Period,9,100,300,200,0.1
1025,Monte Tondo,A,Late Imperial Period,10,300,500,200,0.1
1026,,A,Late Iron Age,5,-600,-580,20,0.30000001
1026,,A,Archaic Period,6,-580,-500,80,0.30000001
1026,,B,Republican Period,7,-200,-30,170,0.30000001
1027,Ceccanibbo,A,Late Iron Age,5,-600,-580,20,0.1
1027,Ceccanibbo,A,Archaic Period,6,-580,-500,80,0.1
1028,,A,Republican Period,7,-200,-30,170,0.40000001
1028,,A,Early Imperial Period,8,-30,100,130,0.40000001
1028,,A,Mid-Imperial Period,9,100,300,200,0.40000001
1028,,A,Late Imperial Period,10,300,500,200,0.40000001
1029,Valle dei Ladri,A,Late Iron Age,5,-600,-580,20,1.5
1029,Valle dei Ladri,A,Archaic Period,6,-580,-500,80,1.5
1029,Valle dei Ladri,B,Republican Period,7,-100,-30,70,1.5
1029,Valle dei Ladri,B,Early Imperial Period,8,-30,100,130,1.5
1029,Valle dei Ladri,B,Mid-Imperial Period,9,100,300,200,1.5
1029,Valle dei Ladri,B,Late Imperial Period,10,300,500,200,1.5
1030,,A,Early Imperial Period,8,-30,100,130,0.1
1030,,A,Mid-Imperial Period,9,100,300,200,0.1
1030,,A,Late Imperial Period,10,300,500,200,0.1
1031,Ospedaletto,A,Late Iron Age,5,-600,-580,20,0.1
1031,Ospedaletto,A,Archaic Period,6,-580,-350,230,0.1
1031,Ospedaletto,A,Republican Period,7,-350,-30,320,0.1
1032,Monte Muletto,A,Early Imperial Period,8,-30,100,130,0.2
1032,Monte Muletto,A,Mid-Imperial Period,9,100,300,200,0.2
1032,Monte Muletto,A,Late Imperial Period,10,300,500,200,0.2
1033,Monte Muletto,A,Republican Period,7,-100,-30,70,0.5
1033,Monte Muletto,A,Early Imperial Period,8,-30,100,130,0.5
1033,Monte Muletto,A,Mid-Imperial Period,9,100,300,200,0.5
1033,Monte Muletto,A,Late Imperial Period,10,300,500,200,0.5
1034,,A,Early Imperial Period,8,-30,100,130,0.2
1034,,A,Mid-Imperial Period,9,100,300,200,0.2
1034,,A,Late Imperial Period,10,300,500,200,0.2
1035,,A,Late Iron Age,5,-600,-580,20,0.30000001
1035,,A,Archaic Period,6,-580,-500,80,0.30000001
1035,,B,Republican Period,7,-100,-30,70,0.30000001
1035,,B,Early Imperial Period,8,-30,100,130,0.30000001
1036,,A,Late Iron Age,5,-600,-580,20,0.30000001
1036,,A,Archaic Period,6,-580,-350,230,0.30000001
1036,,A,Republican Period,7,-350,-30,320,0.30000001
1037,,A,Republican Period,7,-100,-30,70,0.40000001
1037,,A,Early Imperial Period,8,-30,100,130,0.40000001
1037,,A,Mid-Imperial Period,9,100,300,200,0.40000001
1037,,A,Late Imperial Period,10,300,500,200,0.40000001
1038,,A,Republican Period,7,-200,-30,170,0.1
1038,,A,Early Imperial Period,8,-30,100,130,0.1
1038,,A,Mid-Imperial Period,9,100,300,200,0.1
1039,,A,Late Iron Age,5,-600,-580,20,0.2
1039,,A,Archaic Period,6,-580,-500,80,0.2
1049,,A,Republican Period,7,-100,-30,70,0.2
1049,,A,Early Imperial Period,8,-30,100,130,0.2
1050,,A,Republican Period,7,-200,-30,170,0.40000001
1051,Riserva Grande,A,Late Iron Age,5,-600,-580,20,0.1
1051,Riserva Grande,A,Archaic Period,6,-580,-500,80,0.1
1051,Riserva Grande,B,Republican Period,7,-200,-30,170,0.1
1052,,A,Late Iron Age,5,-600,-580,20,3
1052,,A,Archaic Period,6,-580,-500,80,3
1052,,B,Republican Period,7,-200,-30,170,3
1052,,B,Early Imperial Period,8,-30,100,130,3
1052,,B,Mid-Imperial Period,9,100,300,200,3
1052,,B,Late Imperial Period,10,300,500,200,3
1053,,A,Republican Period,7,-200,-30,170,0.80000001
1053,,A,Early Imperial Period,8,-30,100,130,0.80000001
1053,,A,Mid-Imperial Period,9,100,300,200,0.80000001
1053,,A,Late Imperial Period,10,300,500,200,0.80000001
1054,,A,Mid-Imperial Period,9,100,300,200,0.1
1055,Tenuta della Paola,A,Early Imperial Period,8,-30,100,130,0.69999999
1055,Tenuta della Paola,A,Mid-Imperial Period,9,100,300,200,0.69999999
1055,Tenuta della Paola,A,Late Imperial Period,10,300,500,200,0.69999999
1056,Tenuta della Paola,A,Late Iron Age,5,-600,-580,20,0.30000001
1056,Tenuta della Paola,A,Archaic Period,6,-580,-350,230,0.30000001
1056,Tenuta della Paola,A,Republican Period,7,-350,-30,320,0.30000001
1056,Tenuta della Paola,A,Early Imperial Period,8,-30,100,130,0.30000001
1056,Tenuta della Paola,A,Mid-Imperial Period,9,100,300,200,0.30000001
1057,Tenuta della Paola,A,Late Iron Age,5,-600,-580,20,0.5
1057,Tenuta della Paola,A,Archaic Period,6,-580,-500,80,0.5
1057,Tenuta della Paola,B,Early Imperial Period,8,-30,100,130,0.5
1057,Tenuta della Paola,B,Mid-Imperial Period,9,100,300,200,0.5
1057,Tenuta della Paola,B,Late Imperial Period,10,300,500,200,0.5
1058,,A,Republican Period,7,-200,-30,170,0.1
1058,,B,Late Imperial Period,10,400,500,100,0.1
1059,,A,Late Iron Age,5,-600,-580,20,0.1
1059,,A,Archaic Period,6,-580,-350,230,0.1
1059,,A,Republican Period,7,-350,-30,320,0.1
1060,,A,Republican Period,7,-200,-30,170,0.1
1060,,A,Early Imperial Period,8,-30,100,130,0.1
1060,,A,Mid-Imperial Period,9,100,300,200,0.1
1061,,A,Late Iron Age,5,-600,-580,20,0.40000001
1061,,A,Archaic Period,6,-580,-350,230,0.40000001
1061,,A,Republican Period,7,-350,-30,320,0.40000001
1061,,A,Early Imperial Period,8,-30,100,130,0.40000001
1061,,A,Mid-Imperial Period,9,100,300,200,0.40000001
1061,,A,Late Imperial Period,10,300,500,200,0.40000001
1062,I Casaletti,A,Early Imperial Period,8,-30,100,130,0.40000001
1062,I Casaletti,A,Mid-Imperial Period,9,100,300,200,0.40000001
1062,I Casaletti,A,Late Imperial Period,10,300,500,200,0.40000001
1063,,A,Late Iron Age,5,-600,-580,20,0.5
1063,,A,Archaic Period,6,-580,-500,80,0.5
1064,Riserva della Paola,A,Republican Period,7,-100,-30,70,0.30000001
1064,Riserva della Paola,A,Early Imperial Period,8,-30,100,130,0.30000001
1065,,A,Late Iron Age,5,-600,-580,20,0.1
1065,,A,Archaic Period,6,-580,-350,230,0.1
1065,,A,Republican Period,7,-350,-30,320,0.1
1066,,A,Late Iron Age,5,-600,-580,20,0.5
1066,,A,Archaic Period,6,-580,-500,80,0.5
1067,,A,Late Iron Age,5,-600,-580,20,0.5
1067,,A,Archaic Period,6,-580,-500,80,0.5
1067,,B,Republican Period,7,-200,-30,170,0.5
1067,,B,Early Imperial Period,8,-30,100,130,0.5
1067,,B,Mid-Imperial Period,9,100,300,200,0.5
1068,Cecanibbio,A,Republican Period,7,-200,-30,170,1.5
1068,Cecanibbio,A,Early Imperial Period,8,-30,100,130,1.5
1068,Cecanibbio,A,Mid-Imperial Period,9,100,300,200,1.5
1069,La Polledrara,A,Republican Period,7,-200,-30,170,0.5
1070,La Polledrara,A,Republican Period,7,-100,-30,70,1
1070,La Polledrara,A,Early Imperial Period,8,-30,100,130,1
1070,La Polledrara,A,Mid-Imperial Period,9,100,300,200,1
1071,Casotto,A,Republican Period,7,-300,-100,200,0.1
1072,Casotto,A,Late Iron Age,5,-600,-580,20,0.30000001
1072,Casotto,A,Archaic Period,6,-580,-500,80,0.30000001
1072,Casotto,B,Mid-Imperial Period,9,200,300,100,0.30000001
1072,Casotto,B,Late Imperial Period,10,300,500,200,0.30000001
1073,Casotto,A,Late Iron Age,5,-600,-580,20,0.5
1073,Casotto,A,Archaic Period,6,-580,-350,230,0.5
1073,Casotto,A,Republican Period,7,-350,-30,320,0.5
1074,Casotto,A,Late Iron Age,5,-600,-580,20,0.40000001
1074,Casotto,A,Archaic Period,6,-580,-350,230,0.40000001
1074,Casotto,A,Republican Period,7,-350,-30,320,0.40000001
1074,Casotto,A,Early Imperial Period,8,-30,100,130,0.40000001
1074,Casotto,A,Mid-Imperial Period,9,100,300,200,0.40000001
1075,Casotto,A,Late Iron Age,5,-600,-580,20,0.2
1075,Casotto,A,Archaic Period,6,-580,-350,230,0.2
1075,Casotto,A,Republican Period,7,-350,-30,320,0.2
1076,,A,Late Iron Age,5,-600,-580,20,0.1
1076,,A,Archaic Period,6,-580,-350,230,0.1
1076,,A,Republican Period,7,-350,-30,320,0.1
1076,,A,Early Imperial Period,8,-30,100,130,0.1
1076,,A,Mid-Imperial Period,9,100,300,200,0.1
1076,,A,Late Imperial Period,10,300,500,200,0.1
1077,Ovile,A,Late Iron Age,5,-600,-580,20,1
1077,Ovile,A,Archaic Period,6,-580,-500,80,1
1077,Ovile,B,Early Imperial Period,8,-30,100,130,1
1077,Ovile,B,Mid-Imperial Period,9,100,300,200,1
1077,Ovile,B,Late Imperial Period,10,300,500,200,1
1078,Ovile,A,Late Iron Age,5,-600,-580,20,0.30000001
1078,Ovile,A,Archaic Period,6,-580,-500,80,0.30000001
1078,Ovile,B,Early Imperial Period,8,-30,100,130,0.30000001
1078,Ovile,B,Mid-Imperial Period,9,100,300,200,0.30000001
1078,Ovile,B,Late Imperial Period,10,300,500,200,0.30000001
1079,Ovile,A,Late Iron Age,5,-600,-580,20,0.2
1079,Ovile,A,Archaic Period,6,-580,-500,80,0.2
1080,,A,Late Iron Age,5,-600,-580,20,0.1
1080,,A,Archaic Period,6,-580,-500,80,0.1
1080,,B,Republican Period,7,-200,-30,170,0.1
1081,,A,Early Bronze Age,1,-2300,-1700,600,0.5
1081,,A,Middle Bronze Age,2,-1700,-1300,400,0.5
1081,,A,Late Bronze Age,3,-1300,-1020,280,0.5
1081,,A,Early Iron Age,4,-1020,-1000,20,0.5
1081,,B,Archaic Period,6,-500,-350,150,0.5
1081,,B,Republican Period,7,-350,-30,320,0.5
1081,,B,Early Imperial Period,8,-30,100,130,0.5
1081,,B,Mid-Imperial Period,9,100,300,200,0.5
1081,,B,Late Imperial Period,10,300,500,200,0.5
1082,Serra di Valle Galeria,A,Late Iron Age,5,-600,-580,20,0.2
1082,Serra di Valle Galeria,A,Archaic Period,6,-580,-500,80,0.2
1082,Serra di Valle Galeria,B,Early Imperial Period,8,-30,100,130,0.2
1082,Serra di Valle Galeria,B,Mid-Imperial Period,9,100,300,200,0.2
1082,Serra di Valle Galeria,B,Late Imperial Period,10,300,500,200,0.2
1083,,A,Late Iron Age,5,-600,-580,20,0.5
1083,,A,Archaic Period,6,-580,-500,80,0.5
1083,,B,Early Imperial Period,8,-30,100,130,0.5
1083,,B,Mid-Imperial Period,9,100,300,200,0.5
1083,,B,Late Imperial Period,10,300,500,200,0.5
1084,Monte Procoio,A,Late Iron Age,5,-600,-580,20,0.1
1084,Monte Procoio,A,Archaic Period,6,-580,-350,230,0.1
1084,Monte Procoio,A,Republican Period,7,-350,-30,320,0.1
1084,Monte Procoio,A,Early Imperial Period,8,-30,100,130,0.1
1084,Monte Procoio,A,Mid-Imperial Period,9,100,300,200,0.1
1084,Monte Procoio,A,Late Imperial Period,10,300,500,200,0.1
1085,Monte Procoio,A,Middle Bronze Age,2,-1700,-1300,400,0.1
1085,Monte Procoio,A,Late Bronze Age,3,-1300,-1020,280,0.1
1085,Monte Procoio,A,Early Iron Age,4,-1020,-1000,20,0.1
1085,Monte Procoio,B,Late Iron Age,5,-600,-580,20,0.1
1085,Monte Procoio,B,Archaic Period,6,-580,-500,80,0.1
1085,Monte Procoio,C,Republican Period,7,-300,-100,200,0.1
1086,Riserva delle Capanne,A,Republican Period,7,-200,-30,170,1.4
1086,Riserva delle Capanne,A,Early Imperial Period,8,-30,100,130,1.4
1086,Riserva delle Capanne,A,Mid-Imperial Period,9,100,300,200,1.4
1087,Riserva delle Capanne,A,Republican Period,7,-200,-30,170,0.30000001
1087,Riserva delle Capanne,A,Early Imperial Period,8,-30,100,130,0.30000001
1087,Riserva delle Capanne,A,Mid-Imperial Period,9,100,300,200,0.30000001
1087,Riserva delle Capanne,A,Late Imperial Period,10,300,500,200,0.30000001
1088,le Tre Vallette,A,Late Iron Age,5,-600,-580,20,0.5
1088,le Tre Vallette,A,Archaic Period,6,-580,-500,80,0.5
1088,le Tre Vallette,B,Republican Period,7,-200,-100,100,0.5
1089,,A,Late Iron Age,5,-600,-580,20,0.1
1089,,A,Archaic Period,6,-580,-500,80,0.1
1089,,B,Republican Period,7,-200,-30,170,0.1
1089,,B,Early Imperial Period,8,-30,100,130,0.1
1089,,B,Mid-Imperial Period,9,100,300,200,0.1
1089,,B,Late Imperial Period,10,300,500,200,0.1
1090,le Tre Vallette,A,Republican Period,7,-200,-30,170,0.30000001
1090,le Tre Vallette,A,Early Imperial Period,8,-30,100,130,0.30000001
1091,,A,Republican Period,7,-200,-30,170,0.40000001
1091,,A,Early Imperial Period,8,-30,100,130,0.5
1091,,A,Mid-Imperial Period,9,100,300,200,0.5
1092,,A,Archaic Period,6,-500,-350,150,0.1
1092,,A,Republican Period,7,-350,-30,320,0.1
1093,,A,Late Iron Age,5,-700,-580,120,0.2
1093,,A,Archaic Period,6,-580,-500,80,0.2
1094,,A,Late Iron Age,5,-600,-580,20,0.60000002
1094,,A,Archaic Period,6,-580,-500,80,0.60000002
1094,,B,Republican Period,7,-200,-30,170,0.60000002
1094,,B,Early Imperial Period,8,-30,100,130,0.60000002
1094,,B,Mid-Imperial Period,9,100,300,200,0.60000002
1095,,A,Late Iron Age,5,-600,-580,20,0.40000001
1095,,A,Archaic Period,6,-580,-500,80,0.40000001
1095,,B,Republican Period,7,-200,-30,170,0.40000001
1096,Serra della Sargia,A,Republican Period,7,-100,-30,70,0.2
1096,Serra della Sargia,A,Early Imperial Period,8,-30,100,130,0.2
1096,Serra della Sargia,A,Mid-Imperial Period,9,100,300,200,0.2
1097,Serra della Sargia,A,Archaic Period,6,-500,-350,150,0.30000001
1097,Serra della Sargia,A,Republican Period,7,-350,-30,320,0.30000001
1097,Serra della Sargia,A,Early Imperial Period,8,-30,100,130,0.30000001
1097,Serra della Sargia,A,Mid-Imperial Period,9,100,300,200,0.30000001
1097,Serra della Sargia,A,Late Imperial Period,10,300,500,200,0.30000001
1098,Serra della Sargia,A,Archaic Period,6,-500,-350,150,0.2
1098,Serra della Sargia,A,Republican Period,7,-350,-30,320,0.2
1098,Serra della Sargia,A,Early Imperial Period,8,-30,100,130,0.2
1098,Serra della Sargia,A,Mid-Imperial Period,9,100,300,200,0.2
1098,Serra della Sargia,A,Late Imperial Period,10,300,500,200,0.2
1099,Serra Valle Galeria,A,Archaic Period,6,-500,-350,150,0.1
1099,Serra Valle Galeria,A,Republican Period,7,-350,-30,320,0.1
1099,Serra Valle Galeria,A,Early Imperial Period,8,-30,100,130,0.1
1099,Serra Valle Galeria,A,Mid-Imperial Period,9,100,300,200,0.1
1099,Serra Valle Galeria,A,Late Imperial Period,10,300,500,200,0.1
1100,Serra di Valle Galeria,A,Archaic Period,6,-500,-350,150,0.1
1100,Serra di Valle Galeria,A,Republican Period,7,-350,-30,320,0.1
1100,Serra di Valle Galeria,A,Early Imperial Period,8,-30,100,130,0.1
1100,Serra di Valle Galeria,A,Mid-Imperial Period,9,100,300,200,0.1
1100,Serra di Valle Galeria,A,Late Imperial Period,10,300,500,200,0.1
1101,Serra di Valle Galeria,A,Late Iron Age,5,-600,-580,20,0.30000001
1101,Serra di Valle Galeria,A,Archaic Period,6,-580,-350,230,0.30000001
1101,Serra di Valle Galeria,A,Republican Period,7,-350,-30,320,0.30000001
1101,Serra di Valle Galeria,B,Mid-Imperial Period,9,100,300,200,0.30000001
1102,Riserva di Valle Galeria,A,Republican Period,7,-100,-30,70,0.2
1102,Riserva di Valle Galeria,A,Early Imperial Period,8,-30,100,130,0.2
1102,Riserva di Valle Galeria,A,Mid-Imperial Period,9,100,300,200,0.2
1103,Riserva di Valle Galeria,A,Archaic Period,6,-500,-350,150,0.60000002
1103,Riserva di Valle Galeria,A,Republican Period,7,-350,-30,320,0.60000002
1103,Riserva di Valle Galeria,A,Early Imperial Period,8,-30,100,130,0.60000002
1103,Riserva di Valle Galeria,A,Mid-Imperial Period,9,100,300,200,0.60000002
1104,Riserva di Valle Galeria,A,Late Iron Age,5,-600,-580,20,0.2
1104,Riserva di Valle Galeria,A,Archaic Period,6,-580,-500,80,0.2
1105,Riserva di Valle Galeria,A,Archaic Period,6,-500,-350,150,0.30000001
1105,Riserva di Valle Galeria,A,Republican Period,7,-350,-30,320,0.30000001
1105,Riserva di Valle Galeria,A,Early Imperial Period,8,-30,100,130,0.30000001
1105,Riserva di Valle Galeria,A,Mid-Imperial Period,9,100,300,200,0.30000001
1106,,A,Late Iron Age,5,-600,-580,20,0.2
1106,,A,Archaic Period,6,-580,-500,80,0.2
1107,Riserva di Valle Galeria,A,Late Iron Age,5,-600,-580,20,0.1
1107,Riserva di Valle Galeria,A,Archaic Period,6,-580,-350,230,0.1
1107,Riserva di Valle Galeria,A,Republican Period,7,-350,-30,320,0.1
1107,Riserva di Valle Galeria,A,Early Imperial Period,8,-30,100,130,0.1
1107,Riserva di Valle Galeria,A,Mid-Imperial Period,9,100,300,200,0.1
1107,Riserva di Valle Galeria,A,Late Imperial Period,10,300,500,200,0.1
1108,Riserva di Valle Galeria,A,Late Iron Age,5,-600,-580,20,0.1
1108,Riserva di Valle Galeria,A,Archaic Period,6,-580,-500,80,0.1
1108,Riserva di Valle Galeria,B,Republican Period,7,-200,-30,170,0.1
1108,Riserva di Valle Galeria,B,Early Imperial Period,8,-30,100,130,0.1
1108,Riserva di Valle Galeria,B,Mid-Imperial Period,9,100,300,200,0.1
1109,Riserva di Valle Galeria,A,Republican Period,7,-200,-30,170,0.1
1109,Riserva di Valle Galeria,A,Early Imperial Period,8,-30,100,130,0.1
1109,Riserva di Valle Galeria,A,Mid-Imperial Period,9,100,300,200,0.1
1110,Riserva delle Sette Rubbia,A,Late Iron Age,5,-600,-580,20,0.60000002
1110,Riserva delle Sette Rubbia,A,Archaic Period,6,-580,-500,80,0.60000002
1110,Riserva delle Sette Rubbia,B,Republican Period,7,-200,-30,170,0.60000002
1110,Riserva delle Sette Rubbia,B,Early Imperial Period,8,-30,100,130,0.60000002
1110,Riserva delle Sette Rubbia,B,Mid-Imperial Period,9,100,300,200,0.60000002
1111,Monte di Bocca,A,Archaic Period,6,-500,-350,150,0.60000002
1111,Monte di Bocca,A,Republican Period,7,-350,-30,320,0.60000002
1111,Monte di Bocca,A,Early Imperial Period,8,-30,100,130,0.60000002
1111,Monte di Bocca,A,Mid-Imperial Period,9,100,300,200,0.60000002
1111,Monte di Bocca,A,Late Imperial Period,10,300,500,200,0.60000002
1112,Riserva delle Sette Rubbia,A,Republican Period,7,-200,-30,170,0.1
1112,Riserva delle Sette Rubbia,A,Early Imperial Period,8,-30,100,130,0.1
1112,Riserva delle Sette Rubbia,A,Mid-Imperial Period,9,100,300,200,0.1
1113,Riserva delle Sette Rubbia,A,Republican Period,7,-200,-30,170,0.80000001
1113,Riserva delle Sette Rubbia,A,Early Imperial Period,8,-30,100,130,0.80000001
1113,Riserva delle Sette Rubbia,A,Mid-Imperial Period,9,100,300,200,0.80000001
1114,Riserva delle Sette Rubbia,A,Republican Period,7,-200,-30,170,0.1
1115,Riserva dell'Olmo,A,Early Imperial Period,8,-30,100,130,0.1
1115,Riserva dell'Olmo,A,Mid-Imperial Period,9,100,300,200,0.1
1115,Riserva dell'Olmo,A,Late Imperial Period,10,300,500,200,0.1
1116,,A,Late Iron Age,5,-600,-580,20,0.1
1116,,A,Archaic Period,6,-580,-500,80,0.1
1117,,A,Late Iron Age,5,-600,-580,20,0.60000002
1117,,A,Archaic Period,6,-580,-500,80,0.60000002
1118,Riserva dell'Olmo,A,Archaic Period,6,-500,-350,150,0.2
1118,Riserva dell'Olmo,A,Republican Period,7,-350,-30,320,0.2
1118,Riserva dell'Olmo,A,Early Imperial Period,8,-30,100,130,0.2
1118,Riserva dell'Olmo,A,Mid-Imperial Period,9,100,300,200,0.2
1119,,A,Late Iron Age,5,-600,-580,20,0.30000001
1119,,A,Archaic Period,6,-580,-500,80,0.30000001
1119,,B,Republican Period,7,-100,-30,70,0.30000001
1119,,B,Early Imperial Period,8,-30,100,130,0.30000001
1119,,B,Mid-Imperial Period,9,100,300,200,0.30000001
1120,Riserva dell'Olmo,A,Late Iron Age,5,-600,-580,20,0.1
1120,Riserva dell'Olmo,A,Archaic Period,6,-580,-350,230,0.1
1120,Riserva dell'Olmo,A,Republican Period,7,-350,-30,320,0.1
1121,Riserva delle Sette Rubbia,A,Early Imperial Period,8,-30,100,130,0.1
1121,Riserva delle Sette Rubbia,A,Mid-Imperial Period,9,100,300,200,0.1
1121,Riserva delle Sette Rubbia,A,Late Imperial Period,10,300,500,200,0.1
1122,Riserva dell'Olmo,A,Late Iron Age,5,-600,-580,20,0.1
1122,Riserva dell'Olmo,A,Archaic Period,6,-580,-500,80,0.1
1122,Riserva dell'Olmo,B,Early Imperial Period,8,-30,100,130,0.1
1122,Riserva dell'Olmo,B,Mid-Imperial Period,9,100,300,200,0.1
1122,Riserva dell'Olmo,B,Late Imperial Period,10,300,500,200,0.1
1123,Riserva dell'Olmo,A,Late Iron Age,5,-600,-580,20,0.60000002
1123,Riserva dell'Olmo,A,Archaic Period,6,-580,-500,80,0.60000002
1123,Riserva dell'Olmo,B,Republican Period,7,-200,-30,170,0.60000002
1123,Riserva dell'Olmo,B,Early Imperial Period,8,-30,100,130,0.60000002
1123,Riserva dell'Olmo,B,Mid-Imperial Period,9,100,300,200,0.60000002
1124,,A,Late Iron Age,5,-600,-580,20,0.1
1124,,A,Archaic Period,6,-580,-500,80,0.1
1124,,B,Mid-Imperial Period,9,200,300,100,0.1
1124,,B,Late Imperial Period,10,300,500,200,0.1
1125,,A,Republican Period,7,-100,-30,70,0.1
1125,,A,Early Imperial Period,8,-30,100,130,0.1
1125,,A,Mid-Imperial Period,9,100,300,200,0.1
1125,,A,Late Imperial Period,10,300,500,200,0.1
1126,,A,Republican Period,7,-200,-30,170,0.69999999
1126,,A,Early Imperial Period,8,-30,100,130,0.69999999
1126,,A,Mid-Imperial Period,9,100,300,200,0.69999999
1127,,A,Late Bronze Age,3,-1200,-1020,180,0.30000001
1127,,A,Early Iron Age,4,-1020,-1000,20,0.30000001
1127,,B,Late Iron Age,5,-700,-580,120,0.30000001
1127,,B,Archaic Period,6,-580,-500,80,0.30000001
1128,,A,Early Bronze Age,1,-2300,-1700,600,0.30000001
1128,,A,Middle Bronze Age,2,-1700,-1300,400,0.30000001
1128,,A,Late Bronze Age,3,-1300,-1020,280,0.30000001
1128,,A,Early Iron Age,4,-1020,-1000,20,0.30000001
1128,,B,Archaic Period,6,-500,-350,150,0.30000001
1128,,B,Republican Period,7,-350,-30,320,0.30000001
1128,,B,Early Imperial Period,8,-30,100,130,0.30000001
1128,,B,Mid-Imperial Period,9,100,300,200,0.30000001
1128,,B,Late Imperial Period,10,300,500,200,0.30000001
1129,Castel Lombardo,A,Middle Bronze Age,2,-1700,-1300,400,0.1
1130,Quarto Lungo,A,Early Bronze Age,1,-2300,-1700,600,1
1130,Quarto Lungo,A,Middle Bronze Age,2,-1700,-1300,400,1
1130,Quarto Lungo,A,Late Bronze Age,3,-1300,-1020,280,1
1130,Quarto Lungo,A,Early Iron Age,4,-1020,-1000,20,1
1130,Quarto Lungo,B,Late Iron Age,5,-600,-580,20,1
1130,Quarto Lungo,B,Archaic Period,6,-580,-350,230,1
1130,Quarto Lungo,B,Republican Period,7,-350,-30,320,1
1130,Quarto Lungo,B,Early Imperial Period,8,-30,100,130,1
1130,Quarto Lungo,B,Mid-Imperial Period,9,100,300,200,1
1131,,A,Early Bronze Age,1,-2300,-1700,600,0.1
1131,,A,Middle Bronze Age,2,-1700,-1300,400,0.1
1131,,A,Late Bronze Age,3,-1300,-1020,280,0.1
1131,,A,Early Iron Age,4,-1020,-1000,20,0.1
1132,Quarto della CadutaL,A,Late Iron Age,5,-700,-600,100,0.2
1133,Anagni,A,Late Iron Age,5,-600,-580,20,5
1133,Anagni,A,Archaic Period,6,-580,-500,80,5
1134,Anagni,A,Archaic Period,6,-500,-350,150,12
1134,Anagni,A,Republican Period,7,-350,-30,320,12
1134,Anagni,A,Early Imperial Period,8,-30,100,130,12
1134,Anagni,A,Mid-Imperial Period,9,100,300,200,12
1134,Anagni,A,Late Imperial Period,10,300,500,200,12
1135,,A,Archaic Period,6,-500,-350,150,0.69999999
1135,,A,Republican Period,7,-350,-30,320,0.69999999
1135,,A,Early Imperial Period,8,-30,100,130,0.69999999
1135,,A,Mid-Imperial Period,9,100,300,200,0.69999999
1135,,A,Late Imperial Period,10,300,500,200,0.69999999
1136,,A,Mid-Imperial Period,9,100,300,200,1
1136,,A,Late Imperial Period,10,300,500,200,1
1137,,A,Republican Period,7,-200,-30,170,1
1137,,A,Early Imperial Period,8,-30,100,130,1
1137,,A,Mid-Imperial Period,9,100,300,200,1
1137,,A,Late Imperial Period,10,300,500,200,1
1138,,A,Republican Period,7,-200,-30,170,1
1138,,A,Early Imperial Period,8,-30,100,130,1
1138,,A,Mid-Imperial Period,9,100,300,200,1
1138,,A,Late Imperial Period,10,300,500,200,1
1139,,A,Late Imperial Period,10,300,500,200,1
1140,,A,Archaic Period,6,-500,-350,150,1
1140,,A,Republican Period,7,-350,-30,320,1
1140,,A,Early Imperial Period,8,-30,100,130,1
1140,,A,Mid-Imperial Period,9,100,300,200,1
1140,,A,Late Imperial Period,10,300,500,200,1
1141,,A,Republican Period,7,-200,-30,170,1
1141,,A,Early Imperial Period,8,-30,100,130,1
1141,,A,Mid-Imperial Period,9,100,300,200,1
1141,,A,Late Imperial Period,10,300,500,200,1
1142,,A,Republican Period,7,-200,-30,170,1
1142,,A,Early Imperial Period,8,-30,100,130,1
1142,,A,Mid-Imperial Period,9,100,300,200,1
1142,,A,Late Imperial Period,10,300,500,200,1
1143,,A,Republican Period,7,-200,-30,170,1
1143,,A,Early Imperial Period,8,-30,100,130,1
1143,,A,Mid-Imperial Period,9,100,300,200,1
1143,,A,Late Imperial Period,10,300,500,200,1
1144,,A,Republican Period,7,-200,-30,170,0.69999999
1144,,A,Early Imperial Period,8,-30,100,130,0.69999999
1144,,A,Mid-Imperial Period,9,100,300,200,0.69999999
1144,,A,Late Imperial Period,10,300,500,200,0.69999999
1145,,A,Republican Period,7,-200,-30,170,1
1145,,A,Early Imperial Period,8,-30,100,130,1
1145,,A,Mid-Imperial Period,9,100,300,200,1
1145,,A,Late Imperial Period,10,300,500,200,1
1146,,A,Republican Period,7,-200,-30,170,1
1146,,A,Early Imperial Period,8,-30,100,130,1
1146,,A,Mid-Imperial Period,9,100,300,200,1
1146,,A,Late Imperial Period,10,300,500,200,1
1147,,A,Republican Period,7,-200,-30,170,1
1147,,A,Early Imperial Period,8,-30,100,130,1
1147,,A,Mid-Imperial Period,9,100,300,200,1
1147,,A,Late Imperial Period,10,300,500,200,1
1148,,A,Late Imperial Period,10,300,500,200,1
1149,,A,Republican Period,7,-200,-30,170,1
1149,,A,Early Imperial Period,8,-30,100,130,1
1149,,A,Mid-Imperial Period,9,100,300,200,1
1149,,A,Late Imperial Period,10,300,500,200,1
1150,,A,Republican Period,7,-200,-30,170,0.5
1150,,A,Early Imperial Period,8,-30,100,130,0.5
1150,,A,Mid-Imperial Period,9,100,300,200,0.5
1150,,A,Late Imperial Period,10,300,500,200,0.5
1151,,A,Republican Period,7,-200,-30,170,0.5
1151,,A,Early Imperial Period,8,-30,100,130,0.5
1151,,A,Mid-Imperial Period,9,100,300,200,0.5
1151,,A,Late Imperial Period,10,300,500,200,0.5
1152,,A,Archaic Period,6,-500,-350,150,2
1152,,A,Republican Period,7,-350,-30,320,2
1152,,A,Early Imperial Period,8,-30,100,130,2
1152,,A,Mid-Imperial Period,9,100,300,200,2
1152,,A,Late Imperial Period,10,300,500,200,2
1153,Villamagna,A,Mid-Imperial Period,9,100,300,200,7
1153,Villamagna,A,Late Imperial Period,10,300,500,200,7
1154,,A,Republican Period,7,-200,-30,170,0.69999999
1154,,A,Early Imperial Period,8,-30,100,130,0.69999999
1154,,A,Mid-Imperial Period,9,100,300,200,0.69999999
1154,,A,Late Imperial Period,10,300,500,200,0.69999999
1155,,A,Republican Period,7,-200,-30,170,1
1155,,A,Early Imperial Period,8,-30,100,130,1
1155,,A,Mid-Imperial Period,9,100,300,200,1
1155,,A,Late Imperial Period,10,300,500,200,1
1156,,A,Republican Period,7,-200,-30,170,1
1156,,A,Early Imperial Period,8,-30,100,130,1
1156,,A,Mid-Imperial Period,9,100,300,200,1
1156,,A,Late Imperial Period,10,300,500,200,1
1157,,A,Republican Period,7,-200,-30,170,1
1157,,A,Early Imperial Period,8,-30,100,130,1
1157,,A,Mid-Imperial Period,9,100,300,200,1
1157,,A,Late Imperial Period,10,300,500,200,1
1158,,A,Republican Period,7,-200,-30,170,1
1158,,A,Early Imperial Period,8,-30,100,130,1
1158,,A,Mid-Imperial Period,9,100,300,200,1
1158,,A,Late Imperial Period,10,300,500,200,1
1159,,A,Republican Period,7,-200,-30,170,0.5
1159,,A,Early Imperial Period,8,-30,100,130,0.5
1159,,A,Mid-Imperial Period,9,100,300,200,0.5
1159,,A,Late Imperial Period,10,300,500,200,0.5
1160,,A,Republican Period,7,-200,-30,170,0.5
1160,,A,Early Imperial Period,8,-30,100,130,0.5
1160,,A,Mid-Imperial Period,9,100,300,200,0.5
1160,,A,Late Imperial Period,10,300,500,200,0.5
1161,Fontana Grano,A,Republican Period,7,-200,-30,170,1
1161,Fontana Grano,A,Early Imperial Period,8,-30,100,130,1
1161,Fontana Grano,A,Mid-Imperial Period,9,100,300,200,1
1161,Fontana Grano,A,Late Imperial Period,10,300,500,200,1
1162,Fontana Abate,A,Republican Period,7,-200,-30,170,0.5
1162,Fontana Abate,A,Early Imperial Period,8,-30,100,130,0.5
1162,Fontana Abate,A,Mid-Imperial Period,9,100,300,200,0.5
1162,Fontana Abate,A,Late Imperial Period,10,300,500,200,0.5
1163,Colle S. Vito,A,Republican Period,7,-200,-30,170,0.5
1163,Colle S. Vito,A,Early Imperial Period,8,-30,100,130,0.5
1163,Colle S. Vito,A,Mid-Imperial Period,9,100,300,200,0.5
1163,Colle S. Vito,A,Late Imperial Period,10,300,500,200,0.5
1164,Fontana Acetosa,A,Republican Period,7,-200,-30,170,1
1164,Fontana Acetosa,A,Early Imperial Period,8,-30,100,130,1
1164,Fontana Acetosa,A,Mid-Imperial Period,9,100,300,200,1
1164,Fontana Acetosa,A,Late Imperial Period,10,300,500,200,1
1165,S. Filippo,A,Republican Period,7,-200,-30,170,1
1165,S. Filippo,A,Early Imperial Period,8,-30,100,130,1
1165,S. Filippo,A,Mid-Imperial Period,9,100,300,200,1
1165,S. Filippo,A,Late Imperial Period,10,300,500,200,1
1166,Canelara,A,Republican Period,7,-200,-30,170,1
1166,Canelara,A,Early Imperial Period,8,-30,100,130,1
1166,Canelara,A,Mid-Imperial Period,9,100,300,200,1
1166,Canelara,A,Late Imperial Period,10,300,500,200,1
1167,Vignola,A,Republican Period,7,-200,-30,170,1
1167,Vignola,A,Early Imperial Period,8,-30,100,130,1
1167,Vignola,A,Mid-Imperial Period,9,100,300,200,1
1167,Vignola,A,Late Imperial Period,10,300,500,200,1
1168,Monte S. Giorgio,A,Republican Period,7,-200,-30,170,0.5
1168,Monte S. Giorgio,A,Early Imperial Period,8,-30,100,130,0.5
1168,Monte S. Giorgio,A,Mid-Imperial Period,9,100,300,200,0.5
1168,Monte S. Giorgio,A,Late Imperial Period,10,300,500,200,0.5
1169,Pedicate,A,Republican Period,7,-200,-30,170,1
1169,Pedicate,A,Early Imperial Period,8,-30,100,130,1
1169,Pedicate,A,Mid-Imperial Period,9,100,300,200,1
1169,Pedicate,A,Late Imperial Period,10,300,500,200,1
1170,Prato Castagno,A,Republican Period,7,-200,-30,170,1
1170,Prato Castagno,A,Early Imperial Period,8,-30,100,130,1
1170,Prato Castagno,A,Mid-Imperial Period,9,100,300,200,1
1170,Prato Castagno,A,Late Imperial Period,10,300,500,200,1
1171,Ara la Stella,A,Republican Period,7,-200,-30,170,0.5
1171,Ara la Stella,A,Early Imperial Period,8,-30,100,130,0.5
1171,Ara la Stella,A,Mid-Imperial Period,9,100,300,200,0.5
1171,Ara la Stella,A,Late Imperial Period,10,300,500,200,0.5
1172,Valle S. Pietro,A,Republican Period,7,-200,-30,170,1
1172,Valle S. Pietro,A,Early Imperial Period,8,-30,100,130,1
1172,Valle S. Pietro,A,Mid-Imperial Period,9,100,300,200,1
1172,Valle S. Pietro,A,Late Imperial Period,10,300,500,200,1
1173,Colle Capone,A,Republican Period,7,-200,-30,170,1
1173,Colle Capone,A,Early Imperial Period,8,-30,100,130,1
1173,Colle Capone,A,Mid-Imperial Period,9,100,300,200,1
1173,Colle Capone,A,Late Imperial Period,10,300,500,200,1
1174,Monte Sroppa/Torre dell'Isola,A,Late Bronze Age,3,-1200,-1020,180,3
1174,Monte Sroppa/Torre dell'Isola,A,Early Iron Age,4,-1020,-1000,20,3
1175,PVPB28,A,Early Iron Age,4,-1000,-750,250,1
1175,PVPB28,A,Late Iron Age,5,-750,-580,170,1
1175,PVPB28,A,Archaic Period,6,-580,-350,230,1
1175,PVPB28,A,Republican Period,7,-350,-30,320,1
1175,PVPB28,A,Early Imperial Period,8,-30,100,130,1
1175,PVPB28,A,Mid-Imperial Period,9,100,300,200,1
1175,PVPB28,A,Late Imperial Period,10,300,500,200,1
1176,PVPB15/1,A,Early Bronze Age,1,-2300,-1700,600,1
1176,PVPB15/1,A,Middle Bronze Age,2,-1700,-1300,400,1
1176,PVPB15/1,A,Late Bronze Age,3,-1300,-1020,280,1
1176,PVPB15/1,A,Early Iron Age,4,-1020,-1000,20,1
1176,PVPB15/1,B,Late Iron Age,5,-700,-580,120,1
1176,PVPB15/1,B,Archaic Period,6,-580,-350,230,1
1176,PVPB15/1,B,Republican Period,7,-350,-30,320,1
1176,PVPB15/1,B,Early Imperial Period,8,-30,100,130,1
1176,PVPB15/1,B,Mid-Imperial Period,9,100,300,200,1
1176,PVPB15/1,B,Late Imperial Period,10,300,500,200,1
1177,GMPT42,A,Late Bronze Age,3,-1300,-1020,280,1
1177,GMPT42,A,Early Iron Age,4,-1020,-1000,20,1
1178,Grotta Arnaro I,A,Early Bronze Age,1,-2300,-1700,600,0.2
1178,Grotta Arnaro I,A,Middle Bronze Age,2,-1700,-1300,400,0.2
1178,Grotta Arnaro I,A,Late Bronze Age,3,-1300,-1200,100,0.2
1179,Grotta Arnaro II,A,Early Bronze Age,1,-2300,-1700,600,0.1
1179,Grotta Arnaro II,A,Middle Bronze Age,2,-1700,-1300,400,0.1
1180,Porciano,A,Early Bronze Age,1,-2300,-1700,600,0.1
1180,Porciano,A,Middle Bronze Age,2,-1700,-1300,400,0.1
1181,Solfate,A,Early Bronze Age,1,-2300,-1700,600,0.41442153
1181,Solfate,A,Middle Bronze Age,2,-1700,-1300,400,0.41442153
1181,Solfate,B,Republican Period,7,-100,-30,70,0.41442153
1184,Casale Coazzo,A,Late Iron Age,5,-600,-580,20,18
1184,Casale Coazzo,A,Archaic Period,6,-580,-350,230,18
1184,Casale Coazzo,A,Republican Period,7,-350,-200,150,18
1185,Via Nomentana,A,Late Iron Age,5,-600,-580,20,1.5
1185,Via Nomentana,A,Archaic Period,6,-580,-350,230,1.5
1185,Via Nomentana,A,Republican Period,7,-350,-200,150,1.5
1186,Via Casal Bianco,A,Late Iron Age,5,-600,-580,20,1.5
1186,Via Casal Bianco,A,Archaic Period,6,-580,-350,230,1.5
1186,Via Casal Bianco,A,Republican Period,7,-350,-200,150,1.5
1187,Via Tiburtina (Caenina?),A,Late Iron Age,5,-650,-580,70,3
1187,Via Tiburtina (Caenina?),A,Archaic Period,6,-580,-350,230,3
1187,Via Tiburtina (Caenina?),A,Republican Period,7,-350,-30,320,3
1187,,A,Early Imperial Period,8,-30,100,130,0.6091466
1187,,A,Mid-Imperial Period,9,100,300,200,0.6091466
1187,,A,Late Imperial Period,10,300,400,100,0.6091466
1188,,A,Archaic Period,6,-500,-350,150,1.5
1188,,A,Republican Period,7,-350,-200,150,1.5
1189,,A,Archaic Period,6,-500,-350,150,1.5
1189,,A,Republican Period,7,-350,-200,150,1.5
1190,Via Cassia,A,Late Iron Age,5,-600,-580,20,2
1190,Via Cassia,A,Archaic Period,6,-580,-350,230,2
1190,Via Cassia,A,Republican Period,7,-350,-200,150,2
1191,Fidenae,A,Middle Bronze Age,2,-1700,-1300,400,1.7450624
1191,Fidenae,A,Late Bronze Age,3,-1300,-1020,280,7.005723
1191,Fidenae,A,Early Iron Age,4,-1020,-750,270,13.799823
1191,Fidenae,A,Late Iron Age,5,-750,-580,170,30.593599
1191,Fidenae,A,Archaic Period,6,-580,-350,230,52.642628
1191,Fidenae,A,Republican Period,7,-350,-30,320,18.744146
1191,Fidenae,A,Early Imperial Period,8,-30,100,130,25.665359
1191,Fidenae,A,Mid-Imperial Period,9,100,300,200,25.665359
1191,Fidenae,A,Late Imperial Period,10,300,500,200,25.665359
1192,Crustumerium,A,Late Bronze Age,3,-1200,-1020,180,2.7446189
1192,Crustumerium,A,Early Iron Age,4,-1020,-750,270,7.657176
1192,Crustumerium,A,Late Iron Age,5,-750,-580,170,55
1192,Crustumerium,A,Archaic Period,6,-580,-350,230,43.473751
1192,Crustumerium,A,Republican Period,7,-350,-30,320,6.3887458
1192,Crustumerium,A,Early Imperial Period,8,-30,100,130,1.2625595
1192,Crustumerium,A,Mid-Imperial Period,9,100,200,100,1.2625595
1193,Muro Linari,A,Mid-Imperial Period,9,100,200,100,0.40000001
1194,Passo Lombardo,A,Early Imperial Period,8,-30,100,130,0.30000001
1194,Passo Lombardo,A,Mid-Imperial Period,9,100,300,200,0.30000001
1194,Passo Lombardo,A,Late Imperial Period,10,300,500,200,0.30000001
1195,Muro Linari,A,Early Imperial Period,8,-30,100,130,0.5
1195,Muro Linari,A,Mid-Imperial Period,9,100,300,200,0.5
1195,Muro Linari,A,Late Imperial Period,10,300,500,200,0.5
1196,,A,Republican Period,7,-100,-30,70,0.69999999
1196,,A,Early Imperial Period,8,-30,100,130,0.69999999
1196,,A,Mid-Imperial Period,9,100,300,200,0.69999999
1196,,A,Late Imperial Period,10,300,500,200,0.69999999
1197,,A,Mid-Imperial Period,9,100,300,200,0.30000001
1198,Fosso della Botte di S. Andrea,A,Mid-Imperial Period,9,100,300,200,0.60000002
1199,,A,Republican Period,7,-200,-30,170,0.60000002
1200,,A,Early Imperial Period,8,-30,100,130,0.40000001
1200,,A,Mid-Imperial Period,9,100,300,200,0.40000001
1200,,A,Late Imperial Period,10,300,500,200,0.40000001
1201,Casale di Gregna,A,Mid-Imperial Period,9,200,300,100,0.89999998
1201,Casale di Gregna,A,Late Imperial Period,10,300,500,200,0.89999998
1202,Torre di Morena,A,Republican Period,7,-100,-30,70,0.30000001
1203,,A,Mid-Imperial Period,9,100,300,200,0.5
1203,,A,Late Imperial Period,10,300,500,200,0.5
1204,Colonnette,A,Early Imperial Period,8,-30,100,130,0.5
1204,Colonnette,A,Mid-Imperial Period,9,100,300,200,0.5
1204,Colonnette,A,Late Imperial Period,10,300,500,200,0.5
1205,Colonnette,A,Mid-Imperial Period,9,100,300,200,0.30000001
1206,,A,Republican Period,7,-100,-30,70,0.40000001
1206,,A,Early Imperial Period,8,-30,100,130,0.40000001
1206,,A,Mid-Imperial Period,9,100,300,200,0.40000001
1206,,A,Late Imperial Period,10,300,500,200,0.40000001
1207,Tenuta dei Centroni,A,Early Imperial Period,8,-30,100,130,1.7
1207,Tenuta dei Centroni,A,Mid-Imperial Period,9,100,300,200,1.7
1207,Tenuta dei Centroni,A,Late Imperial Period,10,300,500,200,1.7
1208,Villa dei Centroni,A,Early Imperial Period,8,-30,100,130,2
1208,Villa dei Centroni,A,Mid-Imperial Period,9,100,300,200,2
1208,Villa dei Centroni,A,Late Imperial Period,10,300,500,200,2
1209,Villa di Casal Morena,A,Early Imperial Period,8,-30,100,130,2
1209,Villa di Casal Morena,A,Mid-Imperial Period,9,100,300,200,2
1209,Villa di Casal Morena,A,Late Imperial Period,10,300,500,200,2
1210,,A,Early Imperial Period,8,-30,100,130,0.40000001
1210,,A,Mid-Imperial Period,9,100,300,200,0.40000001
1210,,A,Late Imperial Period,10,300,500,200,0.40000001
1211,,A,Late Imperial Period,10,300,500,200,0.60000002
1212,Ad Decimum,A,Early Imperial Period,8,-30,100,130,3.5
1212,Ad Decimum,A,Mid-Imperial Period,9,100,300,200,3.5
1212,Ad Decimum,A,Late Imperial Period,10,300,500,200,3.5
1213,Casale di Marzio,A,Early Imperial Period,8,-30,100,130,0.40000001
1213,Casale di Marzio,A,Mid-Imperial Period,9,100,300,200,0.40000001
1213,Casale di Marzio,A,Late Imperial Period,10,300,500,200,0.40000001
1214,Casale della Pignola,A,Early Imperial Period,8,-30,100,130,0.69999999
1214,Casale della Pignola,A,Mid-Imperial Period,9,100,300,200,0.69999999
1214,Casale della Pignola,A,Late Imperial Period,10,300,500,200,0.69999999
1215,,A,Early Imperial Period,8,-30,100,130,0.69999999
1215,,A,Mid-Imperial Period,9,100,300,200,0.69999999
1215,,A,Late Imperial Period,10,300,500,200,0.69999999
1216,Pignola,A,Republican Period,7,-100,-30,70,0.40000001
1217,,A,Republican Period,7,-100,-30,70,0.40000001
1217,,A,Early Imperial Period,8,-30,100,130,0.40000001
1217,,A,Mid-Imperial Period,9,100,300,200,0.40000001
1217,,A,Late Imperial Period,10,300,500,200,0.40000001
1218,,A,Early Imperial Period,8,-30,100,130,0.30000001
1218,,A,Mid-Imperial Period,9,100,300,200,0.30000001
1218,,A,Late Imperial Period,10,300,500,200,0.30000001
1219,Torre dell'Acqua Sotterra,A,Early Imperial Period,8,-30,100,130,0.69999999
1219,Torre dell'Acqua Sotterra,A,Mid-Imperial Period,9,100,300,200,0.69999999
1219,Torre dell'Acqua Sotterra,A,Late Imperial Period,10,300,500,200,0.69999999
1220,,A,Republican Period,7,-100,-30,70,0.60000002
1220,,A,Early Imperial Period,8,-30,100,130,0.60000002
1220,,A,Mid-Imperial Period,9,100,300,200,0.60000002
1220,,A,Late Imperial Period,10,300,500,200,0.60000002
1221,Casabianca,A,Early Imperial Period,8,-30,100,130,0.5
1221,Casabianca,A,Mid-Imperial Period,9,100,300,200,0.5
1221,Casabianca,A,Late Imperial Period,10,300,500,200,0.5
1222,,A,Early Imperial Period,8,-30,100,130,0.5
1222,,A,Mid-Imperial Period,9,100,300,200,0.5
1222,,A,Late Imperial Period,10,300,500,200,0.5
1223,,A,Mid-Imperial Period,9,100,300,200,0.30000001
1223,,A,Late Imperial Period,10,300,500,200,0.30000001
1224,Marcandreola,A,Republican Period,7,-100,-30,70,0.40000001
1224,Marcandreola,A,Early Imperial Period,8,-30,100,130,0.40000001
1224,Marcandreola,A,Mid-Imperial Period,9,100,200,100,0.40000001
1225,Il Casale dei Francesi,A,Early Imperial Period,8,-30,100,130,0.30000001
1225,Il Casale dei Francesi,A,Mid-Imperial Period,9,100,300,200,0.30000001
1225,Il Casale dei Francesi,A,Late Imperial Period,10,300,500,200,0.30000001
1226,,A,Early Imperial Period,8,-30,100,130,0.60000002
1226,,A,Mid-Imperial Period,9,100,300,200,0.60000002
1226,,A,Late Imperial Period,10,300,500,200,0.60000002
1227,Villa di Voconio Pollione,A,Republican Period,7,-100,-30,70,1.5
1227,Villa di Voconio Pollione,A,Early Imperial Period,8,-30,100,130,1.5
1227,Villa di Voconio Pollione,A,Mid-Imperial Period,9,100,300,200,1.5
1227,Villa di Voconio Pollione,A,Late Imperial Period,10,300,450,150,1.5
1228,,A,Republican Period,7,-100,-30,70,1.7
1228,,A,Early Imperial Period,8,-30,100,130,1.7
1228,,A,Mid-Imperial Period,9,100,300,200,1.7
1228,,A,Late Imperial Period,10,300,500,200,1.7
1229,,A,Republican Period,7,-200,-30,170,0.5
1230,Berretta da Prete,A,Republican Period,7,-100,-30,70,0.69999999
1230,Berretta da Prete,A,Early Imperial Period,8,-30,100,130,0.69999999
1230,Berretta da Prete,A,Mid-Imperial Period,9,100,300,200,0.69999999
1230,Berretta da Prete,A,Late Imperial Period,10,300,400,100,0.69999999
1231,,A,Republican Period,7,-100,-30,70,0.5
1231,,A,Early Imperial Period,8,-30,100,130,0.5
1231,,A,Mid-Imperial Period,9,100,300,200,0.5
1231,,A,Late Imperial Period,10,300,500,200,0.5
1232,Ghiaccioforte,A,Late Iron Age,5,-700,-580,120,8
1232,Ghiaccioforte,A,Archaic Period,6,-580,-350,230,8
1232,Ghiaccioforte,A,Republican Period,7,-350,-300,50,8
1232,Casale di Fiorano,B,Mid-Imperial Period,9,100,300,200,0.89999998
1232,Casale di Fiorano,B,Late Imperial Period,10,300,500,200,0.89999998
1233,,A,Republican Period,7,-50,-30,20,0.2
1233,,A,Early Imperial Period,8,-30,100,130,0.2
1233,,A,Mid-Imperial Period,9,100,300,200,0.40000001
1233,,A,Late Imperial Period,10,300,500,200,0.40000001
1234,,A,Republican Period,7,-200,-30,170,0.2
1234,,A,Early Imperial Period,8,-30,100,130,0.2
1234,,A,Mid-Imperial Period,9,100,300,200,0.2
1234,,A,Late Imperial Period,10,300,500,200,0.2
1235,Casale di Palombaro,A,Republican Period,7,-200,-30,170,1
1235,Casale di Palombaro,A,Early Imperial Period,8,-30,100,130,1
1235,Casale di Palombaro,A,Mid-Imperial Period,9,100,300,200,1
1235,Casale di Palombaro,A,Late Imperial Period,10,300,500,200,1
1236,,A,Republican Period,7,-200,-30,170,0.40000001
1236,,A,Early Imperial Period,8,-30,100,130,0.40000001
1236,,A,Mid-Imperial Period,9,100,300,200,0.40000001
1236,,A,Late Imperial Period,10,300,500,200,0.40000001
1237,,A,Republican Period,7,-300,-30,270,0.60000002
1237,,A,Early Imperial Period,8,-30,100,130,0.60000002
1237,,A,Mid-Imperial Period,9,100,300,200,0.60000002
1237,,A,Late Imperial Period,10,300,500,200,0.60000002
1238,,A,Republican Period,7,-200,-30,170,0.5
1238,,A,Early Imperial Period,8,-30,100,130,0.5
1238,,A,Mid-Imperial Period,9,100,300,200,0.5
1238,,A,Late Imperial Period,10,300,500,200,0.5
1239,,A,Republican Period,7,-200,-30,170,1.5
1239,,A,Early Imperial Period,8,-30,100,130,1.5
1239,,A,Mid-Imperial Period,9,100,300,200,1.5
1239,,A,Late Imperial Period,10,300,500,200,1.5
1240,,A,Republican Period,7,-200,-30,170,0.40000001
1240,,A,Early Imperial Period,8,-30,100,130,0.40000001
1240,,A,Mid-Imperial Period,9,100,300,200,0.40000001
1240,,A,Late Imperial Period,10,300,500,200,0.40000001
1241,,A,Republican Period,7,-200,-30,170,1
1241,,A,Early Imperial Period,8,-30,100,130,1
1242,Quarto Coste Rotonde,A,Republican Period,7,-100,-30,70,0.5
1243,Casale di Licia,A,Early Iron Age,4,-1000,-750,250,1.5
1243,Casale di Licia,A,Late Iron Age,5,-750,-580,170,1.5
1243,Casale di Licia,A,Archaic Period,6,-580,-500,80,1.5
1244,Castagnola,A,Republican Period,7,-100,-30,70,0.60000002
1244,Castagnola,A,Early Imperial Period,8,-30,100,130,0.60000002
1244,Castagnola,A,Mid-Imperial Period,9,100,300,200,0.60000002
1244,Castagnola,A,Late Imperial Period,10,300,500,200,0.60000002
1245,Bovillae,A,Archaic Period,6,-500,-350,150,37
1245,Bovillae,A,Republican Period,7,-350,-30,320,37
1245,Bovillae,A,Early Imperial Period,8,-30,100,130,50
1245,Bovillae,A,Mid-Imperial Period,9,100,300,200,50
1245,Bovillae,A,Late Imperial Period,10,300,500,200,50
1246,,A,Early Imperial Period,8,-30,100,130,0.5
1246,,A,Mid-Imperial Period,9,100,300,200,0.5
1246,,A,Late Imperial Period,10,300,500,200,0.5
1247,,A,Early Imperial Period,8,-30,100,130,0.5
1247,,A,Mid-Imperial Period,9,100,300,200,0.5
1247,,A,Late Imperial Period,10,300,500,200,0.5
1248,Vigna Spinabella,A,Early Imperial Period,8,-30,100,130,1.5
1248,Vigna Spinabella,A,Mid-Imperial Period,9,100,300,200,1.5
1248,Vigna Spinabella,A,Late Imperial Period,10,300,500,200,1.5
1249,,A,Early Imperial Period,8,-30,100,130,0.5
1249,,A,Mid-Imperial Period,9,100,300,200,0.5
1249,,A,Late Imperial Period,10,300,500,200,0.5
1250,,A,Early Imperial Period,8,-30,100,130,1
1250,,A,Mid-Imperial Period,9,100,300,200,1
1250,,A,Late Imperial Period,10,300,500,200,1
1251,,A,Early Imperial Period,8,-30,100,130,1
1251,,A,Mid-Imperial Period,9,100,300,200,1
1251,,A,Late Imperial Period,10,300,500,200,1
1252,,A,Early Imperial Period,8,-30,100,130,0.80000001
1252,,A,Mid-Imperial Period,9,100,300,200,0.80000001
1252,,A,Late Imperial Period,10,300,500,200,0.80000001
1253,,A,Late Iron Age,5,-600,-580,20,0.69999999
1253,,A,Archaic Period,6,-580,-350,230,0.69999999
1253,,A,Republican Period,7,-350,-30,320,0.69999999
1253,,A,Early Imperial Period,8,-30,100,130,0.69999999
1253,,A,Mid-Imperial Period,9,100,300,200,0.69999999
1253,,A,Late Imperial Period,10,300,500,200,0.69999999
1254,Mugilla (?),A,Late Iron Age,5,-600,-580,20,3.5
1254,Mugilla (?),A,Archaic Period,6,-580,-500,80,3.5
1255,,A,Early Imperial Period,8,-30,100,130,0.40000001
1255,,A,Mid-Imperial Period,9,100,300,200,0.40000001
1255,,A,Late Imperial Period,10,300,500,200,0.40000001
1256,,A,Early Imperial Period,8,-30,100,130,1
1256,,A,Mid-Imperial Period,9,100,300,200,1
1256,,A,Late Imperial Period,10,300,500,200,1
1257,,A,Early Imperial Period,8,-30,100,130,0.60000002
1257,,A,Mid-Imperial Period,9,100,300,200,0.60000002
1257,,A,Late Imperial Period,10,300,500,200,0.60000002
1258,,A,Republican Period,7,-300,-30,270,0.80000001
1258,,A,Early Imperial Period,8,-30,100,130,0.80000001
1258,,A,Mid-Imperial Period,9,100,300,200,0.80000001
1259,,A,Early Imperial Period,8,-30,100,130,0.69999999
1259,,A,Mid-Imperial Period,9,100,300,200,0.69999999
1259,,A,Late Imperial Period,10,300,500,200,0.69999999
1260,,A,Republican Period,7,-300,-30,270,0.69999999
1260,,A,Early Imperial Period,8,-30,100,130,0.69999999
1260,,A,Mid-Imperial Period,9,100,300,200,0.69999999
1260,,A,Late Imperial Period,10,300,500,200,0.69999999
1261,,A,Republican Period,7,-100,-30,70,1
1261,,A,Early Imperial Period,8,-30,100,130,1
1261,,A,Mid-Imperial Period,9,100,300,200,1
1261,,A,Late Imperial Period,10,300,500,200,1
1262,,A,Republican Period,7,-100,-30,70,0.5
1262,,A,Early Imperial Period,8,-30,100,130,0.5
1262,,A,Mid-Imperial Period,9,100,300,200,0.5
1262,,A,Late Imperial Period,10,300,500,200,0.5
1263,,A,Republican Period,7,-300,-30,270,0.60000002
1263,,A,Early Imperial Period,8,-30,100,130,0.60000002
1263,,A,Mid-Imperial Period,9,100,300,200,0.60000002
1263,,A,Late Imperial Period,10,300,500,200,0.60000002
1264,,A,Republican Period,7,-300,-30,270,0.5
1264,,A,Early Imperial Period,8,-30,100,130,0.5
1264,,A,Mid-Imperial Period,9,100,300,200,0.5
1264,,A,Late Imperial Period,10,300,500,200,0.5
1265,Colle Oliva,A,Republican Period,7,-100,-30,70,1.2
1265,Colle Oliva,A,Early Imperial Period,8,-30,100,130,1.2
1265,Colle Oliva,A,Mid-Imperial Period,9,100,300,200,1.2
1265,Colle Oliva,A,Late Imperial Period,10,300,500,200,1.2
1266,,A,Early Imperial Period,8,-30,100,130,0.5
1266,,A,Mid-Imperial Period,9,100,300,200,0.5
1266,,A,Late Imperial Period,10,300,500,200,0.5
1267,,A,Republican Period,7,-100,-30,70,1.5
1267,,A,Early Imperial Period,8,-30,100,130,1.5
1267,,A,Mid-Imperial Period,9,100,300,200,1.5
1267,,A,Late Imperial Period,10,300,500,200,1.5
1268,,A,Early Imperial Period,8,-30,100,130,0.5
1268,,A,Mid-Imperial Period,9,100,300,200,0.5
1268,,A,Late Imperial Period,10,300,500,200,0.5
1269,,A,Republican Period,7,-100,-30,70,0.5
1270,Fontanile dei Monaci,A,Republican Period,7,-100,-30,70,0.69999999
1270,Fontanile dei Monaci,A,Early Imperial Period,8,-30,100,130,0.69999999
1270,Fontanile dei Monaci,A,Mid-Imperial Period,9,100,300,200,0.69999999
1270,Fontanile dei Monaci,A,Late Imperial Period,10,300,500,200,0.69999999
1271,,A,Early Imperial Period,8,-30,100,130,0.69999999
1271,,A,Mid-Imperial Period,9,100,300,200,0.69999999
1271,,A,Late Imperial Period,10,300,500,200,0.69999999
1272,,A,Early Imperial Period,8,-30,100,130,0.5
1272,,A,Mid-Imperial Period,9,100,300,200,0.5
1272,,A,Late Imperial Period,10,300,500,200,0.5
1273,Messer Paoli,A,Early Imperial Period,8,-30,100,130,3.5
1273,Messer Paoli,A,Mid-Imperial Period,9,100,300,200,3.5
1273,Messer Paoli,A,Late Imperial Period,10,300,500,200,3.5
1274,Casale Castruccio,A,Republican Period,7,-100,-30,70,0.89999998
1274,Casale Castruccio,A,Early Imperial Period,8,-30,100,130,0.89999998
1274,Casale Castruccio,A,Mid-Imperial Period,9,100,300,200,0.89999998
1274,Casale Castruccio,A,Late Imperial Period,10,300,500,200,0.89999998
1275,,A,Early Imperial Period,8,-30,100,130,0.5
1275,,A,Mid-Imperial Period,9,100,300,200,0.5
1275,,A,Late Imperial Period,10,300,500,200,0.5
1276,,A,Republican Period,7,-300,-50,250,0.2
1277,,A,Republican Period,7,-50,-30,20,1
1277,,A,Early Imperial Period,8,-30,100,130,1
1277,,A,Mid-Imperial Period,9,100,300,200,1
1278,,A,Republican Period,7,-200,-30,170,0.1
1278,,A,Early Imperial Period,8,-30,-20,10,0.1
1279,,A,Republican Period,7,-200,-50,150,0.1
1280,,A,Archaic Period,6,-400,-350,50,0.2
1280,,A,Republican Period,7,-350,-300,50,0.2
1281,,A,Republican Period,7,-300,-50,250,0.2
1282,,A,Republican Period,7,-200,-30,170,0.2
1282,,A,Early Imperial Period,8,-30,100,130,0.2
1283,,A,Archaic Period,6,-500,-350,150,0.2
1283,,A,Republican Period,7,-350,-300,50,0.2
1284,,A,Republican Period,7,-300,-50,250,0.1
1285,,A,Republican Period,7,-200,-30,170,0.1
1285,,A,Early Imperial Period,8,-30,100,130,0.1
1286,,A,Republican Period,7,-200,-30,170,0.5
1287,,A,Late Iron Age,5,-700,-580,120,1
1287,,A,Archaic Period,6,-580,-350,230,1
1287,,A,Republican Period,7,-350,-30,320,1
1287,,A,Early Imperial Period,8,-30,100,130,1
1288,,A,Late Iron Age,5,-700,-580,120,0.1
1288,,A,Archaic Period,6,-580,-350,230,0.1
1288,,A,Republican Period,7,-350,-300,50,0.1
1289,,A,Republican Period,7,-200,-30,170,1.5
1289,,A,Early Imperial Period,8,-30,100,130,1.5
1289,,A,Mid-Imperial Period,9,100,200,100,1.5
1290,,A,Archaic Period,6,-400,-350,50,0.1
1290,,A,Republican Period,7,-350,-300,50,0.1
1291,,A,Republican Period,7,-50,-30,20,0.1
1291,,A,Early Imperial Period,8,-30,100,130,0.1
1292,,A,Republican Period,7,-200,-30,170,0.1
1292,,A,Early Imperial Period,8,-30,100,130,0.1
1293,,A,Republican Period,7,-200,-50,150,0.1
1294,,A,Republican Period,7,-50,-30,20,1
1294,,A,Early Imperial Period,8,-30,100,130,1
1294,,A,Mid-Imperial Period,9,100,300,200,1
1294,,A,Late Imperial Period,10,300,500,200,1
1295,,A,Late Iron Age,5,-700,-580,120,2
1295,,A,Archaic Period,6,-580,-500,80,2
1295,,B,Republican Period,7,-300,-30,270,1.5
1295,,B,Early Imperial Period,8,-30,100,130,2.5
1295,,B,Mid-Imperial Period,9,100,200,100,2.5
1296,,A,Late Iron Age,5,-700,-580,120,0.80000001
1296,,A,Archaic Period,6,-580,-350,230,0.80000001
1296,,A,Republican Period,7,-350,-300,50,0.80000001
1297,,A,Late Iron Age,5,-700,-580,120,0.1
1297,,A,Archaic Period,6,-580,-350,230,0.1
1297,,B,Republican Period,7,-350,-50,300,0.2
1298,,A,Archaic Period,6,-500,-350,150,1
1298,,A,Republican Period,7,-350,-30,320,1
1298,,A,Early Imperial Period,8,-30,100,130,1
1298,,A,Mid-Imperial Period,9,100,300,200,1
1298,,A,Late Imperial Period,10,300,500,200,1
1299,,A,Late Iron Age,5,-700,-580,120,1
1299,,A,Archaic Period,6,-580,-350,230,1
1299,,A,Republican Period,7,-350,-300,50,1
1300,,A,Republican Period,7,-200,-30,170,1
1300,,A,Early Imperial Period,8,-30,100,130,1
1300,,A,Mid-Imperial Period,9,100,200,100,1
1301,,A,Archaic Period,6,-500,-350,150,0.1
1301,,A,Republican Period,7,-350,-300,50,0.1
1302,,A,Archaic Period,6,-500,-350,150,0.1
1302,,A,Republican Period,7,-350,-300,50,0.1
1303,,A,Republican Period,7,-200,-30,170,0.30000001
1303,,A,Early Imperial Period,8,-30,100,130,0.30000001
1304,,A,Archaic Period,6,-400,-350,50,0.1
1304,,A,Republican Period,7,-350,-300,50,0.1
1305,,A,Archaic Period,6,-400,-350,50,0.1
1305,,A,Republican Period,7,-350,-200,150,0.1
1306,,A,Republican Period,7,-200,-30,170,0.80000001
1306,,A,Early Imperial Period,8,-30,100,130,0.80000001
1306,,A,Mid-Imperial Period,9,100,300,200,0.80000001
1306,,A,Late Imperial Period,10,300,500,200,0.80000001
1307,,A,Republican Period,7,-200,-30,170,0.1
1307,,A,Early Imperial Period,8,-30,100,130,0.1
1308,,A,Republican Period,7,-200,-30,170,0.1
1308,,A,Early Imperial Period,8,-30,100,130,0.1
1308,,A,Mid-Imperial Period,9,100,200,100,0.1
1309,,A,Republican Period,7,-200,-30,170,2.5
1309,,A,Early Imperial Period,8,-30,100,130,2.5
1309,,A,Mid-Imperial Period,9,100,300,200,2.5
1309,,A,Late Imperial Period,10,300,500,200,2.5
1310,,A,Republican Period,7,-300,-30,270,0.69999999
1310,,A,Early Imperial Period,8,-30,100,130,0.69999999
1310,,A,Mid-Imperial Period,9,100,200,100,0.69999999
1311,,A,Republican Period,7,-200,-30,170,0.80000001
1311,,A,Early Imperial Period,8,-30,100,130,0.80000001
1312,,A,Late Iron Age,5,-700,-580,120,0.1
1312,,A,Archaic Period,6,-580,-500,80,0.1
1313,,A,Republican Period,7,-200,-30,170,0.1
1313,,A,Early Imperial Period,8,-30,100,130,0.1
1314,,A,Republican Period,7,-200,-30,170,0.5
1314,,A,Early Imperial Period,8,-30,100,130,0.5
1314,,A,Mid-Imperial Period,9,100,300,200,0.5
1314,,A,Late Imperial Period,10,300,500,200,0.5
1315,,A,Republican Period,7,-200,-30,170,0.30000001
1315,,A,Early Imperial Period,8,-30,100,130,0.30000001
1315,,A,Mid-Imperial Period,9,100,300,200,0.30000001
1316,,A,Republican Period,7,-200,-30,170,0.30000001
1316,,A,Early Imperial Period,8,-30,100,130,0.30000001
1317,,A,Mid-Imperial Period,9,200,300,100,4
1317,,A,Late Imperial Period,10,300,400,100,4
1318,,A,Republican Period,7,-200,-30,170,2.5
1318,,A,Early Imperial Period,8,-30,100,130,2.5
1318,,A,Mid-Imperial Period,9,100,300,200,2.5
1318,,A,Late Imperial Period,10,300,500,200,2.5
1319,,A,Republican Period,7,-200,-30,170,0.30000001
1320,,A,Republican Period,7,-200,-30,170,0.2
1320,,A,Early Imperial Period,8,-30,100,130,0.2
1320,,A,Mid-Imperial Period,9,100,200,100,0.2
1321,,A,Republican Period,7,-200,-30,170,4
1321,,A,Early Imperial Period,8,-30,100,130,4
1321,,A,Mid-Imperial Period,9,100,200,100,4
1322,,A,Republican Period,7,-50,-30,20,1.5
1322,,A,Early Imperial Period,8,-30,100,130,1.5
1323,,A,Archaic Period,6,-500,-350,150,0.30000001
1323,,A,Republican Period,7,-350,-300,50,0.30000001
1324,,A,Republican Period,7,-300,-30,270,1
1324,,A,Early Imperial Period,8,-30,100,130,1
1324,,A,Mid-Imperial Period,9,100,200,100,1
1325,,A,Republican Period,7,-300,-30,270,0.1
1326,,A,Republican Period,7,-50,-30,20,0.1
1326,,A,Early Imperial Period,8,-30,100,130,0.1
1326,,A,Mid-Imperial Period,9,100,200,100,0.1
1327,,A,Late Iron Age,5,-700,-580,120,0.1
1327,,A,Archaic Period,6,-580,-350,230,0.1
1327,,A,Republican Period,7,-350,-300,50,0.1
1328,,A,Late Iron Age,5,-700,-580,120,0.1
1328,,A,Archaic Period,6,-580,-350,230,0.1
1328,,A,Republican Period,7,-350,-300,50,0.1
1329,,A,Republican Period,7,-300,-50,250,0.30000001
1330,,A,Republican Period,7,-50,-30,20,1
1330,,A,Early Imperial Period,8,-30,100,130,1
1330,,A,Mid-Imperial Period,9,100,300,200,1
1330,,A,Late Imperial Period,10,300,500,200,1
1331,,A,Late Iron Age,5,-700,-580,120,0.1
1331,,A,Archaic Period,6,-580,-350,230,0.1
1331,,A,Republican Period,7,-350,-300,50,0.1
1332,,A,Early Imperial Period,8,50,100,50,0.1
1332,,A,Mid-Imperial Period,9,100,300,200,0.1
1333,,A,Early Imperial Period,8,50,100,50,0.80000001
1333,,A,Mid-Imperial Period,9,100,300,200,0.80000001
1333,,A,Late Imperial Period,10,300,500,200,0.80000001
1334,,A,Early Imperial Period,8,50,100,50,0.5
1334,,A,Mid-Imperial Period,9,100,300,200,0.5
1334,,A,Late Imperial Period,10,300,500,200,0.5
1335,,A,Republican Period,7,-200,-30,170,0.2
1335,,A,Early Imperial Period,8,-30,100,130,0.2
1335,,A,Mid-Imperial Period,9,100,200,100,0.2
1336,,A,Republican Period,7,-200,-30,170,0.2
1336,,A,Early Imperial Period,8,-30,100,130,0.2
1336,,A,Mid-Imperial Period,9,100,200,100,0.2
1337,,A,Republican Period,7,-200,-30,170,0.2
1337,,A,Early Imperial Period,8,-30,100,130,0.2
1337,,A,Mid-Imperial Period,9,100,300,200,0.2
1338,,A,Republican Period,7,-200,-30,170,1
1338,,A,Early Imperial Period,8,-30,100,130,1
1338,,A,Mid-Imperial Period,9,100,300,200,1
1338,,A,Late Imperial Period,10,300,500,200,1
1339,,A,Republican Period,7,-200,-30,170,0.30000001
1339,,A,Early Imperial Period,8,-30,100,130,0.30000001
1339,,A,Mid-Imperial Period,9,100,200,100,0.30000001
1340,,A,Republican Period,7,-50,-30,20,0.2
1340,,A,Early Imperial Period,8,-30,100,130,0.2
1340,,A,Mid-Imperial Period,9,100,300,200,0.2
1340,,A,Late Imperial Period,10,300,400,100,0.2
1341,,A,Republican Period,7,-200,-30,170,0.40000001
1341,,A,Early Imperial Period,8,-30,100,130,0.40000001
1341,,A,Mid-Imperial Period,9,100,200,100,0.40000001
1342,,A,Republican Period,7,-200,-30,170,0.40000001
1342,,A,Early Imperial Period,8,-30,100,130,0.40000001
1342,,A,Mid-Imperial Period,9,100,300,200,0.40000001
1342,,A,Late Imperial Period,10,300,500,200,0.40000001
1343,,A,Republican Period,7,-200,-30,170,0.2
1343,,A,Early Imperial Period,8,-30,100,130,0.2
1343,,A,Mid-Imperial Period,9,100,300,200,0.2
1343,,A,Late Imperial Period,10,300,400,100,0.2
1344,,A,Republican Period,7,-200,-50,150,0.2
1345,,A,Republican Period,7,-200,-30,170,0.40000001
1345,,A,Early Imperial Period,8,-30,100,130,0.40000001
1345,,A,Mid-Imperial Period,9,100,300,200,0.40000001
1345,,A,Late Imperial Period,10,300,400,100,0.40000001
1346,,A,Republican Period,7,-300,-30,270,0.1
1346,,A,Early Imperial Period,8,-30,100,130,0.1
1346,,A,Mid-Imperial Period,9,100,300,200,0.1
1346,,A,Late Imperial Period,10,300,400,100,0.1
1347,,A,Republican Period,7,-200,-30,170,0.2
1347,,A,Early Imperial Period,8,-30,100,130,0.2
1347,,A,Mid-Imperial Period,9,100,200,100,0.2
1348,,A,Republican Period,7,-200,-30,170,0.2
1348,,A,Early Imperial Period,8,-30,100,130,0.2
1349,,A,Republican Period,7,-200,-30,170,1
1349,,A,Early Imperial Period,8,-30,100,130,1
1349,,A,Mid-Imperial Period,9,100,200,100,1
1350,,A,Republican Period,7,-200,-30,170,0.5
1350,,A,Early Imperial Period,8,-30,100,130,0.5
1350,,A,Mid-Imperial Period,9,100,200,100,0.5
1351,,A,Republican Period,7,-200,-30,170,0.80000001
1351,,A,Early Imperial Period,8,-30,100,130,0.80000001
1352,,A,Republican Period,7,-50,-30,20,0.30000001
1352,,A,Early Imperial Period,8,-30,100,130,0.30000001
1352,,A,Mid-Imperial Period,9,100,200,100,0.30000001
1353,,A,Republican Period,7,-200,-30,170,0.30000001
1353,,A,Early Imperial Period,8,-30,100,130,0.30000001
1353,,A,Mid-Imperial Period,9,100,200,100,0.30000001
1354,,A,Republican Period,7,-200,-30,170,0.40000001
1354,,A,Early Imperial Period,8,-30,100,130,0.40000001
1355,,A,Republican Period,7,-200,-30,170,0.80000001
1355,,A,Early Imperial Period,8,-30,100,130,0.80000001
1356,,A,Republican Period,7,-200,-30,170,0.60000002
1357,,A,Republican Period,7,-200,-30,170,0.80000001
1357,,A,Early Imperial Period,8,-30,100,130,0.80000001
1357,,A,Mid-Imperial Period,9,100,300,200,0.80000001
1357,,A,Late Imperial Period,10,300,400,100,0.80000001
1358,,A,Republican Period,7,-300,-30,270,1
1358,,A,Early Imperial Period,8,-30,100,130,1
1358,,A,Mid-Imperial Period,9,100,300,200,1
1359,,A,Republican Period,7,-200,-30,170,2
1359,,A,Early Imperial Period,8,-30,100,130,2
1359,,A,Mid-Imperial Period,9,100,200,100,2
1360,,A,Republican Period,7,-200,-50,150,0.1
1361,,A,Republican Period,7,-50,-30,20,0.2
1361,,A,Early Imperial Period,8,-30,100,130,0.2
1362,,A,Late Iron Age,5,-700,-580,120,0.30000001
1362,,A,Archaic Period,6,-580,-500,80,0.30000001
1363,,A,Late Iron Age,5,-700,-580,120,0.2
1363,,A,Archaic Period,6,-580,-350,230,0.2
1363,,A,Republican Period,7,-350,-300,50,0.2
1364,,A,Republican Period,7,-200,-50,150,0.69999999
1365,,A,Republican Period,7,-50,-30,20,2
1365,,A,Early Imperial Period,8,-30,100,130,2
1366,,A,Republican Period,7,-200,-30,170,0.5
1366,,A,Early Imperial Period,8,-30,100,130,0.5
1366,,A,Mid-Imperial Period,9,100,200,100,0.5
1367,,A,Republican Period,7,-200,-30,170,1
1367,,A,Early Imperial Period,8,-30,100,130,1
1367,,A,Mid-Imperial Period,9,100,200,100,1
1368,Saturnia,A,Archaic Period,6,-500,-350,150,24
1368,Saturnia,B,Republican Period,7,-350,-30,320,24
1368,Saturnia,B,Early Imperial Period,8,-30,100,130,24
1368,Saturnia,B,Mid-Imperial Period,9,100,200,100,24
1369,,A,Republican Period,7,-200,-30,170,0.60000002
1369,,A,Early Imperial Period,8,-30,100,130,0.60000002
1369,,A,Mid-Imperial Period,9,100,300,200,0.60000002
1369,,A,Late Imperial Period,10,300,500,200,0.60000002
1370,,A,Republican Period,7,-50,-30,20,1
1370,,A,Early Imperial Period,8,-30,100,130,1
1370,,A,Mid-Imperial Period,9,100,200,100,1
1371,,A,Republican Period,7,-200,-30,170,0.30000001
1371,,A,Early Imperial Period,8,-30,100,130,0.30000001
1371,,A,Mid-Imperial Period,9,100,200,100,0.30000001
1372,,A,Republican Period,7,-200,-30,170,1.5
1372,,A,Early Imperial Period,8,-30,100,130,1.5
1372,,A,Mid-Imperial Period,9,100,300,200,1.5
1373,,A,Late Iron Age,5,-700,-580,120,0.69999999
1373,,A,Archaic Period,6,-580,-350,230,0.69999999
1373,,A,Republican Period,7,-350,-300,50,0.69999999
1374,,A,Republican Period,7,-300,-30,270,0.5
1374,,A,Early Imperial Period,8,-30,100,130,0.5
1374,,A,Mid-Imperial Period,9,100,300,200,0.5
1375,,A,Republican Period,7,-300,-30,270,1.5
1376,,A,Republican Period,7,-200,-30,170,1
1376,,A,Early Imperial Period,8,-30,100,130,1
1377,,A,Republican Period,7,-50,-30,20,1.5
1377,,A,Early Imperial Period,8,-30,100,130,1.5
1377,,A,Mid-Imperial Period,9,100,200,100,1.5
1378,,A,Republican Period,7,-200,-30,170,1.5
1378,,A,Early Imperial Period,8,-30,100,130,1.5
1378,,A,Mid-Imperial Period,9,100,200,100,1.5
1379,,A,Republican Period,7,-300,-30,270,0.40000001
1379,,A,Early Imperial Period,8,-30,100,130,0.40000001
1379,,A,Mid-Imperial Period,9,100,300,200,0.40000001
1380,,A,Late Iron Age,5,-700,-580,120,1.5
1380,,A,Archaic Period,6,-580,-350,230,1.5
1380,,A,Republican Period,7,-350,-200,150,1.5
1381,,A,Republican Period,7,-200,-30,170,0.40000001
1381,,A,Early Imperial Period,8,-30,100,130,0.40000001
1381,,A,Mid-Imperial Period,9,100,300,200,0.40000001
1381,,A,Late Imperial Period,10,300,500,200,0.40000001
1382,,A,Late Iron Age,5,-700,-580,120,0.5
1382,,A,Archaic Period,6,-580,-400,180,0.5
1382,,B,Republican Period,7,-200,-30,170,0.5
1382,,B,Early Imperial Period,8,-30,100,130,0.5
1382,,B,Mid-Imperial Period,9,100,300,200,0.5
1383,,A,Late Iron Age,5,-700,-580,120,1
1383,,A,Archaic Period,6,-580,-350,230,1
1383,,A,Republican Period,7,-350,-300,50,1
1384,,A,Republican Period,7,-200,-30,170,0.40000001
1384,,A,Early Imperial Period,8,-30,100,130,0.40000001
1384,,A,Mid-Imperial Period,9,100,200,100,0.40000001
1385,,A,Republican Period,7,-200,-30,170,0.5
1385,,A,Early Imperial Period,8,-30,100,130,0.5
1386,,A,Republican Period,7,-300,-30,270,0.30000001
1386,,A,Early Imperial Period,8,-30,100,130,0.30000001
1386,,A,Mid-Imperial Period,9,100,300,200,0.30000001
1386,,A,Late Imperial Period,10,300,500,200,0.30000001
1387,,A,Late Iron Age,5,-700,-580,120,0.30000001
1387,,A,Archaic Period,6,-580,-400,180,0.30000001
1388,,A,Late Iron Age,5,-700,-580,120,0.40000001
1388,,A,Archaic Period,6,-580,-500,80,0.40000001
1388,,B,Republican Period,7,-200,-50,150,0.40000001
1389,,A,Archaic Period,6,-500,-350,150,0.40000001
1389,,A,Republican Period,7,-350,-30,320,0.40000001
1389,,A,Early Imperial Period,8,-30,100,130,0.40000001
1390,,A,Archaic Period,6,-500,-350,150,0.40000001
1390,,A,Republican Period,7,-350,-30,320,0.40000001
1390,,A,Early Imperial Period,8,-30,100,130,0.40000001
1391,,A,Republican Period,7,-300,-30,270,2
1391,,A,Early Imperial Period,8,-30,100,130,2
1391,,A,Mid-Imperial Period,9,100,200,100,2
1392,,A,Republican Period,7,-300,-30,270,0.30000001
1392,,A,Early Imperial Period,8,-30,100,130,0.30000001
1393,,A,Late Iron Age,5,-700,-580,120,0.80000001
1393,,A,Archaic Period,6,-580,-400,180,0.80000001
1394,,A,Republican Period,7,-50,-30,20,0.5
1394,,A,Early Imperial Period,8,-30,100,130,0.5
1395,,A,Republican Period,7,-200,-30,170,1.5
1396,,A,Republican Period,7,-300,-50,250,0.69999999
1397,,A,Republican Period,7,-200,-30,170,0.30000001
1397,,A,Early Imperial Period,8,-30,100,130,0.30000001
1397,,A,Mid-Imperial Period,9,100,200,100,0.30000001
1398,,A,Republican Period,7,-300,-50,250,1
1399,,A,Republican Period,7,-50,-30,20,2
1399,,A,Early Imperial Period,8,-30,100,130,2
1399,,A,Mid-Imperial Period,9,100,300,200,2
1400,,A,Republican Period,7,-50,-30,20,2
1400,,A,Early Imperial Period,8,-30,100,130,2
1400,,A,Mid-Imperial Period,9,100,200,100,2
1401,,A,Republican Period,7,-200,-30,170,0.60000002
1401,,A,Early Imperial Period,8,-30,100,130,0.60000002
1401,,A,Mid-Imperial Period,9,100,200,100,0.60000002
1402,,A,Republican Period,7,-200,-30,170,1
1402,,A,Early Imperial Period,8,-30,100,130,1
1402,,A,Mid-Imperial Period,9,100,300,200,1
1402,,A,Late Imperial Period,10,300,500,200,1
1403,,A,Republican Period,7,-50,-30,20,1
1403,,A,Early Imperial Period,8,-30,100,130,1
1403,,A,Mid-Imperial Period,9,100,300,200,1
1403,,A,Late Imperial Period,10,300,500,200,1
1404,,A,Republican Period,7,-300,-30,270,1
1404,,A,Early Imperial Period,8,-30,100,130,1
1405,,A,Republican Period,7,-50,-30,20,1.3
1405,,A,Early Imperial Period,8,-30,100,130,1.3
1405,,A,Mid-Imperial Period,9,100,300,200,1.3
1405,,A,Late Imperial Period,10,300,500,200,1.3
1406,,A,Republican Period,7,-200,-30,170,0.30000001
1406,,A,Early Imperial Period,8,-30,100,130,0.30000001
1407,,A,Late Iron Age,5,-700,-580,120,0.2
1407,,A,Archaic Period,6,-580,-500,80,0.2
1408,,A,Republican Period,7,-50,-30,20,1.5
1408,,A,Early Imperial Period,8,-30,100,130,1.5
1408,,A,Mid-Imperial Period,9,100,200,100,1.5
1409,,A,Late Iron Age,5,-700,-580,120,0.30000001
1409,,A,Archaic Period,6,-580,-350,230,0.30000001
1409,,A,Republican Period,7,-350,-200,150,0.30000001
1410,,A,Archaic Period,6,-400,-350,50,0.30000001
1410,,A,Republican Period,7,-350,-300,50,0.30000001
1411,,A,Republican Period,7,-200,-30,170,0.30000001
1411,,A,Early Imperial Period,8,-30,100,130,0.30000001
1411,,A,Mid-Imperial Period,9,100,300,200,0.30000001
1412,,A,Republican Period,7,-50,-30,20,2
1412,,A,Early Imperial Period,8,-30,100,130,2
1412,,A,Mid-Imperial Period,9,100,200,100,2
1413,,A,Republican Period,7,-300,-30,270,0.40000001
1413,,A,Early Imperial Period,8,-30,100,130,0.40000001
1413,,A,Mid-Imperial Period,9,100,300,200,0.40000001
1413,,A,Late Imperial Period,10,300,500,200,0.40000001
1414,,A,Republican Period,7,-300,-30,270,0.40000001
1414,,A,Early Imperial Period,8,-30,100,130,0.40000001
1414,,A,Mid-Imperial Period,9,100,300,200,0.40000001
1414,,A,Late Imperial Period,10,300,500,200,0.40000001
1415,,A,Republican Period,7,-300,-30,270,0.69999999
1415,,A,Early Imperial Period,8,-30,100,130,0.69999999
1415,,A,Mid-Imperial Period,9,100,300,200,0.69999999
1415,,A,Late Imperial Period,10,300,500,200,0.69999999
1416,,A,Republican Period,7,-300,-30,270,0.5
1416,,A,Early Imperial Period,8,-30,100,130,0.5
1416,,A,Mid-Imperial Period,9,100,300,200,0.5
1416,,A,Late Imperial Period,10,300,500,200,0.5
1417,,A,Mid-Imperial Period,9,250,300,50,0.5
1417,,A,Late Imperial Period,10,300,400,100,0.5
1418,,A,Mid-Imperial Period,9,150,300,150,0.80000001
1419,,A,Republican Period,7,-300,-30,270,0.5
1419,,A,Early Imperial Period,8,-30,100,130,0.5
1419,,A,Mid-Imperial Period,9,100,300,200,0.5
1419,,A,Late Imperial Period,10,300,500,200,0.5
1420,,A,Mid-Imperial Period,9,100,200,100,0.60000002
1421,,A,Mid-Imperial Period,9,100,200,100,0.5
1422,,A,Republican Period,7,-300,-30,270,0.30000001
1422,,A,Early Imperial Period,8,-30,100,130,0.30000001
1422,,A,Mid-Imperial Period,9,100,300,200,0.30000001
1422,,A,Late Imperial Period,10,300,500,200,0.30000001
1423,,A,Republican Period,7,-300,-30,270,0.40000001
1423,,A,Early Imperial Period,8,-30,100,130,0.40000001
1423,,A,Mid-Imperial Period,9,100,300,200,0.40000001
1423,,A,Late Imperial Period,10,300,500,200,0.40000001
1424,,A,Mid-Imperial Period,9,100,300,200,0.40000001
1425,La Giostra,A,Republican Period,7,-325,-250,75,2.5
1426,,A,Mid-Imperial Period,9,100,200,100,0.5
1427,,A,Early Imperial Period,8,1,100,99,0.5
1427,,A,Mid-Imperial Period,9,100,300,200,0.5
1428,,A,Early Imperial Period,8,1,100,99,1
1429,,A,Republican Period,7,-300,-30,270,0.5
1429,,A,Early Imperial Period,8,-30,100,130,0.5
1429,,A,Mid-Imperial Period,9,100,300,200,0.5
1429,,A,Late Imperial Period,10,300,500,200,0.5
1430,,A,Republican Period,7,-100,-30,70,0.60000002
1430,,A,Early Imperial Period,8,-30,100,130,0.60000002
1430,,A,Mid-Imperial Period,9,100,300,200,0.60000002
1430,,A,Late Imperial Period,10,300,400,100,0.60000002
1431,,A,Mid-Imperial Period,9,100,300,200,1
1431,,A,Late Imperial Period,10,300,400,100,1
1432,,A,Republican Period,7,-300,-30,270,0.30000001
1432,,A,Early Imperial Period,8,-30,100,130,0.30000001
1432,,A,Mid-Imperial Period,9,100,300,200,0.30000001
1432,,A,Late Imperial Period,10,300,500,200,0.30000001
1433,,A,Mid-Imperial Period,9,100,200,100,0.5
1434,,A,Republican Period,7,-300,-30,270,0.5
1434,,A,Early Imperial Period,8,-30,100,130,0.5
1434,,A,Mid-Imperial Period,9,100,300,200,0.5
1434,,A,Late Imperial Period,10,300,500,200,0.5
1435,,A,Early Imperial Period,8,-30,100,130,0.60000002
1435,,A,Mid-Imperial Period,9,100,300,200,0.60000002
1435,,A,Late Imperial Period,10,300,500,200,0.60000002
1436,,A,Early Imperial Period,8,-30,100,130,0.69999999
1436,,A,Mid-Imperial Period,9,100,300,200,0.69999999
1436,,A,Late Imperial Period,10,300,500,200,0.69999999
1437,,A,Republican Period,7,-300,-30,270,0.5
1437,,A,Early Imperial Period,8,-30,100,130,0.5
1437,,A,Mid-Imperial Period,9,100,300,200,0.5
1437,,A,Late Imperial Period,10,300,500,200,0.5
1438,,A,Republican Period,7,-300,-30,270,0.69999999
1438,,A,Early Imperial Period,8,-30,100,130,0.69999999
1438,,A,Mid-Imperial Period,9,100,300,200,0.69999999
1438,,A,Late Imperial Period,10,300,500,200,0.69999999
1439,,A,Republican Period,7,-300,-30,270,0.5
1439,,A,Early Imperial Period,8,-30,100,130,0.5
1439,,A,Mid-Imperial Period,9,100,300,200,0.5
1439,,A,Late Imperial Period,10,300,500,200,0.5
1440,,A,Republican Period,7,-100,-30,70,0.69999999
1440,,A,Early Imperial Period,8,-30,100,130,0.69999999
1440,,A,Mid-Imperial Period,9,100,300,200,0.69999999
1440,,A,Late Imperial Period,10,300,400,100,0.69999999
1441,,A,Republican Period,7,-300,-30,270,0.69999999
1441,,A,Early Imperial Period,8,-30,100,130,0.69999999
1441,,A,Mid-Imperial Period,9,100,300,200,0.69999999
1441,,A,Late Imperial Period,10,300,500,200,0.69999999
1442,,A,Republican Period,7,-300,-30,270,0.40000001
1443,Cecchignola,A,Early Imperial Period,8,-30,100,130,0.60000002
1443,Cecchignola,A,Mid-Imperial Period,9,100,300,200,0.60000002
1443,Cecchignola,A,Late Imperial Period,10,300,500,200,0.60000002
1444,Cecchignola,A,Republican Period,7,-300,-30,270,0.40000001
1444,Cecchignola,A,Early Imperial Period,8,-30,100,130,0.40000001
1444,Cecchignola,A,Mid-Imperial Period,9,100,300,200,0.40000001
1444,Cecchignola,A,Late Imperial Period,10,300,500,200,0.40000001
1445,Casalle Cecchignoletta,A,Mid-Imperial Period,9,100,300,200,1
1446,Torre Pagnotta,A,Republican Period,7,-100,-30,70,0.40000001
1446,Torre Pagnotta,A,Early Imperial Period,8,-30,100,130,0.40000001
1446,Torre Pagnotta,A,Mid-Imperial Period,9,100,200,100,0.40000001
1447,Tenuta Cecchignola,A,Early Imperial Period,8,1,100,99,0.80000001
1447,Tenuta Cecchignola,A,Mid-Imperial Period,9,100,200,100,0.80000001
1448,Casale Gasperini,A,Early Imperial Period,8,1,100,99,1
1448,Casale Gasperini,A,Mid-Imperial Period,9,100,200,100,1
1449,,A,Republican Period,7,-300,-30,270,0.80000001
1449,,A,Early Imperial Period,8,-30,100,130,0.80000001
1449,,A,Mid-Imperial Period,9,100,300,200,0.80000001
1449,,A,Late Imperial Period,10,300,500,200,0.80000001
1450,Fattoria,A,Republican Period,7,-300,-30,270,0.5
1450,Fattoria,A,Early Imperial Period,8,-30,100,130,0.5
1450,Fattoria,A,Mid-Imperial Period,9,100,300,200,0.5
1450,Fattoria,A,Late Imperial Period,10,300,500,200,0.5
1451,Casale Torre della Castelluccia,A,Republican Period,7,-300,-30,270,0.5
1451,Casale Torre della Castelluccia,A,Early Imperial Period,8,-30,100,130,0.5
1451,Casale Torre della Castelluccia,A,Mid-Imperial Period,9,100,300,200,0.5
1451,Casale Torre della Castelluccia,A,Late Imperial Period,10,300,500,200,0.5
1452,,A,Republican Period,7,-200,-100,100,0.60000002
1453,Tenuta di Valleranello,A,Republican Period,7,-300,-30,270,0.5
1453,Tenuta di Valleranello,A,Early Imperial Period,8,-30,100,130,0.5
1453,Tenuta di Valleranello,A,Mid-Imperial Period,9,100,300,200,0.5
1453,Tenuta di Valleranello,A,Late Imperial Period,10,300,500,200,0.5
1454,,A,Republican Period,7,-300,-30,270,0.5
1454,,A,Early Imperial Period,8,-30,100,130,0.5
1454,,A,Mid-Imperial Period,9,100,300,200,0.5
1454,,A,Late Imperial Period,10,300,500,200,0.5
1455,,A,Mid-Imperial Period,9,100,200,100,0.5
1456,Pizzo di Prete,A,Republican Period,7,-300,-30,270,0.40000001
1456,Pizzo di Prete,A,Early Imperial Period,8,-30,100,130,0.40000001
1456,Pizzo di Prete,A,Mid-Imperial Period,9,100,300,200,0.40000001
1456,Pizzo di Prete,A,Late Imperial Period,10,300,500,200,0.40000001
1457,,A,Republican Period,7,-300,-30,270,0.5
1457,,A,Early Imperial Period,8,-30,100,130,0.5
1457,,A,Mid-Imperial Period,9,100,300,200,0.5
1457,,A,Late Imperial Period,10,300,500,200,0.5
1458,Casale di Perna,A,Republican Period,7,-300,-30,270,0.5
1458,Casale di Perna,A,Early Imperial Period,8,-30,100,130,0.5
1458,Casale di Perna,A,Mid-Imperial Period,9,100,300,200,0.5
1458,Casale di Perna,A,Late Imperial Period,10,300,500,200,0.5
1459,Casale di Perna,A,Republican Period,7,-300,-30,270,0.60000002
1459,Casale di Perna,A,Early Imperial Period,8,-30,100,130,0.60000002
1459,Casale di Perna,A,Mid-Imperial Period,9,100,300,200,0.60000002
1459,Casale di Perna,A,Late Imperial Period,10,300,500,200,0.60000002
1460,Pizzo di Prete,A,Early Imperial Period,8,-30,100,130,0.60000002
1460,Pizzo di Prete,A,Mid-Imperial Period,9,100,300,200,0.60000002
1460,Pizzo di Prete,A,Late Imperial Period,10,300,500,200,0.60000002
1461,,A,Mid-Imperial Period,9,100,200,100,1
1462,,A,Republican Period,7,-300,-30,270,0.60000002
1462,,A,Early Imperial Period,8,-30,100,130,0.60000002
1462,,A,Mid-Imperial Period,9,100,300,200,0.60000002
1462,,A,Late Imperial Period,10,300,500,200,0.60000002
1463,,A,Republican Period,7,-300,-30,270,0.5
1463,,A,Early Imperial Period,8,-30,100,130,0.5
1463,,A,Mid-Imperial Period,9,100,300,200,0.5
1463,,A,Late Imperial Period,10,300,500,200,0.5
1464,Vermicino,A,Republican Period,7,-100,-30,70,0.30000001
1464,Vermicino,A,Early Imperial Period,8,-30,100,130,0.30000001
1464,Vermicino,A,Mid-Imperial Period,9,100,300,200,0.30000001
1465,Cornufelle,A,Republican Period,7,-100,-30,70,1.5
1465,Cornufelle,A,Early Imperial Period,8,-30,100,130,1.5
1465,Cornufelle,A,Mid-Imperial Period,9,100,250,150,1.5
1466,Sterpara,A,Republican Period,7,-150,-50,100,1
1467,Ventidue Rubbia,A,Republican Period,7,-100,-30,70,0.30000001
1467,Ventidue Rubbia,A,Early Imperial Period,8,-30,100,130,0.30000001
1467,Ventidue Rubbia,A,Mid-Imperial Period,9,100,200,100,0.30000001
1468,Valle Vermiglia,A,Republican Period,7,-150,-30,120,0.80000001
1469,Grotte di S. Maria,A,Republican Period,7,-150,-50,100,0.30000001
1470,Casalaccio,A,Republican Period,7,-100,-30,70,0.80000001
1470,Casalaccio,A,Early Imperial Period,8,-30,100,130,0.80000001
1470,Casalaccio,A,Mid-Imperial Period,9,100,300,200,0.80000001
1471,Casale Fiorano,A,Republican Period,7,-150,-30,120,3.5
1471,Casale Fiorano,A,Early Imperial Period,8,-30,50,80,3.5
1472,Quarto Perazzeta,A,Republican Period,7,-200,-30,170,0.5
1473,Grotte dello Stinco,A,Republican Period,7,-50,-30,20,0.30000001
1473,Grotte dello Stinco,A,Early Imperial Period,8,-30,50,80,0.30000001
1474,Vigna Ferri,A,Republican Period,7,-100,-30,70,0.80000001
1474,Vigna Ferri,A,Early Imperial Period,8,-30,100,130,0.80000001
1474,Vigna Ferri,A,Mid-Imperial Period,9,100,300,200,0.80000001
1475,Colle Giuduce,A,Republican Period,7,-50,-30,20,0.30000001
1475,Colle Giuduce,A,Early Imperial Period,8,-30,100,130,0.30000001
1476,Colle Papa,A,Republican Period,7,-100,-30,70,1
1476,Colle Papa,A,Early Imperial Period,8,-30,100,130,1
1476,Colle Papa,A,Mid-Imperial Period,9,100,250,150,1
1477,Quarto Montione,A,Republican Period,7,-100,-30,70,2.3
1478,Luogo Nuovo,A,Republican Period,7,-100,-30,70,0.30000001
1478,Luogo Nuovo,A,Early Imperial Period,8,-30,100,130,0.69999999
1478,Luogo Nuovo,A,Mid-Imperial Period,9,100,250,150,0.69999999
1479,Casale Bevilacqua,A,Republican Period,7,-200,-30,170,1
1480,Villa Campitelli,A,Republican Period,7,-100,-30,70,0.5
1480,Villa Campitelli,A,Early Imperial Period,8,-30,100,130,0.5
1480,Villa Campitelli,A,Mid-Imperial Period,9,100,200,100,0.5
1481,Spinetta,A,Republican Period,7,-150,-30,120,1.5
1481,Spinetta,A,Early Imperial Period,8,-30,100,130,1.5
1481,Spinetta,A,Mid-Imperial Period,9,100,200,100,1.5
1482,Colle Pisano,A,Republican Period,7,-150,-30,120,1.5
1482,Colle Pisano,A,Early Imperial Period,8,-30,100,130,1.5
1482,Colle Pisano,A,Mid-Imperial Period,9,100,150,50,1.5
1483,Fontana Candida,A,Republican Period,7,-100,-30,70,0.30000001
1483,Fontana Candida,A,Early Imperial Period,8,-30,100,130,0.30000001
1484,Casale Segni,A,Republican Period,7,-150,-30,120,1.5
1484,Casale Segni,A,Early Imperial Period,8,-30,100,130,1.5
1485,Monte Mellone,A,Republican Period,7,-150,-30,120,0.60000002
1485,Monte Mellone,A,Early Imperial Period,8,-30,100,130,0.60000002
1485,Monte Mellone,A,Mid-Imperial Period,9,100,300,200,0.60000002
1485,Monte Mellone,A,Late Imperial Period,10,300,400,100,0.60000002
1486,Casale Brandolini,A,Mid-Imperial Period,9,100,300,200,0.5
1487,Casale Sonnino,A,Republican Period,7,-100,-30,70,3
1487,Casale Sonnino,A,Early Imperial Period,8,-30,100,130,3
1487,Casale Sonnino,A,Mid-Imperial Period,9,100,200,100,3
1488,Casale Grande,A,Republican Period,7,-150,-30,120,0.30000001
1488,Casale Grande,A,Early Imperial Period,8,-30,100,130,0.30000001
1488,Casale Grande,A,Mid-Imperial Period,9,100,150,50,0.30000001
1489,Casale Celli,A,Republican Period,7,-100,-30,70,0.30000001
1489,Casale Celli,A,Early Imperial Period,8,-30,100,130,0.30000001
1489,Casale Celli,A,Mid-Imperial Period,9,100,300,200,0.30000001
1489,Casale Celli,A,Late Imperial Period,10,300,400,100,0.30000001
1490,Casale Celli,A,Republican Period,7,-150,-30,120,1.5
1491,i Romoli,A,Republican Period,7,-50,-30,20,0.5
1491,i Romoli,A,Early Imperial Period,8,-30,100,130,0.5
1491,i Romoli,A,Mid-Imperial Period,9,100,200,100,0.5
1492,I Tavolacci,A,Early Imperial Period,8,-30,100,130,2
1492,I Tavolacci,A,Mid-Imperial Period,9,100,300,200,2
1493,Pentoma dei Frati,A,Republican Period,7,-150,-30,120,2.5
1494,Le Cappellette,A,Republican Period,7,-150,-30,120,1.5
1495,Villa Mondragone,A,Republican Period,7,-50,-30,20,1.5
1495,Villa Mondragone,A,Early Imperial Period,8,-30,100,130,1.5
1495,Villa Mondragone,A,Mid-Imperial Period,9,100,200,100,1.5
1496,Il Parco,A,Republican Period,7,-100,-30,70,3.5
1496,Il Parco,A,Early Imperial Period,8,-30,100,130,3.5
1497,Villa Falconieri,A,Republican Period,7,-150,-30,120,1.5
1498,I Cappuccini,A,Republican Period,7,-100,-30,70,0.30000001
1498,I Cappuccini,A,Early Imperial Period,8,-30,100,130,0.30000001
1499,Villa Torlonia,A,Republican Period,7,-50,-30,20,3.5
1499,Villa Torlonia,A,Early Imperial Period,8,-30,100,130,3.5
1499,Villa Torlonia,A,Mid-Imperial Period,9,100,200,100,3.5
1500,Villa Muti,A,Early Imperial Period,8,-30,100,130,1.5
1500,Villa Muti,A,Mid-Imperial Period,9,100,150,50,1.5
1501,Villa Montione,A,Republican Period,7,-50,-30,20,2
1501,Villa Montione,A,Early Imperial Period,8,-30,100,130,2
1501,Villa Montione,A,Mid-Imperial Period,9,100,150,50,2
1502,Castel Savelli,A,Republican Period,7,-150,-30,120,1.8
1502,Castel Savelli,A,Early Imperial Period,8,-30,100,130,1.8
1502,Castel Savelli,A,Mid-Imperial Period,9,100,150,50,1.8
1503,Valle Marciana,A,Early Iron Age,4,-1000,-750,250,0.064769238
1503,Valle Marciana,A,Late Iron Age,5,-750,-700,50,0.064769238
1504,Valle Marciana,A,Middle Bronze Age,2,-1700,-1300,400,0.065580301
1505,Valle Marciana,A,Early Iron Age,4,-950,-750,200,0.064773604
1505,Valle Marciana,A,Late Iron Age,5,-750,-600,150,0.064773604
1506,Sorgente Preziosa,A,Early Iron Age,4,-950,-750,200,0.095430933
1506,Sorgente Preziosa,A,Late Iron Age,5,-750,-600,150,0.095430933
1507,Convento delle Monache,A,Republican Period,7,-150,-30,120,0.69999999
1507,Convento delle Monache,A,Early Imperial Period,8,-30,100,130,0.69999999
1507,Convento delle Monache,A,Mid-Imperial Period,9,100,200,100,0.69999999
1509,Villa Cipriana,A,Republican Period,7,-100,-30,70,1
1510,Villa Cavalletti,A,Early Iron Age,4,-1000,-800,200,0.034003966
1511,Abbazia di S. Nilo,A,Republican Period,7,-100,-30,70,0.60000002
1511,Abbazia di S. Nilo,A,Early Imperial Period,8,-30,100,130,0.60000002
1511,Abbazia di S. Nilo,A,Mid-Imperial Period,9,100,200,100,0.60000002
1512,Valle Marciana,A,Early Iron Age,4,-1000,-750,250,0.080973923
1512,Valle Marciana,A,Late Iron Age,5,-750,-700,50,0.080973923
1513,Il Nocinone,A,Archaic Period,6,-500,-350,150,0.064765029
1513,Il Nocinone,A,Republican Period,7,-350,-300,50,0.064765029
1514,Tuscolo,A,Republican Period,7,-50,-30,20,1
1514,Tuscolo,A,Early Imperial Period,8,-30,100,130,1
1514,Tuscolo,A,Mid-Imperial Period,9,100,300,200,1
1514,Tuscolo,A,Late Imperial Period,10,300,400,100,1
1515,Tuscolo,A,Republican Period,7,-100,-30,70,1.7
1515,Tuscolo,A,Early Imperial Period,8,-30,100,130,1.7
1515,Tuscolo,A,Mid-Imperial Period,9,100,200,100,1.7
1516,Tuscolo,A,Republican Period,7,-100,-30,70,0.30000001
1516,Tuscolo,A,Early Imperial Period,8,-30,100,130,0.30000001
1517,Villa Gammarelli,A,Republican Period,7,-250,-30,220,0.5
1517,Villa Gammarelli,A,Early Imperial Period,8,-30,100,130,0.5
1517,Villa Gammarelli,A,Mid-Imperial Period,9,100,200,100,0.5
1518,Casaccia,A,Republican Period,7,-100,-30,70,0.30000001
1519,Monte Salomone,A,Early Imperial Period,8,-30,100,130,0.2
1519,Monte Salomone,A,Mid-Imperial Period,9,100,150,50,0.2
1521,Colle delle Streghe,A,Late Iron Age,5,-700,-600,100,0.061944254
1523,Valle delle Noci,A,Early Imperial Period,8,-30,100,130,0.2
1524,Madonna delle Molare,A,Republican Period,7,-150,-75,75,1
1528,Pilozzo,A,Middle Bronze Age,2,-1700,-1300,400,0.16995189
1529,Villa Cavalletti,A,Early Iron Age,4,-1000,-800,200,0.097152017
1530,Valle Marciana,A,Early Iron Age,4,-1000,-800,200,0.080165125
1531,Colle delle Ginestre,A,Early Iron Age,4,-1000,-800,200,0.080159374
1532,Monti Tuscolani,A,Late Iron Age,5,-700,-650,50,0.13683245
1533,Il Nocinone,A,Archaic Period,6,-500,-350,150,0.064766422
1533,Il Nocinone,A,Republican Period,7,-350,-300,50,0.064766422
1534,,A,Archaic Period,6,-500,-350,150,0.2
1534,,A,Republican Period,7,-350,-30,320,0.2
1534,,A,Early Imperial Period,8,-30,100,130,0.2
1534,,A,Mid-Imperial Period,9,100,300,200,0.2
1534,,A,Late Imperial Period,10,300,500,200,0.2
1535,,A,Archaic Period,6,-500,-350,150,0.2
1535,,A,Republican Period,7,-350,-30,320,0.2
1535,,A,Early Imperial Period,8,-30,100,130,0.2
1535,,A,Mid-Imperial Period,9,100,300,200,0.2
1535,,A,Late Imperial Period,10,300,500,200,0.2
1536,,A,Archaic Period,6,-500,-350,150,0.2
1536,,A,Republican Period,7,-350,-30,320,0.2
1536,,A,Early Imperial Period,8,-30,100,130,0.2
1536,,A,Mid-Imperial Period,9,100,300,200,0.2
1536,,A,Late Imperial Period,10,300,500,200,0.2
1537,,A,Archaic Period,6,-500,-350,150,0.2
1537,,A,Republican Period,7,-350,-30,320,0.2
1537,,A,Early Imperial Period,8,-30,100,130,0.2
1537,,A,Mid-Imperial Period,9,100,300,200,0.2
1537,,A,Late Imperial Period,10,300,500,200,0.2
1538,,A,Archaic Period,6,-500,-350,150,0.69999999
1538,,A,Republican Period,7,-350,-30,320,0.69999999
1538,,A,Early Imperial Period,8,-30,100,130,0.69999999
1538,,A,Mid-Imperial Period,9,100,300,200,0.69999999
1538,,A,Late Imperial Period,10,300,500,200,0.69999999
1539,,A,Mid-Imperial Period,9,100,300,200,1
1540,,A,Archaic Period,6,-500,-350,150,0.40000001
1540,,A,Republican Period,7,-350,-30,320,0.40000001
1540,,A,Early Imperial Period,8,-30,100,130,0.40000001
1540,,A,Mid-Imperial Period,9,100,300,200,0.40000001
1540,,A,Late Imperial Period,10,300,500,200,0.40000001
1541,,A,Archaic Period,6,-500,-350,150,0.1
1541,,A,Republican Period,7,-350,-30,320,0.1
1541,,A,Early Imperial Period,8,-30,100,130,0.1
1541,,A,Mid-Imperial Period,9,100,300,200,0.1
1541,,A,Late Imperial Period,10,300,500,200,0.1
1542,,A,Archaic Period,6,-500,-350,150,0.1
1542,,A,Republican Period,7,-350,-30,320,0.1
1542,,A,Early Imperial Period,8,-30,100,130,0.1
1542,,A,Mid-Imperial Period,9,100,300,200,0.1
1542,,A,Late Imperial Period,10,300,500,200,0.1
1543,,A,Archaic Period,6,-500,-350,150,0.80000001
1543,,A,Republican Period,7,-350,-30,320,0.80000001
1543,,A,Early Imperial Period,8,-30,100,130,0.80000001
1543,,A,Mid-Imperial Period,9,100,300,200,0.80000001
1543,,A,Late Imperial Period,10,300,500,200,0.80000001
1544,,A,Archaic Period,6,-500,-350,150,0.80000001
1544,,A,Republican Period,7,-350,-30,320,0.80000001
1544,,A,Early Imperial Period,8,-30,100,130,0.80000001
1544,,A,Mid-Imperial Period,9,100,300,200,0.80000001
1544,,A,Late Imperial Period,10,300,500,200,0.80000001
1545,,A,Early Imperial Period,8,-30,100,130,0.30000001
1545,,A,Mid-Imperial Period,9,100,300,200,0.30000001
1545,,A,Late Imperial Period,10,300,500,200,0.30000001
1546,,A,Archaic Period,6,-500,-350,150,0.30000001
1546,,A,Republican Period,7,-350,-30,320,0.30000001
1546,,A,Early Imperial Period,8,-30,100,130,0.30000001
1546,,A,Mid-Imperial Period,9,100,300,200,0.30000001
1546,,A,Late Imperial Period,10,300,500,200,0.30000001
1547,,A,Archaic Period,6,-500,-350,150,0.40000001
1547,,A,Republican Period,7,-350,-30,320,0.40000001
1547,,A,Early Imperial Period,8,-30,100,130,0.40000001
1547,,A,Mid-Imperial Period,9,100,300,200,0.40000001
1547,,A,Late Imperial Period,10,300,500,200,0.40000001
1548,,A,Archaic Period,6,-500,-350,150,0.5
1548,,A,Republican Period,7,-350,-30,320,0.5
1548,,A,Early Imperial Period,8,-30,100,130,0.5
1548,,A,Mid-Imperial Period,9,100,300,200,0.5
1548,,A,Late Imperial Period,10,300,500,200,0.5
1549,,A,Archaic Period,6,-500,-350,150,0.40000001
1549,,A,Republican Period,7,-350,-30,320,0.40000001
1549,,A,Early Imperial Period,8,-30,100,130,0.40000001
1549,,A,Mid-Imperial Period,9,100,300,200,0.40000001
1549,,A,Late Imperial Period,10,300,500,200,0.40000001
1550,,A,Early Imperial Period,8,-30,100,130,0.69999999
1550,,A,Mid-Imperial Period,9,100,300,200,0.69999999
1550,,A,Late Imperial Period,10,300,500,200,0.69999999
1551,,A,Archaic Period,6,-500,-350,150,0.30000001
1551,,A,Republican Period,7,-350,-30,320,0.30000001
1551,,A,Early Imperial Period,8,-30,100,130,0.30000001
1551,,A,Mid-Imperial Period,9,100,300,200,0.30000001
1551,,A,Late Imperial Period,10,300,500,200,0.30000001
1552,,A,Early Imperial Period,8,-30,100,130,0.5
1552,,A,Mid-Imperial Period,9,100,300,200,0.5
1552,,A,Late Imperial Period,10,300,500,200,0.5
1553,,A,Archaic Period,6,-500,-350,150,0.40000001
1553,,A,Republican Period,7,-350,-30,320,0.40000001
1553,,A,Early Imperial Period,8,-30,100,130,0.40000001
1553,,A,Mid-Imperial Period,9,100,300,200,0.40000001
1553,,A,Late Imperial Period,10,300,500,200,0.40000001
1554,,A,Archaic Period,6,-500,-350,150,0.40000001
1554,,A,Republican Period,7,-350,-30,320,0.40000001
1554,,A,Early Imperial Period,8,-30,100,130,0.40000001
1554,,A,Mid-Imperial Period,9,100,300,200,0.40000001
1554,,A,Late Imperial Period,10,300,500,200,0.40000001
1555,,A,Archaic Period,6,-500,-350,150,0.40000001
1555,,A,Republican Period,7,-350,-30,320,0.40000001
1555,,A,Early Imperial Period,8,-30,100,130,0.40000001
1555,,A,Mid-Imperial Period,9,100,300,200,0.40000001
1555,,A,Late Imperial Period,10,300,500,200,0.40000001
1556,,A,Early Imperial Period,8,-30,50,80,0.5
1557,,A,Archaic Period,6,-500,-350,150,0.30000001
1557,,A,Republican Period,7,-350,-30,320,0.30000001
1557,,A,Early Imperial Period,8,-30,100,130,0.30000001
1557,,A,Mid-Imperial Period,9,100,300,200,0.30000001
1557,,A,Late Imperial Period,10,300,500,200,0.30000001
1558,,A,Early Imperial Period,8,-30,50,80,0.80000001
1559,,A,Archaic Period,6,-500,-350,150,0.5
1559,,A,Republican Period,7,-350,-30,320,0.5
1559,,A,Early Imperial Period,8,-30,100,130,0.5
1559,,A,Mid-Imperial Period,9,100,300,200,0.5
1559,,A,Late Imperial Period,10,300,500,200,0.5
1560,,A,Republican Period,7,-100,-30,70,0.5
1561,,A,Archaic Period,6,-500,-350,150,0.40000001
1561,,A,Republican Period,7,-350,-30,320,0.40000001
1561,,A,Early Imperial Period,8,-30,100,130,0.40000001
1561,,A,Mid-Imperial Period,9,100,300,200,0.40000001
1561,,A,Late Imperial Period,10,300,500,200,0.40000001
1562,,A,Archaic Period,6,-500,-350,150,0.40000001
1562,,A,Republican Period,7,-350,-30,320,0.40000001
1562,,A,Early Imperial Period,8,-30,100,130,0.40000001
1562,,A,Mid-Imperial Period,9,100,300,200,0.40000001
1562,,A,Late Imperial Period,10,300,500,200,0.40000001
1563,,A,Archaic Period,6,-500,-350,150,0.40000001
1563,,A,Republican Period,7,-350,-30,320,0.40000001
1563,,A,Early Imperial Period,8,-30,100,130,0.40000001
1563,,A,Mid-Imperial Period,9,100,300,200,0.40000001
1563,,A,Late Imperial Period,10,300,500,200,0.40000001
1564,,A,Archaic Period,6,-500,-350,150,0.40000001
1564,,A,Republican Period,7,-350,-30,320,0.40000001
1564,,A,Early Imperial Period,8,-30,100,130,0.40000001
1564,,A,Mid-Imperial Period,9,100,300,200,0.40000001
1564,,A,Late Imperial Period,10,300,500,200,0.40000001
1565,,A,Republican Period,7,-100,-30,70,0.60000002
1566,Apiolae ?,A,Late Iron Age,5,-600,-580,20,1
1566,Apiolae ?,A,Archaic Period,6,-580,-500,80,1
1567,,A,Archaic Period,6,-500,-350,150,0.2
1567,,A,Republican Period,7,-350,-30,320,0.2
1567,,A,Early Imperial Period,8,-30,100,130,0.2
1567,,A,Mid-Imperial Period,9,100,300,200,0.2
1567,,A,Late Imperial Period,10,300,500,200,0.2
1568,,A,Republican Period,7,-100,-30,70,0.30000001
1569,,A,Republican Period,7,-100,-30,70,0.30000001
1570,,A,Archaic Period,6,-500,-350,150,0.30000001
1570,,A,Republican Period,7,-350,-30,320,0.30000001
1570,,A,Early Imperial Period,8,-30,100,130,0.30000001
1570,,A,Mid-Imperial Period,9,100,300,200,0.30000001
1570,,A,Late Imperial Period,10,300,500,200,0.30000001
1571,,A,Archaic Period,6,-500,-350,150,0.40000001
1571,,A,Republican Period,7,-350,-30,320,0.40000001
1571,,A,Early Imperial Period,8,-30,100,130,0.40000001
1571,,A,Mid-Imperial Period,9,100,300,200,0.40000001
1571,,A,Late Imperial Period,10,300,500,200,0.40000001
1572,,A,Archaic Period,6,-500,-350,150,0.80000001
1572,,A,Republican Period,7,-350,-30,320,0.80000001
1572,,A,Early Imperial Period,8,-30,100,130,0.80000001
1572,,A,Mid-Imperial Period,9,100,300,200,0.80000001
1572,,A,Late Imperial Period,10,300,500,200,0.80000001
1573,,A,Early Imperial Period,8,-30,50,80,0.80000001
1574,,A,Republican Period,7,-100,-30,70,0.40000001
1575,,A,Archaic Period,6,-500,-350,150,0.2
1575,,A,Republican Period,7,-350,-30,320,0.2
1575,,A,Early Imperial Period,8,-30,100,130,0.2
1575,,A,Mid-Imperial Period,9,100,300,200,0.2
1575,,A,Late Imperial Period,10,300,500,200,0.2
1576,,A,Archaic Period,6,-500,-350,150,0.2
1576,,A,Republican Period,7,-350,-30,320,0.2
1576,,A,Early Imperial Period,8,-30,100,130,0.2
1576,,A,Mid-Imperial Period,9,100,300,200,0.2
1576,,A,Late Imperial Period,10,300,500,200,0.2
1577,,A,Archaic Period,6,-500,-350,150,0.5
1577,,A,Republican Period,7,-350,-30,320,0.5
1577,,A,Early Imperial Period,8,-30,100,130,0.5
1577,,A,Mid-Imperial Period,9,100,300,200,0.5
1577,,A,Late Imperial Period,10,300,500,200,0.5
1578,,A,Archaic Period,6,-500,-350,150,0.60000002
1578,,A,Republican Period,7,-350,-30,320,0.60000002
1578,,A,Early Imperial Period,8,-30,100,130,0.60000002
1578,,A,Mid-Imperial Period,9,100,300,200,0.60000002
1578,,A,Late Imperial Period,10,300,500,200,0.60000002
1579,,A,Archaic Period,6,-500,-350,150,0.2
1579,,A,Republican Period,7,-350,-30,320,0.2
1579,,A,Early Imperial Period,8,-30,100,130,0.2
1579,,A,Mid-Imperial Period,9,100,300,200,0.2
1579,,A,Late Imperial Period,10,300,500,200,0.2
1580,,A,Republican Period,7,-100,-30,70,1.5
1580,,A,Early Imperial Period,8,-30,100,130,1.5
1580,,A,Mid-Imperial Period,9,100,300,200,1.5
1580,,A,Late Imperial Period,10,300,400,100,1.5
1581,,A,Early Imperial Period,8,1,100,99,0.5
1582,,A,Archaic Period,6,-500,-350,150,0.2
1582,,A,Republican Period,7,-350,-30,320,0.2
1582,,A,Early Imperial Period,8,-30,100,130,0.2
1582,,A,Mid-Imperial Period,9,100,300,200,0.2
1582,,A,Late Imperial Period,10,300,500,200,0.2
1583,,A,Early Imperial Period,8,-30,50,80,0.5
1584,,A,Republican Period,7,-100,-30,70,0.60000002
1585,,A,Mid-Imperial Period,9,100,200,100,0.5
1586,,A,Archaic Period,6,-500,-350,150,0.2
1586,,A,Republican Period,7,-350,-30,320,0.2
1586,,A,Early Imperial Period,8,-30,100,130,0.2
1586,,A,Mid-Imperial Period,9,100,300,200,0.2
1586,,A,Late Imperial Period,10,300,500,200,0.2
1587,,A,Archaic Period,6,-500,-350,150,0.30000001
1587,,A,Republican Period,7,-350,-30,320,0.30000001
1587,,A,Early Imperial Period,8,-30,100,130,0.30000001
1587,,A,Mid-Imperial Period,9,100,300,200,0.30000001
1587,,A,Late Imperial Period,10,300,500,200,0.30000001
1588,,A,Archaic Period,6,-500,-350,150,0.60000002
1588,,A,Republican Period,7,-350,-30,320,0.60000002
1588,,A,Early Imperial Period,8,-30,100,130,0.60000002
1588,,A,Mid-Imperial Period,9,100,300,200,0.60000002
1588,,A,Late Imperial Period,10,300,500,200,0.60000002
1589,,A,Early Imperial Period,8,-30,100,130,0.30000001
1589,,A,Mid-Imperial Period,9,100,200,100,0.30000001
1590,,A,Archaic Period,6,-500,-350,150,0.30000001
1590,,A,Republican Period,7,-350,-30,320,0.30000001
1590,,A,Early Imperial Period,8,-30,100,130,0.30000001
1590,,A,Mid-Imperial Period,9,100,300,200,0.30000001
1590,,A,Late Imperial Period,10,300,500,200,0.30000001
1591,,A,Archaic Period,6,-500,-350,150,0.2
1591,,A,Republican Period,7,-350,-30,320,0.2
1591,,A,Early Imperial Period,8,-30,100,130,0.2
1591,,A,Mid-Imperial Period,9,100,300,200,0.2
1591,,A,Late Imperial Period,10,300,500,200,0.2
1592,,A,Archaic Period,6,-500,-350,150,0.30000001
1592,,A,Republican Period,7,-350,-30,320,0.30000001
1592,,A,Early Imperial Period,8,-30,100,130,0.30000001
1592,,A,Mid-Imperial Period,9,100,300,200,0.30000001
1592,,A,Late Imperial Period,10,300,500,200,0.30000001
1593,,A,Archaic Period,6,-500,-350,150,0.5
1593,,A,Republican Period,7,-350,-30,320,0.5
1593,,A,Early Imperial Period,8,-30,100,130,0.5
1593,,A,Mid-Imperial Period,9,100,300,200,0.5
1593,,A,Late Imperial Period,10,300,500,200,0.5
1594,,A,Archaic Period,6,-500,-350,150,0.5
1594,,A,Republican Period,7,-350,-30,320,0.5
1594,,A,Early Imperial Period,8,-30,100,130,0.5
1594,,A,Mid-Imperial Period,9,100,300,200,0.5
1594,,A,Late Imperial Period,10,300,500,200,0.5
1595,,A,Early Imperial Period,8,1,100,99,1
1596,,A,Archaic Period,6,-500,-350,150,0.40000001
1596,,A,Republican Period,7,-350,-30,320,0.40000001
1596,,A,Early Imperial Period,8,-30,100,130,0.40000001
1596,,A,Mid-Imperial Period,9,100,300,200,0.40000001
1596,,A,Late Imperial Period,10,300,500,200,0.40000001
1597,,A,Archaic Period,6,-500,-350,150,0.5
1597,,A,Republican Period,7,-350,-30,320,0.5
1597,,A,Early Imperial Period,8,-30,100,130,0.5
1597,,A,Mid-Imperial Period,9,100,300,200,0.5
1597,,A,Late Imperial Period,10,300,500,200,0.5
1598,,A,Early Imperial Period,8,-30,100,130,0.40000001
1599,,A,Archaic Period,6,-500,-350,150,0.40000001
1599,,A,Republican Period,7,-350,-30,320,0.40000001
1599,,A,Early Imperial Period,8,-30,100,130,0.40000001
1599,,A,Mid-Imperial Period,9,100,300,200,0.40000001
1599,,A,Late Imperial Period,10,300,500,200,0.40000001
1600,,A,Archaic Period,6,-500,-350,150,0.69999999
1600,,A,Republican Period,7,-350,-30,320,0.69999999
1600,,A,Early Imperial Period,8,-30,100,130,0.69999999
1600,,A,Mid-Imperial Period,9,100,300,200,0.69999999
1600,,A,Late Imperial Period,10,300,500,200,0.69999999
1601,,A,Archaic Period,6,-500,-350,150,0.5
1601,,A,Republican Period,7,-350,-30,320,0.5
1601,,A,Early Imperial Period,8,-30,100,130,0.5
1601,,A,Mid-Imperial Period,9,100,300,200,0.5
1601,,A,Late Imperial Period,10,300,500,200,0.5
1602,,A,Archaic Period,6,-500,-350,150,0.5
1602,,A,Republican Period,7,-350,-30,320,0.5
1602,,A,Early Imperial Period,8,-30,100,130,0.5
1602,,A,Mid-Imperial Period,9,100,300,200,0.5
1602,,A,Late Imperial Period,10,300,500,200,0.5
1603,,A,Archaic Period,6,-500,-350,150,0.30000001
1603,,A,Republican Period,7,-350,-30,320,0.30000001
1603,,A,Early Imperial Period,8,-30,100,130,0.30000001
1603,,A,Mid-Imperial Period,9,100,300,200,0.30000001
1603,,A,Late Imperial Period,10,300,500,200,0.30000001
1604,,A,Archaic Period,6,-500,-350,150,0.5
1604,,A,Republican Period,7,-350,-30,320,0.5
1604,,A,Early Imperial Period,8,-30,100,130,0.5
1604,,A,Mid-Imperial Period,9,100,300,200,0.5
1604,,A,Late Imperial Period,10,300,500,200,0.5
1605,,A,Archaic Period,6,-500,-350,150,0.5
1605,,A,Republican Period,7,-350,-30,320,0.5
1606,,A,Archaic Period,6,-500,-350,150,0.30000001
1606,,A,Republican Period,7,-350,-30,320,0.30000001
1606,,A,Early Imperial Period,8,-30,100,130,0.30000001
1606,,A,Mid-Imperial Period,9,100,300,200,0.30000001
1606,,A,Late Imperial Period,10,300,500,200,0.30000001
1607,,A,Archaic Period,6,-500,-350,150,0.60000002
1607,,A,Republican Period,7,-350,-30,320,0.60000002
1607,,A,Early Imperial Period,8,-30,100,130,0.60000002
1607,,A,Mid-Imperial Period,9,100,300,200,0.60000002
1607,,A,Late Imperial Period,10,300,500,200,0.60000002
1608,,A,Archaic Period,6,-400,-350,50,0.80000001
1608,,A,Republican Period,7,-350,-100,250,0.80000001
1609,,A,Archaic Period,6,-500,-350,150,0.30000001
1609,,A,Republican Period,7,-350,-30,320,0.30000001
1609,,A,Early Imperial Period,8,-30,100,130,0.30000001
1609,,A,Mid-Imperial Period,9,100,300,200,0.30000001
1609,,A,Late Imperial Period,10,300,500,200,0.30000001
1610,,A,Archaic Period,6,-500,-350,150,0.30000001
1610,,A,Republican Period,7,-350,-30,320,0.30000001
1610,,A,Early Imperial Period,8,-30,100,130,0.30000001
1610,,A,Mid-Imperial Period,9,100,300,200,0.30000001
1610,,A,Late Imperial Period,10,300,500,200,0.30000001
1611,,A,Republican Period,7,-50,-30,20,0.2
1611,,A,Early Imperial Period,8,-30,100,130,0.2
1611,,A,Mid-Imperial Period,9,100,300,200,0.2
1611,,A,Late Imperial Period,10,300,500,200,0.2
1612,,A,Archaic Period,6,-400,-350,50,0.69999999
1612,,A,Republican Period,7,-350,-30,320,0.69999999
1613,,A,Archaic Period,6,-500,-350,150,0.60000002
1613,,A,Republican Period,7,-350,-30,320,0.60000002
1613,,A,Early Imperial Period,8,-30,100,130,0.60000002
1613,,A,Mid-Imperial Period,9,100,300,200,0.60000002
1613,,A,Late Imperial Period,10,300,500,200,0.60000002
1614,,A,Archaic Period,6,-500,-350,150,0.30000001
1614,,A,Republican Period,7,-350,-30,320,0.30000001
1614,,A,Early Imperial Period,8,-30,100,130,0.30000001
1614,,A,Mid-Imperial Period,9,100,300,200,0.30000001
1614,,A,Late Imperial Period,10,300,500,200,0.30000001
1616,,A,Archaic Period,6,-500,-350,150,0.30000001
1616,,A,Republican Period,7,-350,-30,320,0.30000001
1616,,A,Early Imperial Period,8,-30,100,130,0.30000001
1616,,A,Mid-Imperial Period,9,100,300,200,0.30000001
1616,,A,Late Imperial Period,10,300,500,200,0.30000001
1617,,A,Archaic Period,6,-500,-350,150,0.30000001
1617,,A,Republican Period,7,-350,-30,320,0.30000001
1617,,A,Early Imperial Period,8,-30,100,130,0.30000001
1617,,A,Mid-Imperial Period,9,100,300,200,0.30000001
1617,,A,Late Imperial Period,10,300,500,200,0.30000001
1618,,A,Archaic Period,6,-500,-350,150,0.30000001
1618,,A,Republican Period,7,-350,-30,320,0.30000001
1618,,A,Early Imperial Period,8,-30,100,130,0.30000001
1618,,A,Mid-Imperial Period,9,100,300,200,0.30000001
1618,,A,Late Imperial Period,10,300,500,200,0.30000001
1619,,A,Early Imperial Period,8,-30,100,130,0.40000001
1620,,A,Archaic Period,6,-400,-350,50,0.5
1620,,A,Republican Period,7,-350,-30,320,0.5
1620,,A,Early Imperial Period,8,-30,50,80,0.5
1621,,A,Archaic Period,6,-500,-350,150,0.5
1621,,A,Republican Period,7,-350,-30,320,0.5
1621,,A,Early Imperial Period,8,-30,100,130,0.5
1621,,A,Mid-Imperial Period,9,100,300,200,0.5
1621,,A,Late Imperial Period,10,300,500,200,0.5
1622,,A,Archaic Period,6,-500,-350,150,0.5
1622,,A,Republican Period,7,-350,-30,320,0.5
1622,,A,Early Imperial Period,8,-30,100,130,0.5
1622,,A,Mid-Imperial Period,9,100,300,200,0.5
1622,,A,Late Imperial Period,10,300,500,200,0.5
1623,,A,Republican Period,7,-50,-30,20,0.40000001
1623,,A,Early Imperial Period,8,-30,100,130,0.40000001
1623,,A,Mid-Imperial Period,9,100,300,200,0.40000001
1623,,A,Late Imperial Period,10,300,500,200,0.40000001
1624,,A,Republican Period,7,-50,-30,20,0.30000001
1624,,A,Early Imperial Period,8,-30,100,130,0.30000001
1624,,A,Mid-Imperial Period,9,100,300,200,0.30000001
1624,,A,Late Imperial Period,10,300,500,200,0.30000001
1625,,A,Republican Period,7,-50,-30,20,0.30000001
1625,,A,Early Imperial Period,8,-30,100,130,0.30000001
1625,,A,Mid-Imperial Period,9,100,300,200,0.30000001
1625,,A,Late Imperial Period,10,300,500,200,0.30000001
1626,,A,Republican Period,7,-50,-30,20,0.30000001
1626,,A,Early Imperial Period,8,-30,100,130,0.30000001
1626,,A,Mid-Imperial Period,9,100,300,200,0.30000001
1626,,A,Late Imperial Period,10,300,500,200,0.30000001
1627,,A,Archaic Period,6,-500,-350,150,0.5
1627,,A,Republican Period,7,-350,-30,320,0.5
1627,,A,Early Imperial Period,8,-30,100,130,0.5
1627,,A,Mid-Imperial Period,9,100,300,200,0.5
1627,,A,Late Imperial Period,10,300,500,200,0.5
1628,,A,Republican Period,7,-100,-30,70,0.69999999
1628,,A,Early Imperial Period,8,-30,100,130,0.69999999
1628,,A,Mid-Imperial Period,9,100,200,100,0.69999999
1629,,A,Republican Period,7,-50,-30,20,0.30000001
1629,,A,Early Imperial Period,8,-30,100,130,0.30000001
1629,,A,Mid-Imperial Period,9,100,300,200,0.30000001
1629,,A,Late Imperial Period,10,300,500,200,0.30000001
1630,,A,Archaic Period,6,-400,-350,50,0.2
1630,,A,Republican Period,7,-350,-30,320,0.2
1630,,A,Early Imperial Period,8,-30,50,80,0.2
1631,,A,Early Imperial Period,8,-30,100,130,0.30000001
1631,,A,Mid-Imperial Period,9,100,300,200,0.30000001
1631,,A,Late Imperial Period,10,300,500,200,0.30000001
1632,,A,Archaic Period,6,-400,-350,50,0.2
1632,,A,Republican Period,7,-350,-30,320,0.2
1632,,A,Early Imperial Period,8,-30,100,130,0.2
1632,,A,Mid-Imperial Period,9,100,300,200,0.2
1632,,A,Late Imperial Period,10,300,500,200,0.2
1633,,A,Archaic Period,6,-500,-350,150,0.40000001
1633,,A,Republican Period,7,-350,-30,320,0.40000001
1634,,A,Archaic Period,6,-500,-350,150,0.40000001
1634,,A,Republican Period,7,-350,-30,320,0.40000001
1634,,A,Early Imperial Period,8,-30,100,130,0.40000001
1634,,A,Mid-Imperial Period,9,100,300,200,0.40000001
1634,,A,Late Imperial Period,10,300,500,200,0.40000001
1635,,A,Archaic Period,6,-500,-350,150,0.2
1635,,A,Republican Period,7,-350,-30,320,0.2
1635,,A,Early Imperial Period,8,-30,100,130,0.2
1635,,A,Mid-Imperial Period,9,100,300,200,0.2
1635,,A,Late Imperial Period,10,300,500,200,0.2
1636,,A,Archaic Period,6,-500,-350,150,0.2
1636,,A,Republican Period,7,-350,-30,320,0.2
1636,,A,Early Imperial Period,8,-30,100,130,0.2
1636,,A,Mid-Imperial Period,9,100,300,200,0.2
1636,,A,Late Imperial Period,10,300,500,200,0.2
1637,Torretta di Decima (Politorium ?),A,Late Iron Age,5,-600,-580,20,1.2
1637,Torretta di Decima (Politorium ?),A,Archaic Period,6,-580,-500,80,1.2
1637,Torretta di Decima (Politorium ?),B,Early Imperial Period,8,-30,50,80,1.2
1638,Trigoria Alta,A,Late Iron Age,5,-600,-580,20,0.30000001
1638,Trigoria Alta,A,Archaic Period,6,-580,-500,80,0.30000001
1638,Trigoria Alta,B,Early Imperial Period,8,-30,100,130,0.30000001
1638,Trigoria Alta,B,Mid-Imperial Period,9,100,300,200,0.30000001
1638,Trigoria Alta,B,Late Imperial Period,10,300,500,200,0.30000001
1639,,A,Archaic Period,6,-500,-350,150,0.2
1639,,A,Republican Period,7,-350,-30,320,0.2
1639,,A,Early Imperial Period,8,-30,100,130,0.2
1639,,A,Mid-Imperial Period,9,100,300,200,0.2
1639,,A,Late Imperial Period,10,300,500,200,0.2
1640,,A,Archaic Period,6,-500,-350,150,0.2
1640,,A,Republican Period,7,-350,-30,320,0.2
1640,,A,Early Imperial Period,8,-30,100,130,0.2
1640,,A,Mid-Imperial Period,9,100,300,200,0.2
1640,,A,Late Imperial Period,10,300,500,200,0.2
1641,Trigoria,A,Late Iron Age,5,-650,-580,70,0.1
1641,Trigoria,B,Archaic Period,6,-580,-350,230,0.1
1641,Trigoria,B,Republican Period,7,-350,-200,150,0.1
1642,,A,Archaic Period,6,-400,-350,50,0.2
1642,,A,Republican Period,7,-350,-30,320,0.2
1643,,A,Archaic Period,6,-400,-350,50,0.40000001
1643,,A,Republican Period,7,-350,-30,320,0.40000001
1644,,A,Archaic Period,6,-400,-350,50,0.2
1644,,A,Republican Period,7,-350,-30,320,0.2
1645,,A,Archaic Period,6,-400,-350,50,0.30000001
1645,,A,Republican Period,7,-350,-30,320,0.30000001
1646,,A,Archaic Period,6,-400,-350,50,0.40000001
1646,,A,Republican Period,7,-350,-30,320,0.40000001
1647,,A,Archaic Period,6,-400,-350,50,0.30000001
1647,,A,Republican Period,7,-350,-30,320,0.30000001
1648,,A,Archaic Period,6,-500,-350,150,0.30000001
1648,,A,Republican Period,7,-350,-30,320,0.30000001
1648,,A,Early Imperial Period,8,-30,100,130,0.30000001
1648,,A,Mid-Imperial Period,9,100,300,200,0.30000001
1648,,A,Late Imperial Period,10,300,500,200,0.30000001
1649,,A,Archaic Period,6,-500,-350,150,0.30000001
1649,,A,Republican Period,7,-350,-30,320,0.30000001
1649,,A,Early Imperial Period,8,-30,100,130,0.30000001
1649,,A,Mid-Imperial Period,9,100,300,200,0.30000001
1649,,A,Late Imperial Period,10,300,500,200,0.30000001
1650,,A,Archaic Period,6,-500,-350,150,0.30000001
1650,,A,Republican Period,7,-350,-30,320,0.30000001
1650,,A,Early Imperial Period,8,-30,100,130,0.30000001
1650,,A,Mid-Imperial Period,9,100,300,200,0.30000001
1650,,A,Late Imperial Period,10,300,500,200,0.30000001
1651,,A,Archaic Period,6,-500,-350,150,0.30000001
1651,,A,Republican Period,7,-350,-30,320,0.30000001
1651,,A,Early Imperial Period,8,-30,100,130,0.30000001
1651,,A,Mid-Imperial Period,9,100,300,200,0.30000001
1651,,A,Late Imperial Period,10,300,500,200,0.30000001
1652,,A,Late Iron Age,5,-600,-580,20,0.40000001
1652,,A,Archaic Period,6,-580,-500,80,0.40000001
1653,,A,Republican Period,7,-200,-30,170,0.1
1653,,A,Early Imperial Period,8,-30,100,130,0.1
1654,,A,Late Iron Age,5,-700,-580,120,0.2
1654,,A,Archaic Period,6,-580,-500,80,0.2
1655,,A,Republican Period,7,-50,-30,20,1
1655,,A,Early Imperial Period,8,-30,50,80,1
1656,,A,Republican Period,7,-100,-30,70,0.1
1656,,A,Early Imperial Period,8,-30,100,130,0.1
1656,,A,Mid-Imperial Period,9,100,300,200,0.1
1656,,A,Late Imperial Period,10,300,400,100,0.1
1657,,A,Republican Period,7,-300,-30,270,0.1
1657,,A,Early Imperial Period,8,-30,100,130,0.1
1657,,A,Mid-Imperial Period,9,100,200,100,0.1
1658,,A,Republican Period,7,-200,-30,170,0.1
1658,,A,Early Imperial Period,8,-30,100,130,0.1
1659,,A,Late Iron Age,5,-700,-580,120,0.1
1659,,A,Archaic Period,6,-580,-500,80,0.1
1660,,A,Late Iron Age,5,-700,-580,120,0.1
1660,,A,Archaic Period,6,-580,-350,230,0.1
1660,,A,Republican Period,7,-350,-30,320,0.1
1660,,A,Early Imperial Period,8,-30,100,130,0.1
1661,,A,Late Iron Age,5,-700,-580,120,0.1
1661,,A,Archaic Period,6,-580,-350,230,0.1
1661,,A,Republican Period,7,-350,-300,50,0.1
1662,,A,Late Iron Age,5,-700,-580,120,0.1
1662,,A,Archaic Period,6,-580,-350,230,0.1
1662,,A,Republican Period,7,-350,-30,320,0.1
1662,,A,Early Imperial Period,8,-30,100,130,0.1
1662,,A,Mid-Imperial Period,9,100,200,100,0.1
1663,,A,Late Iron Age,5,-700,-580,120,0.039999999
1663,,A,Archaic Period,6,-580,-350,230,0.039999999
1663,,A,Republican Period,7,-350,-300,50,0.039999999
1664,,A,Late Iron Age,5,-700,-580,120,0.029999999
1664,,A,Archaic Period,6,-580,-500,80,0.029999999
1665,,A,Republican Period,7,-200,-30,170,1
1665,,A,Early Imperial Period,8,-30,100,130,1
1665,,A,Mid-Imperial Period,9,100,300,200,1
1665,,A,Late Imperial Period,10,300,500,200,1
1666,,A,Late Iron Age,5,-700,-580,120,0.01
1666,,A,Archaic Period,6,-580,-350,230,0.01
1666,,A,Republican Period,7,-350,-300,50,0.01
1667,,A,Late Iron Age,5,-700,-580,120,0.1
1667,,A,Archaic Period,6,-580,-350,230,0.1
1667,,B,Republican Period,7,-350,-30,320,0.1
1667,,B,Early Imperial Period,8,-30,100,130,0.1
1668,,A,Late Iron Age,5,-700,-580,120,0.01
1668,,A,Archaic Period,6,-580,-350,230,0.01
1668,,A,Republican Period,7,-350,-50,300,0.01
1669,,A,Late Iron Age,5,-600,-580,20,0.1
1669,,A,Archaic Period,6,-580,-350,230,0.1
1669,,B,Republican Period,7,-350,-30,320,0.1
1669,,B,Early Imperial Period,8,-30,100,130,0.1
1670,,A,Archaic Period,6,-500,-350,150,0.039999999
1670,,A,Republican Period,7,-350,-50,300,0.039999999
1671,,A,Late Iron Age,5,-700,-580,120,0.5
1671,,A,Archaic Period,6,-580,-500,80,0.5
1671,,B,Republican Period,7,-200,-30,170,0.5
1671,,B,Early Imperial Period,8,-30,100,130,0.5
1671,,B,Mid-Imperial Period,9,100,300,200,0.5
1671,,B,Late Imperial Period,10,300,500,200,0.5
1672,,A,Late Iron Age,5,-700,-580,120,0.1
1672,,A,Archaic Period,6,-580,-500,80,0.1
1672,,B,Republican Period,7,-200,-30,170,0.30000001
1672,,B,Early Imperial Period,8,-30,100,130,0.30000001
1672,,B,Mid-Imperial Period,9,100,300,200,0.30000001
1672,,B,Late Imperial Period,10,300,500,200,0.30000001
1673,,A,Republican Period,7,-200,-100,100,0.050000001
1674,,A,Republican Period,7,-300,-30,270,0.1
1674,,A,Early Imperial Period,8,-30,100,130,0.1
1674,,A,Mid-Imperial Period,9,100,200,100,0.1
1675,,A,Republican Period,7,-200,-30,170,1
1675,,A,Early Imperial Period,8,-30,100,130,1
1675,,A,Mid-Imperial Period,9,100,300,200,1
1675,,A,Late Imperial Period,10,300,500,200,1
1676,,A,Republican Period,7,-300,-30,270,6
1676,,A,Early Imperial Period,8,-30,100,130,6
1676,,A,Mid-Imperial Period,9,100,300,200,6
1676,,A,Late Imperial Period,10,300,500,200,6
1677,,A,Republican Period,7,-200,-30,170,1
1677,,A,Early Imperial Period,8,-30,100,130,1
1677,,A,Mid-Imperial Period,9,100,300,200,1
1677,,A,Late Imperial Period,10,300,500,200,1
1678,,A,Early Iron Age,4,-900,-750,150,4
1678,,A,Late Iron Age,5,-750,-580,170,4
1678,,A,Archaic Period,6,-580,-350,230,4
1678,,A,Republican Period,7,-350,-200,150,4
1679,,A,Early Iron Age,4,-800,-750,50,0.1
1679,,A,Late Iron Age,5,-750,-580,170,0.1
1679,,A,Archaic Period,6,-580,-400,180,0.1
1680,,A,Republican Period,7,-300,-30,270,0.2
1680,,A,Early Imperial Period,8,-30,100,130,0.2
1680,,A,Mid-Imperial Period,9,100,300,200,0.2
1680,,A,Late Imperial Period,10,300,500,200,0.2
1681,,A,Late Iron Age,5,-700,-580,120,0.07
1681,,A,Archaic Period,6,-580,-500,80,0.07
1681,,B,Republican Period,7,-300,-30,270,0.07
1682,,A,Early Iron Age,4,-900,-750,150,0.2
1682,,A,Late Iron Age,5,-750,-580,170,0.2
1682,,A,Archaic Period,6,-580,-350,230,0.2
1682,,A,Republican Period,7,-350,-200,150,0.2
1683,,A,Late Iron Age,5,-600,-580,20,0.2
1683,,A,Archaic Period,6,-580,-400,180,0.2
1684,,A,Republican Period,7,-300,-30,270,1
1684,,A,Early Imperial Period,8,-30,100,130,1
1684,,A,Mid-Imperial Period,9,100,300,200,1
1684,,A,Late Imperial Period,10,300,500,200,1
1685,,A,Late Iron Age,5,-700,-580,120,0.039999999
1685,,A,Archaic Period,6,-580,-350,230,0.039999999
1685,,A,Republican Period,7,-350,-300,50,0.039999999
1686,,A,Mid-Imperial Period,9,200,300,100,0.029999999
1686,,A,Late Imperial Period,10,300,400,100,0.029999999
1687,,A,Republican Period,7,-300,-30,270,0.02
1687,,A,Early Imperial Period,8,-30,100,130,0.02
1688,,A,Republican Period,7,-300,-50,250,0.050000001
1689,,A,Late Iron Age,5,-700,-580,120,0.02
1689,,A,Archaic Period,6,-580,-400,180,0.02
1690,,A,Late Iron Age,5,-700,-580,120,1.2
1690,,A,Archaic Period,6,-580,-350,230,1.2
1690,,A,Republican Period,7,-350,-50,300,1.2
1691,,A,Late Iron Age,5,-700,-580,120,0.029999999
1691,,A,Archaic Period,6,-580,-400,180,0.029999999
1692,,A,Late Iron Age,5,-700,-580,120,0.039999999
1692,,A,Archaic Period,6,-580,-400,180,0.039999999
1693,,A,Late Iron Age,5,-700,-580,120,0.059999999
1693,,A,Archaic Period,6,-580,-400,180,0.059999999
1693,,B,Republican Period,7,-300,-200,100,0.059999999
1694,,A,Republican Period,7,-300,-30,270,0.1
1694,,A,Early Imperial Period,8,-30,100,130,0.1
1695,,A,Late Iron Age,5,-700,-580,120,0.039999999
1695,,A,Archaic Period,6,-580,-400,180,0.039999999
1696,,A,Archaic Period,6,-400,-350,50,3
1696,,A,Republican Period,7,-350,-30,320,3
1696,,A,Early Imperial Period,8,-30,100,130,3
1696,,A,Mid-Imperial Period,9,100,200,100,3
1697,,A,Republican Period,7,-200,-30,170,1
1697,,A,Early Imperial Period,8,-30,100,130,1
1697,,A,Mid-Imperial Period,9,100,300,200,1
1697,,A,Late Imperial Period,10,300,500,200,1
1698,,A,Republican Period,7,-200,-30,170,0.1
1698,,A,Early Imperial Period,8,-30,100,130,0.1
1699,,A,Republican Period,7,-300,-30,270,0.1
1700,,A,Republican Period,7,-50,-30,20,0.1
1700,,A,Early Imperial Period,8,-30,100,130,0.1
1700,,A,Mid-Imperial Period,9,100,300,200,0.1
1700,,A,Late Imperial Period,10,300,500,200,0.1
1701,,A,Republican Period,7,-200,-30,170,0.1
1701,,A,Early Imperial Period,8,-30,100,130,0.1
1701,,A,Mid-Imperial Period,9,100,200,100,0.1
1702,,A,Republican Period,7,-300,-30,270,0.1
1702,,A,Early Imperial Period,8,-30,100,130,0.1
1703,,A,Republican Period,7,-50,-30,20,0.1
1703,,A,Early Imperial Period,8,-30,100,130,0.1
1704,,A,Republican Period,7,-200,-30,170,0.02
1704,,A,Early Imperial Period,8,-30,100,130,0.02
1705,,A,Republican Period,7,-200,-30,170,0.079999998
1705,,A,Early Imperial Period,8,-30,100,130,0.079999998
1706,,A,Republican Period,7,-200,-30,170,0.059999999
1706,,A,Early Imperial Period,8,-30,100,130,0.059999999
1706,,A,Mid-Imperial Period,9,100,300,200,0.059999999
1706,,A,Late Imperial Period,10,300,400,100,0.059999999
1707,,A,Republican Period,7,-200,-30,170,0.039999999
1707,,A,Early Imperial Period,8,-30,100,130,0.039999999
1707,,A,Mid-Imperial Period,9,100,200,100,0.039999999
1708,,A,Republican Period,7,-50,-30,20,0.059999999
1708,,A,Early Imperial Period,8,-30,100,130,0.059999999
1708,,A,Mid-Imperial Period,9,100,200,100,0.059999999
1709,,A,Archaic Period,6,-500,-400,100,0.1
1709,,B,Republican Period,7,-300,-30,270,0.1
1709,,B,Early Imperial Period,8,-30,100,130,0.1
1709,,B,Mid-Imperial Period,9,100,300,200,0.1
1709,,B,Late Imperial Period,10,300,400,100,0.1
1710,,A,Republican Period,7,-50,-30,20,0.2
1710,,A,Early Imperial Period,8,-30,100,130,0.2
1710,,A,Mid-Imperial Period,9,100,300,200,0.2
1710,,A,Late Imperial Period,10,300,400,100,0.2
1711,,A,Republican Period,7,-50,-30,20,0.1
1711,,A,Early Imperial Period,8,-30,100,130,0.1
1711,,A,Mid-Imperial Period,9,100,200,100,0.1
1712,,A,Late Iron Age,5,-700,-580,120,0.30000001
1712,,A,Archaic Period,6,-580,-500,80,0.30000001
1712,,B,Republican Period,7,-200,-30,170,0.30000001
1712,,B,Early Imperial Period,8,-30,100,130,0.30000001
1712,,B,Mid-Imperial Period,9,100,200,100,0.30000001
1713,,A,Late Iron Age,5,-700,-580,120,0.1
1713,,A,Archaic Period,6,-580,-350,230,0.1
1713,,A,Republican Period,7,-350,-300,50,0.1
1714,,A,Republican Period,7,-200,-50,150,0.1
1715,,A,Republican Period,7,-200,-50,150,0.059999999
1716,,A,Archaic Period,6,-400,-350,50,1.8
1716,,A,Republican Period,7,-350,-300,50,1.8
1717,,A,Republican Period,7,-200,-50,150,0.1
1718,,A,Republican Period,7,-200,-30,170,1.2
1718,,A,Early Imperial Period,8,-30,100,130,1.2
1718,,A,Mid-Imperial Period,9,100,200,100,1.2
1719,,A,Republican Period,7,-50,-30,20,0.1
1719,,A,Early Imperial Period,8,-30,100,130,0.1
1719,,A,Mid-Imperial Period,9,100,200,100,0.1
1720,,A,Republican Period,7,-50,-30,20,0.039999999
1720,,A,Early Imperial Period,8,-30,100,130,0.039999999
1721,,A,Republican Period,7,-200,-30,170,0.039999999
1721,,A,Early Imperial Period,8,-30,100,130,0.039999999
1721,,A,Mid-Imperial Period,9,100,200,100,0.039999999
1722,,A,Republican Period,7,-200,-30,170,0.059999999
1722,,A,Early Imperial Period,8,-30,100,130,0.059999999
1723,,A,Republican Period,7,-200,-30,170,0.029999999
1723,,A,Early Imperial Period,8,-30,100,130,0.029999999
1724,,A,Republican Period,7,-200,-50,150,0.02
1725,,A,Republican Period,7,-200,-30,170,0.02
1725,,A,Early Imperial Period,8,-30,100,130,0.02
1726,,A,Republican Period,7,-200,-30,170,0.02
1726,,A,Early Imperial Period,8,-30,100,130,0.02
1727,,A,Late Iron Age,5,-700,-580,120,0.30000001
1727,,A,Archaic Period,6,-580,-350,230,0.30000001
1727,,A,Republican Period,7,-350,-200,150,0.30000001
1728,,A,Republican Period,7,-300,-30,270,1.2
1728,,A,Early Imperial Period,8,-30,100,130,1.2
1728,,A,Mid-Imperial Period,9,100,300,200,1.2
1729,,A,Republican Period,7,-200,-30,170,1.2
1729,,A,Early Imperial Period,8,-30,100,130,1.2
1729,,A,Mid-Imperial Period,9,100,300,200,1.2
1729,,A,Late Imperial Period,10,300,500,200,1.2
1730,,A,Republican Period,7,-200,-30,170,0.2
1730,,A,Early Imperial Period,8,-30,100,130,0.2
1731,,A,Republican Period,7,-200,-30,170,1
1731,,A,Early Imperial Period,8,-30,100,130,1
1731,,A,Mid-Imperial Period,9,100,300,200,1
1731,,A,Late Imperial Period,10,300,500,200,1
1732,,A,Republican Period,7,-200,-30,170,2
1732,,A,Early Imperial Period,8,-30,100,130,2
1732,,A,Mid-Imperial Period,9,100,300,200,2
1732,,A,Late Imperial Period,10,300,500,200,2
1733,,A,Republican Period,7,-300,-30,270,0.029999999
1733,,A,Early Imperial Period,8,-30,100,130,0.029999999
1733,,A,Mid-Imperial Period,9,100,200,100,0.029999999
1734,,A,Republican Period,7,-50,-30,20,0.029999999
1734,,A,Early Imperial Period,8,-30,100,130,0.029999999
1735,,A,Republican Period,7,-200,-30,170,0.050000001
1735,,A,Early Imperial Period,8,-30,100,130,0.050000001
1736,,A,Republican Period,7,-200,-50,150,0.02
1736,,B,Early Imperial Period,8,-30,100,130,0.40000001
1736,,B,Mid-Imperial Period,9,100,300,200,0.40000001
1736,,B,Late Imperial Period,10,300,400,100,0.40000001
1737,,A,Republican Period,7,-300,-30,270,0.1
1737,,A,Early Imperial Period,8,-30,100,130,0.1
1737,,A,Mid-Imperial Period,9,100,300,200,0.1
1737,,A,Late Imperial Period,10,300,500,200,0.1
1738,,A,Late Iron Age,5,-700,-580,120,0.01
1738,,A,Archaic Period,6,-580,-500,80,0.01
1739,,A,Archaic Period,6,-400,-350,50,0.01
1739,,A,Republican Period,7,-350,-30,320,0.01
1739,,A,Early Imperial Period,8,-30,100,130,0.01
1739,,A,Mid-Imperial Period,9,100,200,100,0.01
1740,,A,Republican Period,7,-200,-30,170,0.029999999
1740,,A,Early Imperial Period,8,-30,100,130,0.029999999
1740,,A,Mid-Imperial Period,9,100,200,100,0.029999999
1741,,A,Republican Period,7,-200,-50,150,0.01
1742,,A,Republican Period,7,-200,-30,170,0.30000001
1742,,A,Early Imperial Period,8,-30,100,130,0.30000001
1743,,A,Republican Period,7,-300,-30,270,0.029999999
1743,,A,Early Imperial Period,8,-30,100,130,0.029999999
1743,,A,Mid-Imperial Period,9,100,300,200,0.029999999
1744,,A,Republican Period,7,-50,-30,20,0.050000001
1744,,A,Early Imperial Period,8,-30,100,130,0.050000001
1745,,A,Republican Period,7,-200,-30,170,0.02
1745,,A,Early Imperial Period,8,-30,100,130,0.02
1745,,A,Mid-Imperial Period,9,100,300,200,0.02
1746,,A,Republican Period,7,-200,-30,170,0.039999999
1746,,A,Early Imperial Period,8,-30,100,130,0.039999999
1746,,A,Mid-Imperial Period,9,100,200,100,0.039999999
1747,,A,Republican Period,7,-200,-30,170,0.02
1747,,A,Early Imperial Period,8,-30,100,130,0.02
1748,,A,Late Iron Age,5,-700,-580,120,2
1748,,A,Archaic Period,6,-580,-350,230,2
1748,,A,Republican Period,7,-350,-30,320,2
1748,,A,Early Imperial Period,8,-30,100,130,2
1749,,A,Republican Period,7,-300,-200,100,0.01
1750,,A,Republican Period,7,-300,-200,100,0.059999999
1751,,A,Late Iron Age,5,-700,-580,120,0.02
1751,,A,Archaic Period,6,-580,-400,180,0.02
1752,,A,Late Iron Age,5,-700,-580,120,0.02
1752,,A,Archaic Period,6,-580,-350,230,0.02
1752,,A,Republican Period,7,-350,-300,50,0.02
1753,Casale Tartuchino,A,Late Iron Age,5,-700,-580,120,0.30000001
1753,Casale Tartuchino,A,Archaic Period,6,-580,-350,230,0.30000001
1753,Casale Tartuchino,A,Republican Period,7,-350,-300,50,0.30000001
1754,,A,Republican Period,7,-200,-30,170,1
1754,,A,Early Imperial Period,8,-30,100,130,1
1755,,A,Republican Period,7,-200,-30,170,1
1755,,A,Early Imperial Period,8,-30,100,130,1
1755,,A,Mid-Imperial Period,9,100,300,200,1
1755,,A,Late Imperial Period,10,300,500,200,1
1756,,A,Republican Period,7,-200,-30,170,0.1
1756,,A,Early Imperial Period,8,-30,100,130,0.1
1756,,A,Mid-Imperial Period,9,100,200,100,0.1
1757,,A,Republican Period,7,-50,-30,20,0.40000001
1757,,A,Early Imperial Period,8,-30,100,130,0.40000001
1757,,A,Mid-Imperial Period,9,100,300,200,0.40000001
1757,,A,Late Imperial Period,10,300,400,100,0.40000001
1758,,A,Republican Period,7,-200,-30,170,0.30000001
1758,,A,Early Imperial Period,8,-30,100,130,0.30000001
1759,Heba,A,Republican Period,7,-200,-30,170,14
1759,Heba,A,Early Imperial Period,8,-30,100,130,14
1759,Heba,A,Mid-Imperial Period,9,100,300,200,14
1759,Heba,A,Late Imperial Period,10,300,400,100,14
1760,,A,Late Iron Age,5,-700,-580,120,0.029999999
1760,,A,Archaic Period,6,-580,-350,230,0.029999999
1760,,A,Republican Period,7,-350,-300,50,0.029999999
1761,,A,Republican Period,7,-300,-30,270,0.02
1761,,A,Early Imperial Period,8,-30,100,130,0.02
1762,,A,Republican Period,7,-200,-30,170,0.039999999
1762,,A,Early Imperial Period,8,-30,100,130,0.039999999
1762,,A,Mid-Imperial Period,9,100,200,100,0.039999999
1763,,A,Republican Period,7,-200,-30,170,1
1763,,A,Early Imperial Period,8,-30,100,130,1
1763,,A,Mid-Imperial Period,9,100,300,200,1
1764,,A,Republican Period,7,-300,-50,250,0.1
1765,Doganella,A,Late Iron Age,5,-700,-580,120,140
1765,Doganella,A,Archaic Period,6,-580,-350,230,140
1765,Doganella,A,Republican Period,7,-350,-300,50,140
1766,,A,Republican Period,7,-50,-30,20,0.039999999
1766,,A,Early Imperial Period,8,-30,100,130,0.039999999
1767,,A,Archaic Period,6,-500,-350,150,0.5
1767,,A,Republican Period,7,-350,-30,320,0.5
1767,,A,Early Imperial Period,8,-30,100,130,0.5
1767,,A,Mid-Imperial Period,9,100,200,100,0.5
1768,,A,Republican Period,7,-300,-30,270,0.059999999
1768,,A,Early Imperial Period,8,-30,100,130,0.059999999
1768,,A,Mid-Imperial Period,9,100,200,100,0.059999999
1769,,A,Late Iron Age,5,-700,-580,120,0.2
1769,,A,Archaic Period,6,-580,-350,230,0.2
1769,,A,Republican Period,7,-350,-200,150,0.2
1770,,A,Republican Period,7,-200,-30,170,2
1770,,A,Early Imperial Period,8,-30,100,130,2
1770,,A,Mid-Imperial Period,9,100,300,200,2
1770,,A,Late Imperial Period,10,300,500,200,2
1771,,A,Republican Period,7,-200,-30,170,1.5
1771,,A,Early Imperial Period,8,-30,100,130,1.5
1771,,A,Mid-Imperial Period,9,100,300,200,1.5
1772,,A,Republican Period,7,-200,-30,170,0.1
1772,,A,Early Imperial Period,8,-30,100,130,0.1
1773,,A,Republican Period,7,-200,-30,170,0.059999999
1773,,A,Early Imperial Period,8,-30,100,130,0.059999999
1773,,A,Mid-Imperial Period,9,100,300,200,0.059999999
1774,,A,Archaic Period,6,-500,-400,100,0.079999998
1775,,A,Late Iron Age,5,-700,-580,120,0.02
1775,,A,Archaic Period,6,-580,-500,80,0.02
1776,,A,Republican Period,7,-200,-30,170,1.5
1776,,A,Early Imperial Period,8,-30,100,130,1.5
1776,,A,Mid-Imperial Period,9,100,300,200,1.5
1776,,A,Late Imperial Period,10,300,500,200,1.5
1777,,A,Republican Period,7,-200,-30,170,0.30000001
1777,,A,Early Imperial Period,8,-30,100,130,0.30000001
1778,,A,Republican Period,7,-200,-30,170,0.1
1778,,A,Early Imperial Period,8,-30,100,130,0.1
1779,,A,Republican Period,7,-50,-30,20,1
1779,,A,Early Imperial Period,8,-30,100,130,1
1780,,A,Republican Period,7,-300,-30,270,2
1780,,A,Early Imperial Period,8,-30,100,130,2
1780,,A,Mid-Imperial Period,9,100,200,100,2
1781,,A,Republican Period,7,-300,-30,270,1
1781,,A,Early Imperial Period,8,-30,100,130,1
1781,,A,Mid-Imperial Period,9,100,200,100,1
1782,,A,Republican Period,7,-200,-30,170,1
1782,,A,Early Imperial Period,8,-30,100,130,1
1782,,A,Mid-Imperial Period,9,100,300,200,1
1782,,A,Late Imperial Period,10,300,500,200,1
1783,,A,Late Iron Age,5,-700,-580,120,0.029999999
1783,,A,Archaic Period,6,-580,-350,230,0.029999999
1783,,A,Republican Period,7,-350,-300,50,0.029999999
1784,,A,Republican Period,7,-200,-30,170,0.1
1784,,A,Early Imperial Period,8,-30,100,130,0.1
1784,,A,Mid-Imperial Period,9,100,200,100,0.1
1785,,A,Republican Period,7,-200,-30,170,1.5
1785,,A,Early Imperial Period,8,-30,100,130,1.5
1785,,A,Mid-Imperial Period,9,100,300,200,1.5
1785,,A,Late Imperial Period,10,300,500,200,1.5
1786,,A,Republican Period,7,-200,-30,170,0.1
1786,,A,Early Imperial Period,8,-30,100,130,0.1
1786,,A,Mid-Imperial Period,9,100,300,200,0.1
1786,,A,Late Imperial Period,10,300,400,100,0.1
1787,,A,Republican Period,7,-200,-30,170,0.40000001
1787,,A,Early Imperial Period,8,-30,100,130,0.40000001
1787,,A,Mid-Imperial Period,9,100,300,200,0.40000001
1787,,A,Late Imperial Period,10,300,500,200,0.40000001
1788,,A,Republican Period,7,-200,-30,170,0.1
1788,,A,Early Imperial Period,8,-30,100,130,0.1
1788,,A,Mid-Imperial Period,9,100,300,200,0.1
1788,,A,Late Imperial Period,10,300,500,200,0.1
1789,,A,Republican Period,7,-50,-30,20,0.1
1789,,A,Early Imperial Period,8,-30,100,130,0.1
1789,,A,Mid-Imperial Period,9,100,300,200,0.1
1789,,A,Late Imperial Period,10,300,500,200,0.1
1790,,A,Republican Period,7,-300,-50,250,0.039999999
1791,,A,Republican Period,7,-200,-30,170,0.029999999
1791,,A,Early Imperial Period,8,-30,100,130,0.029999999
1791,,A,Mid-Imperial Period,9,100,200,100,0.029999999
1792,,A,Late Iron Age,5,-700,-580,120,0.059999999
1792,,A,Archaic Period,6,-580,-350,230,0.059999999
1792,,B,Republican Period,7,-350,-30,320,0.029999999
1792,,B,Early Imperial Period,8,-30,100,130,0.029999999
1792,,B,Mid-Imperial Period,9,100,200,100,0.029999999
1793,,A,Late Iron Age,5,-700,-580,120,0.1
1793,,A,Archaic Period,6,-580,-350,230,0.1
1793,,A,Republican Period,7,-350,-300,50,0.1
1794,,A,Archaic Period,6,-400,-350,50,0.30000001
1794,,A,Republican Period,7,-350,-30,320,0.30000001
1794,,A,Early Imperial Period,8,-30,100,130,0.30000001
1794,,A,Mid-Imperial Period,9,100,200,100,0.30000001
1795,,A,Late Iron Age,5,-700,-580,120,0.029999999
1795,,A,Archaic Period,6,-580,-500,80,0.029999999
1796,,A,Republican Period,7,-200,-30,170,0.2
1796,,A,Early Imperial Period,8,-30,100,130,0.2
1796,,A,Mid-Imperial Period,9,100,300,200,0.2
1796,,A,Late Imperial Period,10,300,400,100,0.2
1797,,A,Republican Period,7,-200,-30,170,0.80000001
1797,,A,Early Imperial Period,8,-30,100,130,0.80000001
1797,,A,Mid-Imperial Period,9,100,300,200,0.80000001
1797,,A,Late Imperial Period,10,300,400,100,0.80000001
1798,,A,Late Iron Age,5,-700,-580,120,0.079999998
1798,,A,Archaic Period,6,-580,-350,230,0.079999998
1798,,A,Republican Period,7,-350,-300,50,0.079999998
1799,,A,Late Iron Age,5,-700,-580,120,0.039999999
1799,,A,Archaic Period,6,-580,-350,230,0.039999999
1799,,A,Republican Period,7,-350,-200,150,0.039999999
1800,,A,Archaic Period,6,-400,-350,50,0.050000001
1800,,A,Republican Period,7,-350,-200,150,0.050000001
1801,,A,Republican Period,7,-50,-30,20,1.5
1801,,A,Early Imperial Period,8,-30,100,130,1.5
1801,,A,Mid-Imperial Period,9,100,300,200,1.5
1801,,A,Late Imperial Period,10,300,500,200,1.5
1802,,A,Republican Period,7,-50,-30,20,0.1
1802,,A,Early Imperial Period,8,-30,100,130,0.1
1803,,A,Republican Period,7,-200,-30,170,0.40000001
1803,,A,Early Imperial Period,8,-30,100,130,0.40000001
1804,,A,Republican Period,7,-200,-30,170,1.5
1804,,A,Early Imperial Period,8,-30,100,130,1.5
1805,,A,Late Iron Age,5,-700,-580,120,0.1
1805,,A,Archaic Period,6,-580,-500,80,0.1
1806,,A,Republican Period,7,-200,-30,170,0.30000001
1806,,A,Early Imperial Period,8,-30,100,130,0.30000001
1806,,A,Mid-Imperial Period,9,100,300,200,0.30000001
1806,,A,Late Imperial Period,10,300,400,100,0.30000001
1807,,A,Republican Period,7,-200,-30,170,0.2
1807,,A,Early Imperial Period,8,-30,100,130,0.2
1807,,A,Mid-Imperial Period,9,100,200,100,0.2
1808,,A,Republican Period,7,-200,-30,170,0.02
1808,,A,Early Imperial Period,8,-30,100,130,0.02
1808,,A,Mid-Imperial Period,9,100,200,100,0.02
1809,,A,Republican Period,7,-200,-50,150,0.1
1810,,A,Republican Period,7,-200,-30,170,0.079999998
1810,,A,Early Imperial Period,8,-30,100,130,0.079999998
1810,,A,Mid-Imperial Period,9,100,200,100,0.079999998
1811,,A,Republican Period,7,-200,-30,170,0.30000001
1811,,A,Early Imperial Period,8,-30,100,130,0.30000001
1811,,A,Mid-Imperial Period,9,100,200,100,0.30000001
1812,,A,Republican Period,7,-200,-30,170,0.40000001
1812,,A,Early Imperial Period,8,-30,100,130,0.40000001
1812,,A,Mid-Imperial Period,9,100,200,100,0.40000001
1813,,A,Republican Period,7,-200,-30,170,0.1
1813,,A,Early Imperial Period,8,-30,100,130,0.1
1813,,A,Mid-Imperial Period,9,100,200,100,0.1
1814,,A,Republican Period,7,-200,-30,170,0.059999999
1814,,A,Early Imperial Period,8,-30,100,130,0.059999999
1814,,A,Mid-Imperial Period,9,100,200,100,0.059999999
1815,,A,Republican Period,7,-50,-30,20,0.059999999
1815,,A,Early Imperial Period,8,-30,100,130,0.059999999
1815,,A,Mid-Imperial Period,9,100,200,100,0.059999999
1816,,A,Republican Period,7,-200,-30,170,0.02
1816,,A,Early Imperial Period,8,-30,100,130,0.02
1817,,A,Republican Period,7,-200,-30,170,0.01
1817,,A,Early Imperial Period,8,-30,100,130,0.01
1818,,A,Republican Period,7,-200,-30,170,0.30000001
1818,,A,Early Imperial Period,8,-30,100,130,0.30000001
1818,,A,Mid-Imperial Period,9,100,200,100,0.30000001
1819,,A,Republican Period,7,-200,-30,170,0.050000001
1819,,A,Early Imperial Period,8,-30,100,130,0.050000001
1820,,A,Late Iron Age,5,-700,-580,120,0.2
1820,,A,Archaic Period,6,-580,-350,230,0.2
1820,,A,Republican Period,7,-350,-200,150,0.2
1821,,A,Republican Period,7,-50,-30,20,0.1
1821,,A,Early Imperial Period,8,-30,100,130,0.1
1823,,A,Republican Period,7,-200,-30,170,0.02
1823,,A,Early Imperial Period,8,-30,100,130,0.02
1823,,A,Mid-Imperial Period,9,100,200,100,0.02
1824,,A,Republican Period,7,-200,-30,170,0.02
1824,,A,Early Imperial Period,8,-30,100,130,0.02
1825,,A,Republican Period,7,-50,-30,20,0.30000001
1825,,A,Early Imperial Period,8,-30,100,130,0.30000001
1826,,A,Republican Period,7,-200,-30,170,0.079999998
1826,,A,Early Imperial Period,8,-30,100,130,0.079999998
1827,,A,Republican Period,7,-200,-30,170,0.1
1827,,A,Early Imperial Period,8,-30,100,130,0.1
1828,,A,Republican Period,7,-200,-30,170,0.079999998
1828,,A,Early Imperial Period,8,-30,100,130,0.079999998
1828,,A,Mid-Imperial Period,9,100,200,100,0.079999998
1829,,A,Republican Period,7,-50,-30,20,0.079999998
1829,,A,Early Imperial Period,8,-30,100,130,0.079999998
1830,,A,Mid-Imperial Period,9,100,200,100,0.029999999
1831,,A,Republican Period,7,-200,-30,170,0.029999999
1831,,A,Early Imperial Period,8,-30,100,130,0.029999999
1832,,A,Republican Period,7,-200,-30,170,0.1
1832,,A,Early Imperial Period,8,-30,100,130,0.1
1832,,A,Mid-Imperial Period,9,100,200,100,0.1
1833,,A,Republican Period,7,-50,-30,20,0.1
1833,,A,Early Imperial Period,8,-30,100,130,0.1
1833,,A,Mid-Imperial Period,9,100,200,100,0.1
1834,,A,Republican Period,7,-200,-50,150,0.02
1835,Madonna delle Grazie,A,Republican Period,7,-50,-30,20,4
1835,Madonna delle Grazie,A,Early Imperial Period,8,-30,100,130,4
1835,Madonna delle Grazie,A,Mid-Imperial Period,9,100,300,200,4
1835,Madonna delle Grazie,A,Late Imperial Period,10,300,500,200,4
1836,,A,Archaic Period,6,-500,-400,100,0.02
1836,,B,Republican Period,7,-200,-30,170,0.30000001
1836,,B,Early Imperial Period,8,-30,100,130,0.30000001
1836,,B,Mid-Imperial Period,9,100,200,100,0.30000001
1837,,A,Republican Period,7,-300,-50,250,0.02
1838,,A,Late Iron Age,5,-700,-580,120,10
1838,,A,Archaic Period,6,-580,-400,180,10
1839,,A,Republican Period,7,-200,-30,170,0.2
1839,,A,Early Imperial Period,8,-30,100,130,0.2
1839,,A,Mid-Imperial Period,9,100,200,100,0.2
1840,,A,Republican Period,7,-50,-30,20,0.1
1840,,A,Early Imperial Period,8,-30,100,130,0.1
1840,,A,Mid-Imperial Period,9,100,200,100,0.1
1841,,A,Republican Period,7,-200,-30,170,0.40000001
1841,,A,Early Imperial Period,8,-30,100,130,0.40000001
1841,,A,Mid-Imperial Period,9,100,200,100,0.40000001
1842,,A,Republican Period,7,-50,-30,20,0.2
1842,,A,Early Imperial Period,8,-30,100,130,0.2
1842,,A,Mid-Imperial Period,9,100,200,100,0.2
1843,,A,Republican Period,7,-300,-30,270,0.30000001
1843,,A,Early Imperial Period,8,-30,100,130,0.30000001
1843,,A,Mid-Imperial Period,9,100,200,100,0.30000001
1844,,A,Republican Period,7,-200,-30,170,4
1844,,A,Early Imperial Period,8,-30,100,130,4
1844,,A,Mid-Imperial Period,9,100,200,100,4
1845,,A,Republican Period,7,-50,-30,20,4
1845,,A,Early Imperial Period,8,-30,100,130,4
1846,,A,Republican Period,7,-300,-30,270,0.039999999
1846,,A,Early Imperial Period,8,-30,100,130,0.039999999
1847,,A,Republican Period,7,-300,-30,270,0.039999999
1847,,A,Early Imperial Period,8,-30,100,130,0.039999999
1848,,A,Republican Period,7,-200,-30,170,0.07
1848,,A,Early Imperial Period,8,-30,100,130,0.07
1849,,A,Republican Period,7,-200,-30,170,0.059999999
1849,,A,Early Imperial Period,8,-30,100,130,0.059999999
1850,,A,Republican Period,7,-200,-30,170,0.40000001
1850,,A,Early Imperial Period,8,-30,100,130,0.40000001
1851,,A,Republican Period,7,-300,-30,270,0.079999998
1851,,A,Early Imperial Period,8,-30,100,130,0.079999998
1851,,A,Mid-Imperial Period,9,100,200,100,0.079999998
1852,,A,Republican Period,7,-300,-30,270,1
1852,,A,Early Imperial Period,8,-30,100,130,1
1852,,A,Mid-Imperial Period,9,100,200,100,1
1853,,A,Republican Period,7,-300,-50,250,0.050000001
1854,,A,Late Iron Age,5,-700,-580,120,1
1854,,A,Archaic Period,6,-580,-350,230,1
1854,,A,Republican Period,7,-350,-200,150,1
1855,,A,Republican Period,7,-300,-30,270,0.1
1855,,A,Early Imperial Period,8,-30,100,130,0.1
1856,,A,Republican Period,7,-300,-30,270,0.1
1856,,A,Early Imperial Period,8,-30,100,130,0.1
1856,,A,Mid-Imperial Period,9,100,200,100,0.1
1857,,A,Republican Period,7,-200,-30,170,2
1857,,A,Early Imperial Period,8,-30,100,130,2
1857,,A,Mid-Imperial Period,9,100,300,200,2
1857,,A,Late Imperial Period,10,300,500,200,2
1858,,A,Republican Period,7,-50,-30,20,0.059999999
1858,,A,Early Imperial Period,8,-30,100,130,0.059999999
1859,,A,Republican Period,7,-200,-50,150,0.30000001
1860,,A,Republican Period,7,-200,-30,170,0.2
1860,,A,Early Imperial Period,8,-30,100,130,0.2
1860,,A,Mid-Imperial Period,9,100,200,100,0.2
1861,,A,Republican Period,7,-300,-200,100,0.039999999
1862,,A,Republican Period,7,-300,-50,250,0.02
1863,,A,Republican Period,7,-50,-30,20,0.40000001
1863,,A,Early Imperial Period,8,-30,100,130,0.40000001
1863,,A,Mid-Imperial Period,9,100,300,200,0.40000001
1863,,A,Late Imperial Period,10,300,500,200,0.40000001
1864,,A,Republican Period,7,-50,-30,20,1.2
1864,,A,Early Imperial Period,8,-30,100,130,1.2
1864,,A,Mid-Imperial Period,9,100,300,200,1.2
1865,,A,Republican Period,7,-200,-30,170,0.30000001
1865,,A,Early Imperial Period,8,-30,100,130,0.30000001
1866,,A,Late Iron Age,5,-700,-580,120,0.30000001
1866,,A,Archaic Period,6,-580,-500,80,0.30000001
1867,,A,Republican Period,7,-300,-50,250,0.01
1868,,A,Republican Period,7,-300,-50,250,0.02
1869,,A,Republican Period,7,-300,-50,250,0.02
1870,,A,Republican Period,7,-300,-50,250,0.02
1871,,A,Republican Period,7,-200,-50,150,0.059999999
1872,,A,Republican Period,7,-200,-50,150,0.039999999
1873,,A,Republican Period,7,-300,-50,250,0.1
1874,,A,Republican Period,7,-300,-30,270,0.039999999
1874,,A,Early Imperial Period,8,-30,100,130,0.039999999
1875,,A,Republican Period,7,-200,-50,150,0.039999999
1876,,A,Republican Period,7,-300,-50,250,0.039999999
1877,,A,Republican Period,7,-200,-30,170,0.30000001
1877,,A,Early Imperial Period,8,-30,100,130,0.30000001
1878,,A,Republican Period,7,-200,-50,150,0.40000001
1879,,A,Republican Period,7,-300,-30,270,0.1
1879,,A,Early Imperial Period,8,-30,100,130,0.1
1879,,A,Mid-Imperial Period,9,100,300,200,0.1
1880,,A,Republican Period,7,-300,-30,270,0.1
1880,,A,Early Imperial Period,8,-30,100,130,0.1
1881,,A,Republican Period,7,-200,-30,170,0.1
1881,,A,Early Imperial Period,8,-30,100,130,0.1
1881,,A,Mid-Imperial Period,9,100,200,100,0.1
1882,,A,Republican Period,7,-300,-30,270,0.1
1882,,A,Early Imperial Period,8,-30,100,130,0.1
1883,,A,Late Iron Age,5,-700,-580,120,0.30000001
1883,,A,Archaic Period,6,-580,-350,230,0.30000001
1883,,A,Republican Period,7,-350,-200,150,0.30000001
1884,,A,Republican Period,7,-200,-50,150,0.1
1885,,A,Republican Period,7,-200,-30,170,0.1
1885,,A,Early Imperial Period,8,-30,100,130,0.1
1885,,A,Mid-Imperial Period,9,100,300,200,0.1
1886,,A,Republican Period,7,-200,-30,170,0.02
1886,,A,Early Imperial Period,8,-30,100,130,0.02
1886,,A,Mid-Imperial Period,9,100,200,100,0.02
1887,,A,Republican Period,7,-200,-30,170,0.1
1887,,A,Early Imperial Period,8,-30,100,130,0.1
1888,,A,Republican Period,7,-200,-30,170,0.1
1888,,A,Early Imperial Period,8,-30,100,130,0.1
1888,,A,Mid-Imperial Period,9,100,200,100,0.1
1889,,A,Republican Period,7,-200,-30,170,0.2
1889,,A,Early Imperial Period,8,-30,100,130,0.2
1890,,A,Republican Period,7,-200,-30,170,0.059999999
1890,,A,Early Imperial Period,8,-30,100,130,0.059999999
1890,,A,Mid-Imperial Period,9,100,200,100,0.059999999
1891,,A,Republican Period,7,-200,-30,170,0.059999999
1892,,A,Republican Period,7,-200,-50,150,0.059999999
1893,,A,Republican Period,7,-50,-30,20,0.2
1893,,A,Early Imperial Period,8,-30,100,130,0.2
1894,,A,Republican Period,7,-200,-30,170,0.059999999
1894,,A,Early Imperial Period,8,-30,100,130,0.059999999
1894,,A,Mid-Imperial Period,9,100,200,100,0.059999999
1895,,A,Archaic Period,6,-500,-350,150,0.039999999
1895,,A,Republican Period,7,-350,-300,50,0.039999999
1896,,A,Archaic Period,6,-500,-350,150,0.2
1896,,A,Republican Period,7,-350,-30,320,0.2
1896,,A,Early Imperial Period,8,-30,100,130,0.2
1896,,A,Mid-Imperial Period,9,100,300,200,0.2
1897,,A,Late Iron Age,5,-700,-580,120,0.1
1897,,A,Archaic Period,6,-580,-500,80,0.1
1898,,A,Republican Period,7,-200,-30,170,0.059999999
1899,,A,Late Iron Age,5,-700,-580,120,0.2
1899,,A,Archaic Period,6,-580,-350,230,0.2
1899,,A,Republican Period,7,-350,-300,50,0.2
1900,,A,Late Iron Age,5,-700,-580,120,0.079999998
1900,,A,Archaic Period,6,-580,-400,180,0.079999998
1901,,A,Republican Period,7,-50,-30,20,0.30000001
1901,,A,Early Imperial Period,8,-30,100,130,0.30000001
1902,,A,Archaic Period,6,-500,-350,150,0.2
1902,,A,Republican Period,7,-350,-50,300,0.2
1903,,A,Late Iron Age,5,-700,-580,120,0.02
1903,,A,Archaic Period,6,-580,-350,230,0.02
1903,,A,Republican Period,7,-350,-300,50,0.02
1904,,A,Republican Period,7,-200,-30,170,0.1
1904,,A,Early Imperial Period,8,-30,100,130,0.1
1904,,A,Mid-Imperial Period,9,100,200,100,0.1
1905,,A,Republican Period,7,-200,-30,170,0.5
1905,,A,Early Imperial Period,8,-30,100,130,0.5
1905,,A,Mid-Imperial Period,9,100,200,100,0.5
1906,,A,Republican Period,7,-200,-30,170,0.30000001
1906,,A,Early Imperial Period,8,-30,100,130,0.30000001
1906,,A,Mid-Imperial Period,9,100,200,100,0.30000001
1907,,A,Republican Period,7,-200,-30,170,0.079999998
1908,,A,Archaic Period,6,-400,-350,50,0.1
1908,,A,Republican Period,7,-350,-30,320,0.1
1908,,A,Early Imperial Period,8,-30,100,130,0.1
1909,,A,Republican Period,7,-200,-30,170,0.1
1910,,A,Republican Period,7,-200,-50,150,0.30000001
1911,,A,Republican Period,7,-200,-30,170,0.07
1911,,B,Early Imperial Period,8,30,100,70,0.07
1911,,B,Mid-Imperial Period,9,100,200,100,0.07
1912,,A,Republican Period,7,-200,-50,150,0.2
1913,,A,Republican Period,7,-50,-30,20,0.1
1913,,A,Early Imperial Period,8,-30,100,130,0.1
1914,,A,Republican Period,7,-300,-30,270,0.1
1914,,A,Early Imperial Period,8,-30,100,130,0.1
1914,,A,Mid-Imperial Period,9,100,300,200,0.1
1914,,A,Late Imperial Period,10,300,500,200,0.1
1915,,A,Republican Period,7,-300,-50,250,0.059999999
1916,,A,Republican Period,7,-200,-30,170,0.02
1916,,A,Early Imperial Period,8,-30,100,130,0.02
1917,,A,Republican Period,7,-300,-30,270,0.1
1917,,A,Early Imperial Period,8,-30,100,130,0.1
1918,,A,Late Iron Age,5,-700,-580,120,0.039999999
1918,,A,Archaic Period,6,-580,-400,180,0.039999999
1919,,A,Late Iron Age,5,-700,-580,120,0.039999999
1919,,A,Archaic Period,6,-580,-350,230,0.039999999
1919,,A,Republican Period,7,-350,-300,50,0.039999999
1920,,A,Late Iron Age,5,-700,-580,120,0.079999998
1920,,A,Archaic Period,6,-580,-400,180,0.079999998
1921,,A,Late Iron Age,5,-700,-580,120,0.1
1921,,A,Archaic Period,6,-580,-350,230,0.1
1921,,A,Republican Period,7,-350,-50,300,0.1
1922,,A,Late Iron Age,5,-700,-580,120,0.1
1922,,A,Archaic Period,6,-580,-400,180,0.1
1923,,A,Late Iron Age,5,-700,-580,120,0.02
1923,,A,Archaic Period,6,-580,-500,80,0.02
1924,,A,Republican Period,7,-200,-30,170,0.050000001
1924,,A,Early Imperial Period,8,-30,100,130,0.050000001
1924,,A,Mid-Imperial Period,9,100,300,200,0.050000001
1924,,A,Late Imperial Period,10,300,400,100,0.050000001
1925,,A,Republican Period,7,-200,-30,170,0.2
1925,,A,Early Imperial Period,8,-30,100,130,0.2
1925,,A,Mid-Imperial Period,9,100,200,100,0.2
1926,,A,Archaic Period,6,-400,-350,50,0.2
1926,,A,Republican Period,7,-350,-300,50,0.2
1927,,A,Republican Period,7,-300,-30,270,0.1
1927,,A,Early Imperial Period,8,-30,100,130,0.1
1928,,A,Republican Period,7,-50,-30,20,0.079999998
1928,,A,Early Imperial Period,8,-30,100,130,0.079999998
1928,,A,Mid-Imperial Period,9,100,200,100,0.079999998
1929,,A,Republican Period,7,-50,-30,20,0.1
1929,,A,Early Imperial Period,8,-30,100,130,0.1
1929,,A,Mid-Imperial Period,9,100,200,100,0.1
1930,,A,Republican Period,7,-200,-30,170,0.050000001
1930,,A,Early Imperial Period,8,-30,100,130,0.050000001
1930,,A,Mid-Imperial Period,9,100,200,100,0.050000001
1931,,A,Archaic Period,6,-400,-350,50,0.1
1931,,A,Republican Period,7,-350,-300,50,0.1
1932,,A,Republican Period,7,-200,-30,170,0.039999999
1932,,A,Early Imperial Period,8,-30,100,130,0.039999999
1932,,A,Mid-Imperial Period,9,100,200,100,0.039999999
1933,,A,Late Imperial Period,10,300,500,200,0.039999999
1934,,A,Republican Period,7,-200,-30,170,0.1
1934,,A,Early Imperial Period,8,-30,100,130,0.1
1935,,A,Late Iron Age,5,-700,-580,120,0.1
1935,,A,Archaic Period,6,-580,-500,80,0.1
1935,,B,Republican Period,7,-200,-50,150,0.1
1936,,A,Archaic Period,6,-400,-350,50,1
1936,,A,Republican Period,7,-350,-200,150,1
1937,,A,Late Iron Age,5,-700,-580,120,0.039999999
1937,,A,Archaic Period,6,-580,-350,230,0.039999999
1937,,A,Republican Period,7,-350,-30,320,0.039999999
1937,,A,Early Imperial Period,8,-30,100,130,0.039999999
1937,,A,Mid-Imperial Period,9,100,300,200,0.039999999
1938,,A,Republican Period,7,-50,-30,20,0.059999999
1938,,A,Early Imperial Period,8,-30,100,130,0.059999999
1938,,A,Mid-Imperial Period,9,100,300,200,0.059999999
1938,,A,Late Imperial Period,10,300,400,100,0.059999999
1939,,A,Late Iron Age,5,-700,-580,120,0.050000001
1939,,A,Archaic Period,6,-580,-400,180,0.050000001
1940,,A,Republican Period,7,-200,-50,150,0.059999999
1941,,A,Republican Period,7,-200,-30,170,0.059999999
1941,,A,Early Imperial Period,8,-30,100,130,0.059999999
1941,,A,Mid-Imperial Period,9,100,200,100,0.059999999
1942,,A,Late Iron Age,5,-700,-580,120,0.039999999
1942,,A,Archaic Period,6,-580,-400,180,0.039999999
1942,,B,Republican Period,7,-200,-30,170,0.039999999
1942,,B,Early Imperial Period,8,-30,100,130,0.039999999
1943,,A,Republican Period,7,-50,-30,20,0.029999999
1943,,A,Early Imperial Period,8,-30,100,130,0.029999999
1944,,A,Archaic Period,6,-500,-350,150,0.029999999
1944,,A,Republican Period,7,-350,-300,50,0.029999999
1945,,A,Republican Period,7,-50,-30,20,0.079999998
1945,,A,Early Imperial Period,8,-30,100,130,0.079999998
1946,,A,Archaic Period,6,-500,-400,100,0.079999998
1947,,A,Republican Period,7,-50,-30,20,0.1
1947,,A,Early Imperial Period,8,-30,100,130,0.1
1948,,A,Republican Period,7,-50,-30,20,0.2
1948,,A,Early Imperial Period,8,-30,100,130,0.2
1949,,A,Republican Period,7,-200,-30,170,0.1
1949,,A,Early Imperial Period,8,-30,100,130,0.1
1949,,A,Mid-Imperial Period,9,100,300,200,0.1
1949,,A,Late Imperial Period,10,300,400,100,0.1
1950,,A,Republican Period,7,-200,-30,170,0.1
1950,,A,Early Imperial Period,8,-30,100,130,0.1
1950,,A,Mid-Imperial Period,9,100,300,200,0.1
1950,,A,Late Imperial Period,10,300,400,100,0.1
1951,,A,Republican Period,7,-200,-30,170,0.1
1951,,A,Early Imperial Period,8,-30,100,130,0.1
1951,,A,Mid-Imperial Period,9,100,200,100,0.1
1952,,A,Republican Period,7,-50,-30,20,0.1
1952,,A,Early Imperial Period,8,-30,100,130,0.1
1952,,A,Mid-Imperial Period,9,100,300,200,0.1
1952,,A,Late Imperial Period,10,300,500,200,0.1
1953,,A,Republican Period,7,-300,-30,270,0.079999998
1953,,A,Early Imperial Period,8,-30,100,130,0.079999998
1953,,A,Mid-Imperial Period,9,100,200,100,0.079999998
1954,,A,Republican Period,7,-200,-30,170,0.039999999
1954,,A,Early Imperial Period,8,-30,100,130,0.039999999
1954,,A,Mid-Imperial Period,9,100,200,100,0.039999999
1955,,A,Republican Period,7,-200,-30,170,0.2
1955,,A,Early Imperial Period,8,-30,100,130,0.2
1955,,A,Mid-Imperial Period,9,100,200,100,0.2
1956,,A,Republican Period,7,-50,-30,20,0.079999998
1956,,A,Early Imperial Period,8,-30,100,130,0.079999998
1956,,A,Mid-Imperial Period,9,100,200,100,0.079999998
1957,,A,Republican Period,7,-50,-30,20,0.059999999
1957,,A,Early Imperial Period,8,-30,100,130,0.059999999
1957,,A,Mid-Imperial Period,9,100,300,200,0.059999999
1957,,A,Late Imperial Period,10,300,400,100,0.059999999
1958,,A,Late Iron Age,5,-700,-580,120,0.2
1958,,A,Archaic Period,6,-580,-350,230,0.2
1958,,A,Republican Period,7,-350,-50,300,0.2
1959,,A,Republican Period,7,-200,-30,170,0.1
1959,,A,Early Imperial Period,8,-30,100,130,0.1
1959,,A,Mid-Imperial Period,9,100,200,100,0.1
1960,,A,Republican Period,7,-200,-30,170,0.059999999
1960,,A,Early Imperial Period,8,-30,100,130,0.059999999
1960,,A,Mid-Imperial Period,9,100,300,200,0.059999999
1961,,A,Republican Period,7,-200,-30,170,0.059999999
1961,,A,Early Imperial Period,8,-30,100,130,0.059999999
1961,,A,Mid-Imperial Period,9,100,200,100,0.059999999
1962,,A,Archaic Period,6,-500,-350,150,0.039999999
1962,,A,Republican Period,7,-350,-300,50,0.039999999
1963,,A,Republican Period,7,-200,-30,170,0.1
1964,,A,Early Imperial Period,8,-30,100,130,0.1
1964,,A,Mid-Imperial Period,9,100,200,100,0.1
1965,,A,Republican Period,7,-200,-30,170,0.1
1965,,A,Early Imperial Period,8,-30,100,130,0.1
1965,,A,Mid-Imperial Period,9,100,200,100,0.1
1966,,A,Republican Period,7,-200,-30,170,0.079999998
1966,,A,Early Imperial Period,8,-30,100,130,0.079999998
1966,,A,Mid-Imperial Period,9,100,200,100,0.079999998
1967,,A,Late Iron Age,5,-700,-580,120,0.1
1967,,A,Archaic Period,6,-580,-350,230,0.1
1967,,A,Republican Period,7,-350,-300,50,0.1
1968,,A,Republican Period,7,-300,-50,250,0.1
1969,,A,Late Iron Age,5,-700,-580,120,0.079999998
1969,,A,Archaic Period,6,-580,-350,230,0.079999998
1969,,A,Republican Period,7,-350,-300,50,0.079999998
1970,,A,Late Iron Age,5,-700,-580,120,0.1
1970,,A,Archaic Period,6,-580,-350,230,0.1
1970,,A,Republican Period,7,-350,-50,300,0.1
1971,,A,Republican Period,7,-200,-30,170,0.1
1971,,A,Early Imperial Period,8,-30,100,130,0.1
1971,,A,Mid-Imperial Period,9,100,200,100,0.1
1972,,A,Republican Period,7,-50,-30,20,0.1
1972,,A,Early Imperial Period,8,-30,100,130,0.1
1972,,A,Mid-Imperial Period,9,100,200,100,0.1
1973,,A,Late Iron Age,5,-700,-580,120,0.079999998
1973,,A,Archaic Period,6,-580,-350,230,0.079999998
1973,,A,Republican Period,7,-350,-300,50,0.079999998
1974,,A,Late Iron Age,5,-700,-580,120,0.039999999
1974,,A,Archaic Period,6,-580,-350,230,0.039999999
1974,,A,Republican Period,7,-350,-300,50,0.039999999
1975,,A,Late Iron Age,5,-700,-580,120,0.039999999
1975,,A,Archaic Period,6,-580,-500,80,0.039999999
1976,,A,Late Iron Age,5,-700,-580,120,0.050000001
1976,,A,Archaic Period,6,-580,-350,230,0.050000001
1976,,A,Republican Period,7,-350,-50,300,0.050000001
1977,,A,Republican Period,7,-300,-30,270,0.1
1977,,A,Early Imperial Period,8,-30,100,130,0.1
1977,,A,Mid-Imperial Period,9,100,200,100,0.1
1978,,A,Mid-Imperial Period,9,100,300,200,0.059999999
1978,,A,Late Imperial Period,10,300,400,100,0.059999999
1979,,A,Late Iron Age,5,-700,-580,120,0.059999999
1979,,A,Archaic Period,6,-580,-500,80,0.059999999
1980,,A,Republican Period,7,-300,-30,270,0.079999998
1980,,A,Early Imperial Period,8,-30,100,130,0.079999998
1981,,A,Republican Period,7,-300,-50,250,0.059999999
1981,,B,Mid-Imperial Period,9,200,300,100,0.059999999
1981,,B,Late Imperial Period,10,300,400,100,0.059999999
1982,,A,Republican Period,7,-200,-30,170,0.1
1982,,A,Early Imperial Period,8,-30,100,130,0.1
1983,,A,Republican Period,7,-50,-30,20,0.050000001
1983,,A,Early Imperial Period,8,-30,100,130,0.050000001
1984,,A,Republican Period,7,-200,-30,170,0.059999999
1984,,A,Early Imperial Period,8,-30,100,130,0.059999999
1984,,A,Mid-Imperial Period,9,100,200,100,0.059999999
1985,,A,Republican Period,7,-200,-30,170,0.050000001
1985,,A,Early Imperial Period,8,-30,100,130,0.050000001
1985,,A,Mid-Imperial Period,9,100,200,100,0.050000001
1986,,A,Republican Period,7,-300,-30,270,0.1
1986,,A,Early Imperial Period,8,-30,100,130,0.1
1987,,A,Republican Period,7,-200,-30,170,0.69999999
1987,,A,Early Imperial Period,8,-30,100,130,0.69999999
1987,,A,Mid-Imperial Period,9,100,200,100,0.69999999
1988,,A,Republican Period,7,-50,-30,20,0.2
1988,,A,Early Imperial Period,8,-30,100,130,0.2
1988,,A,Mid-Imperial Period,9,100,300,200,0.2
1989,,A,Republican Period,7,-200,-30,170,0.059999999
1989,,A,Early Imperial Period,8,-30,100,130,0.059999999
1989,,A,Mid-Imperial Period,9,100,200,100,0.059999999
1990,,A,Archaic Period,6,-500,-350,150,0.2
1990,,A,Republican Period,7,-350,-300,50,0.2
1991,,A,Republican Period,7,-200,-50,150,0.1
1992,,A,Republican Period,7,-200,-30,170,0.1
1992,,A,Early Imperial Period,8,-30,100,130,0.1
1992,,A,Mid-Imperial Period,9,100,200,100,0.1
1993,,A,Republican Period,7,-200,-30,170,0.059999999
1993,,A,Early Imperial Period,8,-30,100,130,0.059999999
1993,,A,Mid-Imperial Period,9,100,300,200,0.059999999
1993,,A,Late Imperial Period,10,300,500,200,0.059999999
1994,,A,Republican Period,7,-200,-30,170,0.029999999
1994,,A,Early Imperial Period,8,-30,100,130,0.029999999
1995,,A,Mid-Imperial Period,9,200,300,100,0.029999999
1996,,A,Mid-Imperial Period,9,200,300,100,0.029999999
1997,,A,Republican Period,7,-200,-50,150,0.5
1998,,A,Republican Period,7,-300,-50,250,0.079999998
1999,,A,Republican Period,7,-300,-50,250,0.029999999
2000,,A,Republican Period,7,-300,-50,250,0.059999999
2001,Cosa,A,Republican Period,7,-273,-30,243,13.5
2001,Cosa,A,Early Imperial Period,8,-30,100,130,13.5
2001,Cosa,A,Mid-Imperial Period,9,100,300,200,13.5
2001,Cosa,A,Late Imperial Period,10,300,500,200,13.5
2008,Morelli,A,Republican Period,7,-300,-30,270,0.1
2008,Morelli,A,Early Imperial Period,8,-30,100,130,0.1
2008,Morelli,A,Mid-Imperial Period,9,100,300,200,0.1
2008,Morelli,A,Late Imperial Period,10,300,500,200,0.1
2012,Volpaia,A,Early Bronze Age,1,-2300,-1700,600,0.07
2012,Volpaia,A,Middle Bronze Age,2,-1700,-1300,400,0.07
2012,Volpaia,A,Late Bronze Age,3,-1300,-1020,280,0.07
2012,Volpaia,A,Early Iron Age,4,-1020,-1000,20,0.07
2022,Ponte a Greve,A,Early Bronze Age,1,-2300,-1700,600,0.1
2022,Ponte a Greve,A,Middle Bronze Age,2,-1700,-1350,350,0.1
2022,Ponte a Greve,B,Republican Period,7,-300,-30,270,0.1
2022,Ponte a Greve,B,Early Imperial Period,8,-30,100,130,0.1
2022,Ponte a Greve,B,Mid-Imperial Period,9,100,300,200,0.1
2022,Ponte a Greve,B,Late Imperial Period,10,300,500,200,0.1
2023,Buca del Leccio,A,Early Bronze Age,1,-2300,-1700,600,0.1
2057,Tufarelle,A,Early Bronze Age,1,-2300,-1700,600,0.1
2057,Tufarelle,A,Middle Bronze Age,2,-1700,-1300,400,0.1
2057,Tufarelle,A,Late Bronze Age,3,-1300,-1020,280,0.1
2057,Tufarelle,A,Early Iron Age,4,-1020,-900,120,0.1
2057,Tufarelle,B,Late Iron Age,5,-700,-580,120,0.1
2057,Tufarelle,B,Archaic Period,6,-580,-350,230,0.1
2057,Tufarelle,B,Republican Period,7,-350,-30,320,0.1
2057,Tufarelle,B,Early Imperial Period,8,-30,100,130,0.1
2057,Tufarelle,B,Mid-Imperial Period,9,100,300,200,0.1
2057,Tufarelle,B,Late Imperial Period,10,300,500,200,0.1
2058,Codata delle Macine,A,Early Bronze Age,1,-2300,-1700,600,0.1
2058,Codata delle Macine,A,Middle Bronze Age,2,-1700,-1300,400,0.1
2058,Codata delle Macine,A,Late Bronze Age,3,-1300,-1020,280,0.1
2058,Codata delle Macine,A,Early Iron Age,4,-1020,-900,120,0.1
2069,Bufalereccia,A,Early Bronze Age,1,-2300,-1700,600,0.1
2069,Bufalereccia,A,Middle Bronze Age,2,-1700,-1300,400,0.1
2069,Bufalereccia,A,Late Bronze Age,3,-1300,-1020,280,0.1
2069,Bufalereccia,A,Early Iron Age,4,-1020,-1000,20,0.1
2077,San Sebastiano,A,Republican Period,7,-200,-30,170,0.2
2077,San Sebastiano,A,Early Imperial Period,8,-30,100,130,0.2
2077,San Sebastiano,A,Mid-Imperial Period,9,100,300,200,0.2
2077,San Sebastiano,A,Late Imperial Period,10,300,500,200,0.2
2078,Festa,A,Republican Period,7,-250,-30,220,0.1
2078,Festa,A,Early Imperial Period,8,-30,100,130,0.1
2078,Festa,A,Mid-Imperial Period,9,100,300,200,0.1
2079,Foglia - I Monti,A,Archaic Period,6,-400,-350,50,0.039999999
2079,Foglia - I Monti,A,Republican Period,7,-350,-200,150,0.039999999
2080,Vocabolo San Sebastiano,A,Early Imperial Period,8,-30,100,130,0.059999999
2080,Vocabolo San Sebastiano,A,Mid-Imperial Period,9,100,300,200,0.059999999
2080,Vocabolo San Sebastiano,A,Late Imperial Period,10,300,500,200,0.059999999
2081,Foglia,A,Republican Period,7,-150,-30,120,0.029999999
2081,Foglia,A,Early Imperial Period,8,-30,100,130,0.029999999
2081,Foglia,A,Mid-Imperial Period,9,100,300,200,0.029999999
2082,Torretta,A,Mid-Imperial Period,9,100,300,200,0.029999999
2083,Murella,A,Republican Period,7,-300,-30,270,0.050000001
2083,Murella,A,Early Imperial Period,8,-30,100,130,0.050000001
2083,Murella,A,Mid-Imperial Period,9,100,300,200,0.050000001
2083,Murella,A,Late Imperial Period,10,300,500,200,0.050000001
2084,Vocabolo Casa Cantoniera,A,Early Imperial Period,8,1,100,99,0.1
2084,Vocabolo Casa Cantoniera,A,Mid-Imperial Period,9,100,200,100,0.1
2085,Macchia Grande,A,Early Imperial Period,8,-30,100,130,0.050000001
2085,Macchia Grande,A,Mid-Imperial Period,9,100,300,200,0.050000001
2085,Macchia Grande,A,Late Imperial Period,10,300,500,200,0.050000001
2086,Grapignano,A,Early Imperial Period,8,-30,100,130,0.1
2086,Grapignano,A,Mid-Imperial Period,9,100,300,200,0.1
2087,Monte Comune,A,Republican Period,7,-150,-30,120,0.1
2087,Monte Comune,A,Early Imperial Period,8,-30,100,130,0.1
2087,Monte Comune,A,Mid-Imperial Period,9,100,300,200,0.1
2088,Torretta,A,Republican Period,7,-300,-30,270,0.039999999
2088,Torretta,A,Early Imperial Period,8,-30,100,130,0.039999999
2088,Torretta,A,Mid-Imperial Period,9,100,300,200,0.039999999
2088,Torretta,A,Late Imperial Period,10,300,500,200,0.039999999
2089,Torretta,A,Republican Period,7,-100,-30,70,0.079999998
2089,Torretta,A,Early Imperial Period,8,-30,100,130,0.079999998
2089,Torretta,A,Mid-Imperial Period,9,100,300,200,0.079999998
2090,Torretta,A,Mid-Imperial Period,9,200,300,100,0.1
2090,Torretta,A,Late Imperial Period,10,300,500,200,0.1
2091,Ponte del Peccato,A,Late Iron Age,5,-600,-580,20,0.050000001
2091,Ponte del Peccato,A,Archaic Period,6,-580,-350,230,0.050000001
2091,Ponte del Peccato,A,Republican Period,7,-350,-30,320,0.050000001
2091,Ponte del Peccato,A,Early Imperial Period,8,-30,100,130,0.050000001
2091,Ponte del Peccato,A,Mid-Imperial Period,9,100,300,200,0.050000001
2091,Ponte del Peccato,A,Late Imperial Period,10,300,500,200,0.050000001
2092,Ponte del Peccato,A,Early Imperial Period,8,-30,100,130,0.02
2092,Ponte del Peccato,A,Mid-Imperial Period,9,100,300,200,0.02
2092,Ponte del Peccato,A,Late Imperial Period,10,300,500,200,0.02
2093,Sacramento,A,Republican Period,7,-100,-30,70,0.2
2093,Sacramento,A,Early Imperial Period,8,-30,100,130,0.2
2093,Sacramento,A,Mid-Imperial Period,9,100,300,200,0.2
2093,Sacramento,A,Late Imperial Period,10,300,500,200,0.2
2094,Colli Orti,A,Late Iron Age,5,-600,-580,20,0.050000001
2094,Colli Orti,A,Archaic Period,6,-580,-350,230,0.050000001
2094,Colli Orti,A,Republican Period,7,-350,-30,320,0.050000001
2094,Colli Orti,A,Early Imperial Period,8,-30,100,130,0.050000001
2094,Colli Orti,A,Mid-Imperial Period,9,100,300,200,0.050000001
2094,Colli Orti,A,Late Imperial Period,10,300,500,200,0.050000001
2095,Colli Orti,A,Late Iron Age,5,-600,-580,20,0.079999998
2095,Colli Orti,A,Archaic Period,6,-580,-500,80,0.079999998
2095,Colli Orti,B,Early Imperial Period,8,-30,100,130,0.079999998
2095,Colli Orti,B,Mid-Imperial Period,9,100,300,200,0.079999998
2095,Colli Orti,B,Late Imperial Period,10,300,500,200,0.079999998
2096,Contrada Valle Strombone,A,Early Imperial Period,8,-30,100,130,0.050000001
2096,Contrada Valle Strombone,A,Mid-Imperial Period,9,100,300,200,0.050000001
2097,Contrada Valle Strombone,A,Early Imperial Period,8,-30,100,130,0.02
2097,Contrada Valle Strombone,A,Mid-Imperial Period,9,100,300,200,0.02
2097,Contrada Valle Strombone,A,Late Imperial Period,10,300,500,200,0.02
2098,Contrada Valle Strombone,A,Republican Period,7,-300,-30,270,0.039999999
2098,Contrada Valle Strombone,A,Early Imperial Period,8,-30,100,130,0.039999999
2098,Contrada Valle Strombone,A,Mid-Imperial Period,9,100,300,200,0.039999999
2099,Grapignano,A,Late Bronze Age,3,-1300,-1020,280,0.02
2099,Grapignano,A,Early Iron Age,4,-1020,-1000,20,0.02
2100,Sant'Anna,A,Republican Period,7,-100,-30,70,0.02
2100,Sant'Anna,A,Early Imperial Period,8,-30,100,130,0.02
2100,Sant'Anna,A,Mid-Imperial Period,9,100,300,200,0.02
2100,Sant'Anna,A,Late Imperial Period,10,300,500,200,0.02
2101,Monte Le Palme,A,Early Iron Age,4,-1000,-750,250,0.050000001
2101,Monte Le Palme,A,Late Iron Age,5,-750,-580,170,0.050000001
2101,Monte Le Palme,A,Archaic Period,6,-580,-350,230,0.050000001
2101,Monte Le Palme,A,Republican Period,7,-350,-30,320,0.050000001
2102,Monte Le Palme,A,Late Iron Age,5,-600,-580,20,0.30000001
2102,Monte Le Palme,A,Archaic Period,6,-580,-350,230,0.30000001
2102,Monte Le Palme,A,Republican Period,7,-350,-30,320,0.30000001
2103,Monte Le Palme,A,Early Imperial Period,8,-30,100,130,0.02
2103,Monte Le Palme,A,Mid-Imperial Period,9,100,300,200,0.02
2104,Carrara,A,Early Imperial Period,8,-30,100,130,0.079999998
2104,Carrara,A,Mid-Imperial Period,9,100,300,200,0.079999998
2104,Carrara,A,Late Imperial Period,10,300,500,200,0.079999998
2105,Carrara,A,Late Iron Age,5,-600,-580,20,0.2
2105,Carrara,A,Archaic Period,6,-580,-350,230,0.2
2105,Carrara,A,Republican Period,7,-350,-30,320,0.2
2105,Carrara,A,Early Imperial Period,8,-30,100,130,0.2
2105,Carrara,A,Mid-Imperial Period,9,100,300,200,0.2
2106,Carrara,A,Early Imperial Period,8,-30,100,130,0.01
2106,Carrara,A,Mid-Imperial Period,9,100,300,200,0.01
2106,Carrara,A,Late Imperial Period,10,300,500,200,0.01
2107,Carrara,A,Early Imperial Period,8,-30,100,130,0.1
2107,Carrara,A,Mid-Imperial Period,9,100,300,200,0.1
2107,Carrara,A,Late Imperial Period,10,300,500,200,0.1
2108,Ponte del Peccato,A,Early Iron Age,4,-1000,-750,250,0.039999999
2108,Ponte del Peccato,A,Late Iron Age,5,-750,-580,170,0.039999999
2108,Ponte del Peccato,A,Archaic Period,6,-580,-350,230,0.039999999
2108,Ponte del Peccato,A,Republican Period,7,-350,-30,320,0.039999999
2109,Fonte della Ficora,A,Early Imperial Period,8,-30,100,130,0.1
2109,Fonte della Ficora,A,Mid-Imperial Period,9,100,200,100,0.1
2110,Valle del Torrente l'Aia,A,Early Imperial Period,8,-30,100,130,0.02
2110,Valle del Torrente l'Aia,A,Mid-Imperial Period,9,100,200,100,0.02
2111,Contrada Valle Strombone,A,Early Imperial Period,8,-30,100,130,0.029999999
2111,Contrada Valle Strombone,A,Mid-Imperial Period,9,100,300,200,0.029999999
2111,Contrada Valle Strombone,A,Late Imperial Period,10,300,500,200,0.029999999
2112,Monte Le Palme,A,Late Iron Age,5,-700,-580,120,0.02
2112,Monte Le Palme,A,Archaic Period,6,-580,-350,230,0.02
2112,Monte Le Palme,A,Republican Period,7,-350,-30,320,0.02
2113,Seminario,A,Early Imperial Period,8,-30,100,130,0.050000001
2113,Seminario,A,Mid-Imperial Period,9,100,300,200,0.050000001
2113,Seminario,A,Late Imperial Period,10,300,500,200,0.050000001
2114,Scozzaticcio,A,Early Imperial Period,8,-30,100,130,0.07
2114,Scozzaticcio,A,Mid-Imperial Period,9,100,300,200,0.07
2114,Scozzaticcio,A,Late Imperial Period,10,300,500,200,0.07
2115,Colli Orti,A,Early Imperial Period,8,-30,100,130,0.1
2115,Colli Orti,A,Mid-Imperial Period,9,100,300,200,0.1
2115,Colli Orti,A,Late Imperial Period,10,300,500,200,0.1
2116,Colli Orti,A,Early Imperial Period,8,-30,100,130,0.02
2116,Colli Orti,A,Mid-Imperial Period,9,100,300,200,0.02
2116,Colli Orti,A,Late Imperial Period,10,300,500,200,0.02
2117,Poggio Sommavilla,A,Early Imperial Period,8,-30,100,130,0.2
2117,Poggio Sommavilla,A,Mid-Imperial Period,9,100,300,200,0.2
2117,Poggio Sommavilla,A,Late Imperial Period,10,300,500,200,0.2
2118,Colle Pelatone,A,Republican Period,7,-100,-30,70,0.050000001
2118,Colle Pelatone,A,Early Imperial Period,8,-30,100,130,0.050000001
2118,Colle Pelatone,A,Mid-Imperial Period,9,100,300,200,0.050000001
2118,Colle Pelatone,A,Late Imperial Period,10,300,500,200,0.050000001
2119,Grapignano,A,Early Imperial Period,8,-30,100,130,0.039999999
2119,Grapignano,A,Mid-Imperial Period,9,100,300,200,0.039999999
2120,Campo Rampone,A,Late Iron Age,5,-600,-580,20,0.090000004
2120,Campo Rampone,A,Archaic Period,6,-580,-350,230,0.090000004
2120,Campo Rampone,A,Republican Period,7,-350,-300,50,0.090000004
2120,Campo Rampone,A,Early Imperial Period,8,-30,100,130,0.090000004
2120,Campo Rampone,A,Mid-Imperial Period,9,100,300,200,0.090000004
2120,Campo Rampone,A,Late Imperial Period,10,300,500,200,0.090000004
2121,Campo Rampone,A,Late Iron Age,5,-600,-580,20,0.02
2121,Campo Rampone,A,Archaic Period,6,-580,-500,80,0.02
2121,Campo Rampone,B,Early Imperial Period,8,-30,100,130,0.02
2121,Campo Rampone,B,Mid-Imperial Period,9,100,300,200,0.02
2121,Campo Rampone,B,Late Imperial Period,10,300,500,200,0.02
2122,Pozza,A,Early Imperial Period,8,-30,100,130,0.02
2122,Pozza,A,Mid-Imperial Period,9,100,300,200,0.02
2122,Pozza,A,Late Imperial Period,10,300,500,200,0.02
2123,Valle de L'Aia,A,Republican Period,7,-100,-30,70,0.079999998
2123,Valle de L'Aia,A,Early Imperial Period,8,-30,100,130,0.079999998
2123,Valle de L'Aia,A,Mid-Imperial Period,9,100,300,200,0.079999998
2124,Colli Floridi,A,Early Imperial Period,8,-30,100,130,0.090000004
2124,Colli Floridi,A,Mid-Imperial Period,9,100,200,100,0.090000004
2125,Barcone,A,Republican Period,7,-100,-30,70,0.01
2125,Barcone,A,Early Imperial Period,8,-30,100,130,0.01
2125,Barcone,A,Mid-Imperial Period,9,100,200,100,0.01
2126,Vallorio,A,Early Imperial Period,8,-30,100,130,0.079999998
2126,Vallorio,A,Mid-Imperial Period,9,100,300,200,0.079999998
2126,Vallorio,A,Late Imperial Period,10,300,500,200,0.079999998
2127,Vallorio,A,Early Imperial Period,8,-30,100,130,0.2
2127,Vallorio,A,Mid-Imperial Period,9,100,300,200,0.2
2127,Vallorio,A,Late Imperial Period,10,300,500,200,0.2
2128,Foglia-San Martino,A,Early Imperial Period,8,-30,100,130,0.059999999
2128,Foglia-San Martino,A,Mid-Imperial Period,9,100,300,200,0.059999999
2128,Foglia-San Martino,A,Late Imperial Period,10,300,500,200,0.059999999
2129,Ponte del Peccato,A,Early Iron Age,4,-800,-750,50,0.029999999
2129,Ponte del Peccato,A,Late Iron Age,5,-750,-580,170,0.029999999
2129,Ponte del Peccato,A,Archaic Period,6,-580,-350,230,0.029999999
2129,Ponte del Peccato,A,Republican Period,7,-350,-30,320,0.029999999
2129,Ponte del Peccato,B,Early Imperial Period,8,30,100,70,0.029999999
2129,Ponte del Peccato,B,Mid-Imperial Period,9,100,300,200,0.029999999
2129,Ponte del Peccato,B,Late Imperial Period,10,300,500,200,0.029999999
2130,Foglia-Civitavecchia,A,Late Iron Age,5,-600,-580,20,0.029999999
2130,Foglia-Civitavecchia,A,Archaic Period,6,-580,-500,80,0.029999999
2130,Foglia-Civitavecchia,B,Republican Period,7,-100,-30,70,0.029999999
2131,Colle Rosetta,A,Late Iron Age,5,-600,-580,20,0.2
2131,Colle Rosetta,A,Archaic Period,6,-580,-350,230,0.2
2131,Colle Rosetta,A,Republican Period,7,-350,-30,320,0.2
2131,Colle Rosetta,A,Early Imperial Period,8,-30,100,130,0.2
2132,Colle Tondo,A,Republican Period,7,-100,-30,70,0.059999999
2132,Colle Tondo,A,Early Imperial Period,8,-30,100,130,0.059999999
2132,Colle Tondo,A,Mid-Imperial Period,9,100,300,200,0.059999999
2132,Colle Tondo,A,Late Imperial Period,10,300,500,200,0.059999999
2133,Colle Tondo,A,Republican Period,7,-100,-30,70,0.039999999
2134,Capo l'Aia,A,Republican Period,7,-100,-30,70,0.079999998
2134,Capo l'Aia,A,Early Imperial Period,8,-30,100,130,0.079999998
2134,Capo l'Aia,A,Mid-Imperial Period,9,100,300,200,0.079999998
2135,Caroci,A,Early Imperial Period,8,-30,100,130,0.1
2136,Poggio Sommavilla,A,Late Bronze Age,3,-1200,-1020,180,2
2136,Poggio Sommavilla,A,Early Iron Age,4,-1020,-750,270,2
2136,Poggio Sommavilla,A,Late Iron Age,5,-750,-580,170,30
2136,Poggio Sommavilla,A,Archaic Period,6,-580,-450,130,30
2137,Casale della Marcigliana,A,Republican Period,7,-100,-30,70,0.5
2137,Casale della Marcigliana,A,Early Imperial Period,8,-30,100,130,0.5
2137,Casale della Marcigliana,A,Mid-Imperial Period,9,100,200,100,0.5
2138,Casale della Marcigliana,A,Archaic Period,6,-400,-350,50,0.2
2138,Casale della Marcigliana,A,Republican Period,7,-350,-30,320,0.2
2138,Casale della Marcigliana,A,Early Imperial Period,8,-30,100,130,0.2
2138,Casale della Marcigliana,A,Mid-Imperial Period,9,100,200,100,0.2
2139,Casale della Marcigliana,A,Late Iron Age,5,-600,-580,20,0.30000001
2139,Casale della Marcigliana,A,Archaic Period,6,-580,-500,80,0.30000001
2140,,A,Late Iron Age,5,-700,-700,0,1.1
2140,,B,Archaic Period,6,-400,-350,50,0.40000001
2140,,B,Republican Period,7,-350,-200,150,0.40000001
2140,,C,Early Imperial Period,8,1,100,99,0.1
2140,,C,Mid-Imperial Period,9,100,200,100,0.1
2141,,A,Archaic Period,6,-500,-350,150,0.5
2141,,A,Republican Period,7,-350,-30,320,0.5
2141,,A,Early Imperial Period,8,-30,100,130,0.16
2141,,A,Mid-Imperial Period,9,100,200,100,0.16
2142,,A,Late Iron Age,5,-600,-580,20,1.24
2142,,A,Archaic Period,6,-580,-350,230,0.60000002
2142,,A,Republican Period,7,-350,-200,150,0.60000002
2142,,B,Early Imperial Period,8,1,100,99,0.30000001
2142,,B,Mid-Imperial Period,9,100,200,100,0.30000001
2143,Casale Monticelli,A,Late Iron Age,5,-600,-580,20,1
2143,Casale Monticelli,A,Archaic Period,6,-580,-500,80,1
2143,Casale Monticelli,B,Early Imperial Period,8,1,100,99,0.30000001
2143,Casale Monticelli,B,Mid-Imperial Period,9,100,200,100,0.30000001
2144,,A,Archaic Period,6,-400,-350,50,0.23
2144,,A,Republican Period,7,-350,-300,50,0.23
2145,,A,Late Iron Age,5,-600,-580,20,1.5
2145,,A,Archaic Period,6,-580,-350,230,0.60000002
2145,,A,Republican Period,7,-350,-300,50,0.60000002
2145,,B,Early Imperial Period,8,1,100,99,0.30000001
2145,,B,Mid-Imperial Period,9,100,200,100,0.30000001
2146,,A,Late Iron Age,5,-700,-580,120,0.80000001
2146,,A,Archaic Period,6,-580,-350,230,0.40000001
2146,,A,Republican Period,7,-350,-300,50,0.40000001
2146,,B,Early Imperial Period,8,1,100,99,0.2
2146,,B,Mid-Imperial Period,9,100,200,100,0.2
2147,Casale Monticelli,A,Early Imperial Period,8,1,100,99,0.30000001
2147,Casale Monticelli,A,Mid-Imperial Period,9,100,200,100,0.30000001
2148,,A,Late Iron Age,5,-600,-580,20,0.5
2148,,A,Archaic Period,6,-580,-500,80,0.5
2148,,B,Early Imperial Period,8,1,100,99,0.30000001
2148,,B,Mid-Imperial Period,9,100,200,100,0.30000001
2149,,A,Early Imperial Period,8,1,100,99,0.30000001
2149,,A,Mid-Imperial Period,9,100,200,100,0.30000001
2150,,A,Late Iron Age,5,-600,-580,20,0.69999999
2150,,A,Archaic Period,6,-580,-350,230,0.40000001
2150,,A,Republican Period,7,-350,-300,50,0.40000001
2151,,A,Late Iron Age,5,-600,-580,20,0.60000002
2151,,A,Archaic Period,6,-580,-400,180,0.60000002
2152,,A,Late Iron Age,5,-600,-580,20,0.80000001
2152,,A,Archaic Period,6,-580,-400,180,0.80000001
2152,,B,Early Imperial Period,8,1,100,99,0.1
2152,,B,Mid-Imperial Period,9,100,200,100,0.1
2153,,A,Late Iron Age,5,-600,-580,20,1.4
2153,,A,Archaic Period,6,-580,-350,230,0.69999999
2153,,A,Republican Period,7,-350,-200,150,0.69999999
2154,Casale di Malpasso,A,Late Iron Age,5,-600,-580,20,1.6
2154,Casale di Malpasso,A,Archaic Period,6,-580,-350,230,0.5
2154,Casale di Malpasso,A,Republican Period,7,-350,-30,320,0.5
2154,Casale di Malpasso,A,Early Imperial Period,8,-30,100,130,0.2
2154,Casale di Malpasso,A,Mid-Imperial Period,9,100,200,100,0.2
2155,Settebagni,A,Late Iron Age,5,-700,-580,120,7.0999999
2155,Settebagni,A,Archaic Period,6,-580,-350,230,2.4000001
2155,Settebagni,A,Republican Period,7,-350,-30,320,2.4000001
2155,Settebagni (Praetorium Fidenatium),A,Early Imperial Period,8,-30,100,130,10.7
2155,Settebagni (Praetorium Fidenatium),A,Mid-Imperial Period,9,100,200,100,10.7
2156,Monte di Casa,A,Archaic Period,6,-500,-350,150,0.30000001
2156,Monte di Casa,A,Republican Period,7,-350,-200,150,0.30000001
2157,Monte di Casa,A,Archaic Period,6,-500,-400,100,1
2158,Monte di Casa,A,Early Imperial Period,8,1,100,99,0.30000001
2158,Monte di Casa,A,Mid-Imperial Period,9,100,200,100,0.30000001
2159,,A,Early Imperial Period,8,1,100,99,0.30000001
2159,,A,Mid-Imperial Period,9,100,200,100,0.30000001
2160,,A,Archaic Period,6,-400,-350,50,0.80000001
2160,,A,Republican Period,7,-350,-200,150,0.80000001
2160,,B,Early Imperial Period,8,1,100,99,0.30000001
2160,,B,Mid-Imperial Period,9,100,200,100,0.30000001
2161,,A,Late Iron Age,5,-600,-580,20,1
2161,,A,Archaic Period,6,-580,-350,230,0.40000001
2161,,A,Republican Period,7,-350,-30,320,0.40000001
2161,,A,Early Imperial Period,8,-30,100,130,0.30000001
2161,,A,Mid-Imperial Period,9,100,200,100,0.30000001
2162,,A,Late Iron Age,5,-600,-580,20,1.1
2162,,A,Archaic Period,6,-580,-350,230,0.30000001
2162,,A,Republican Period,7,-350,-30,320,0.30000001
2162,,A,Early Imperial Period,8,-30,100,130,0.30000001
2162,,A,Mid-Imperial Period,9,100,200,100,0.30000001
2163,Podere Formicola,A,Late Iron Age,5,-600,-580,20,2.4000001
2163,Podere Formicola,A,Archaic Period,6,-580,-350,230,1
2163,Podere Formicola,A,Republican Period,7,-350,-200,150,1
2163,Podere Formicola,B,Early Imperial Period,8,1,100,99,0.30000001
2163,Podere Formicola,B,Mid-Imperial Period,9,100,200,100,0.30000001
2164,Podere Formicola,A,Late Iron Age,5,-700,-580,120,1.7
2164,Podere Formicola,A,Archaic Period,6,-580,-350,230,0.40000001
2164,Podere Formicola,B,Republican Period,7,-350,-30,320,0.40000001
2164,Podere Formicola,B,Early Imperial Period,8,-30,100,130,0.30000001
2164,Podere Formicola,B,Mid-Imperial Period,9,100,200,100,0.30000001
2165,,A,Archaic Period,6,-500,-350,150,0.34
2165,,A,Republican Period,7,-350,-200,150,0.34
2165,,B,Early Imperial Period,8,1,100,99,0.15000001
2165,,B,Mid-Imperial Period,9,100,200,100,0.15000001
2166,,A,Late Iron Age,5,-600,-580,20,0.60000002
2166,,A,Archaic Period,6,-580,-400,180,0.60000002
2166,,B,Republican Period,7,-100,-30,70,0.25
2166,,B,Early Imperial Period,8,-30,100,130,0.25
2166,,B,Mid-Imperial Period,9,100,200,100,0.25
2167,,A,Late Iron Age,5,-600,-580,20,1.6
2167,,A,Archaic Period,6,-580,-400,180,1.6
2167,,B,Republican Period,7,-200,-30,170,0.40000001
2167,,B,Early Imperial Period,8,-30,100,130,0.40000001
2167,,B,Mid-Imperial Period,9,100,200,100,0.40000001
2168,tenuta di S. Antonio,A,Late Iron Age,5,-600,-580,20,1.7
2168,tenuta di S. Antonio,A,Archaic Period,6,-580,-350,230,0.60000002
2168,tenuta di S. Antonio,A,Republican Period,7,-350,-200,150,0.60000002
2169,tenuta di S. Antonio,A,Archaic Period,6,-400,-350,50,0.30000001
2169,tenuta di S. Antonio,A,Republican Period,7,-350,-200,150,0.30000001
2169,tenuta di S. Antonio,B,Early Imperial Period,8,-30,100,130,0.30000001
2169,tenuta di S. Antonio,B,Mid-Imperial Period,9,100,200,100,0.30000001
2170,tenuta della Marcigliana,A,Late Iron Age,5,-600,-580,20,0.69999999
2170,tenuta della Marcigliana,A,Archaic Period,6,-580,-350,230,0.2
2170,tenuta della Marcigliana,A,Republican Period,7,-350,-200,150,0.2
2171,tenuta della Marcigliana,A,Late Iron Age,5,-600,-580,20,0.5
2171,tenuta della Marcigliana,A,Archaic Period,6,-580,-350,230,0.2
2171,tenuta della Marcigliana,B,Republican Period,7,-350,-30,320,0.30000001
2171,tenuta della Marcigliana,B,Early Imperial Period,8,-30,100,130,0.30000001
2171,tenuta della Marcigliana,B,Mid-Imperial Period,9,100,200,100,0.30000001
2172,Torretta della Bufalotta,A,Late Iron Age,5,-600,-580,20,2.0999999
2172,Torretta della Bufalotta,A,Archaic Period,6,-580,-400,180,2.0999999
2172,Torretta della Bufalotta,B,Early Imperial Period,8,1,100,99,0.5
2172,Torretta della Bufalotta,B,Mid-Imperial Period,9,100,200,100,0.5
2173,Torretta della Bufalotta,A,Late Iron Age,5,-600,-580,20,0.40000001
2173,Torretta della Bufalotta,A,Archaic Period,6,-580,-400,180,0.40000001
2173,Torretta della Bufalotta,B,Early Imperial Period,8,1,100,99,0.28039166
2173,Torretta della Bufalotta,B,Mid-Imperial Period,9,100,200,100,0.28039166
2174,Torretta della Bufalotta,A,Late Iron Age,5,-700,-580,120,1.9758574
2174,Torretta della Bufalotta,A,Archaic Period,6,-580,-350,230,1.0542978
2174,Torretta della Bufalotta,A,Republican Period,7,-350,-30,320,0.30626145
2174,Torretta della Bufalotta,A,Early Imperial Period,8,-30,100,130,0.30626145
2174,Torretta della Bufalotta,A,Mid-Imperial Period,9,100,200,100,0.30626145
2175,,A,Late Iron Age,5,-600,-580,20,0.49150825
2175,,A,Archaic Period,6,-580,-400,180,0.49150825
2175,,B,Early Imperial Period,8,1,100,99,0.18937132
2175,,B,Mid-Imperial Period,9,100,200,100,0.18937132
2176,,A,Late Iron Age,5,-600,-580,20,0.49371278
2176,,A,Archaic Period,6,-580,-400,180,0.49371278
2176,,B,Early Imperial Period,8,1,100,99,0.30297074
2176,,B,Mid-Imperial Period,9,100,200,100,0.30297074
2177,,A,Late Iron Age,5,-700,-580,120,0.47540462
2177,,A,Archaic Period,6,-580,-400,180,0.47540462
2178,,A,Early Imperial Period,8,1,100,99,0.73966932
2178,,A,Mid-Imperial Period,9,100,200,100,0.73966932
2179,,A,Late Iron Age,5,-600,-580,20,0.39882937
2179,,A,Archaic Period,6,-580,-400,180,0.39882937
2179,,B,Early Imperial Period,8,1,100,99,0.27044487
2179,,B,Mid-Imperial Period,9,100,200,100,0.27044487
2180,,A,Late Iron Age,5,-600,-580,20,0.48102823
2180,,A,Archaic Period,6,-580,-400,180,0.48102823
2180,,B,Early Imperial Period,8,1,100,99,0.2805551
2180,,B,Mid-Imperial Period,9,100,200,100,0.2805551
2181,,A,Early Imperial Period,8,1,100,99,0.2840105
2181,,A,Mid-Imperial Period,9,100,200,100,0.2840105
2182,,A,Early Imperial Period,8,1,100,99,0.28423393
2182,,A,Mid-Imperial Period,9,100,200,100,0.28423393
2183,,A,Late Iron Age,5,-700,-600,100,0.7897734
2183,,B,Republican Period,7,-100,-30,70,0.26479986
2183,,B,Early Imperial Period,8,-30,100,130,0.75491375
2183,,B,Mid-Imperial Period,9,100,200,100,0.75491375
2184,,A,Early Imperial Period,8,1,100,99,0.32535067
2184,,A,Mid-Imperial Period,9,100,200,100,0.32535067
2185,,A,Late Iron Age,5,-600,-580,20,1.1188273
2185,,A,Archaic Period,6,-580,-350,230,0.48928043
2185,,A,Republican Period,7,-350,-200,150,0.48928043
2185,,B,Early Imperial Period,8,1,100,99,0.28079817
2185,,B,Mid-Imperial Period,9,100,200,100,0.28079817
2186,,A,Early Imperial Period,8,1,100,99,0.28925866
2186,,A,Mid-Imperial Period,9,100,200,100,0.28925866
2187,,A,Late Iron Age,5,-600,-580,20,1.227545
2187,,A,Archaic Period,6,-580,-400,180,1.227545
2187,,B,Early Imperial Period,8,1,100,99,0.37298512
2187,,B,Mid-Imperial Period,9,100,200,100,0.37298512
2188,,A,Early Imperial Period,8,1,100,99,0.29075661
2188,,A,Mid-Imperial Period,9,100,200,100,0.29075661
2189,Casale Belladonna,A,Late Iron Age,5,-700,-580,120,0.90876448
2189,Casale Belladonna,A,Archaic Period,6,-580,-400,180,0.90876448
2189,Casale Belladonna,B,Early Imperial Period,8,1,100,99,0.27167812
2189,Casale Belladonna,B,Mid-Imperial Period,9,100,200,100,0.27167812
2190,Casale Belladonna,A,Republican Period,7,-100,-30,70,0.28776544
2190,Casale Belladonna,A,Early Imperial Period,8,-30,100,130,0.28776544
2190,Casale Belladonna,A,Mid-Imperial Period,9,100,200,100,0.28776544
2191,,A,Late Iron Age,5,-600,-580,20,2.4688096
2191,,A,Archaic Period,6,-580,-400,180,2.4688096
2192,,A,Republican Period,7,-100,-30,70,0.60337001
2192,,A,Early Imperial Period,8,-30,100,130,0.60337001
2192,,A,Mid-Imperial Period,9,100,200,100,0.60337001
2193,,A,Late Iron Age,5,-600,-580,20,1.4045736
2193,,A,Archaic Period,6,-580,-350,230,0.76360804
2193,,A,Republican Period,7,-350,-200,150,0.76360804
2194,,A,Late Iron Age,5,-600,-580,20,0.38920578
2194,,A,Archaic Period,6,-580,-400,180,0.38920578
2195,Casale delle Donne,A,Late Iron Age,5,-600,-580,20,1.2181995
2195,Casale delle Donne,A,Archaic Period,6,-580,-500,80,1.2181995
2196,,A,Late Iron Age,5,-600,-580,20,0.66716689
2196,,A,Archaic Period,6,-580,-500,80,0.66716689
2197,,A,Late Iron Age,5,-600,-580,20,0.60288745
2197,,A,Archaic Period,6,-580,-400,180,0.60288745
2197,,B,Early Imperial Period,8,1,100,99,0.27480459
2197,,B,Mid-Imperial Period,9,100,200,100,0.27480459
2198,Casale delle Donne,A,Late Iron Age,5,-700,-580,120,2.37534
2198,Casale delle Donne,A,Archaic Period,6,-580,-400,180,2.37534
2198,Casale delle Donne,B,Early Imperial Period,8,1,100,99,0.13877065
2198,Casale delle Donne,B,Mid-Imperial Period,9,100,200,100,0.13877065
2199,Casale delle Donne,A,Early Imperial Period,8,1,100,99,0.33757395
2199,Casale delle Donne,A,Mid-Imperial Period,9,100,200,100,0.33757395
2200,Casale delle Donne,A,Early Imperial Period,8,1,100,99,0.28866827
2200,Casale delle Donne,A,Mid-Imperial Period,9,100,200,100,0.28866827
2201,Casale delle Donne,A,Late Iron Age,5,-600,-580,20,1.9089532
2201,Casale delle Donne,A,Archaic Period,6,-580,-500,80,1.9089532
2202,Casale delle Donne,A,Archaic Period,6,-500,-350,150,0.67327124
2202,Casale delle Donne,A,Republican Period,7,-350,-200,150,0.67327124
2203,Casale delle Donne,A,Republican Period,7,-100,-30,70,0.64720368
2203,Casale delle Donne,A,Early Imperial Period,8,-30,100,130,0.64720368
2203,Casale delle Donne,A,Mid-Imperial Period,9,100,200,100,0.64720368
2204,,A,Late Iron Age,5,-600,-580,20,0.43711013
2204,,A,Archaic Period,6,-580,-400,180,0.43711013
2205,,A,Early Imperial Period,8,1,100,99,0.27474701
2205,,A,Mid-Imperial Period,9,100,200,100,0.27474701
2206,,A,Late Iron Age,5,-700,-580,120,0.47366279
2206,,A,Archaic Period,6,-580,-400,180,0.47366279
2207,,A,Archaic Period,6,-500,-400,100,0.29615206
2208,,A,Republican Period,7,-100,-30,70,0.265991
2208,,A,Early Imperial Period,8,-30,100,130,0.265991
2208,,A,Mid-Imperial Period,9,100,200,100,0.265991
2209,,A,Late Iron Age,5,-600,-580,20,1.3709524
2209,,A,Archaic Period,6,-580,-350,230,0.63015699
2209,,A,Republican Period,7,-350,-200,150,0.63015699
2210,,A,Early Imperial Period,8,1,100,99,0.32880697
2210,,A,Mid-Imperial Period,9,100,200,100,0.32880697
2211,Colle del Bufalo,A,Late Iron Age,5,-700,-580,120,2.565618
2211,Colle del Bufalo,A,Archaic Period,6,-580,-350,230,0.93918586
2211,Colle del Bufalo,B,Republican Period,7,-350,-30,320,0.71452326
2211,Colle del Bufalo,B,Early Imperial Period,8,-30,100,130,0.71452326
2211,Colle del Bufalo,B,Mid-Imperial Period,9,100,200,100,0.71452326
2212,,A,Early Imperial Period,8,1,100,99,0.2814846
2212,,A,Mid-Imperial Period,9,100,200,100,0.2814846
2213,,A,Early Imperial Period,8,1,100,99,0.29723728
2213,,A,Mid-Imperial Period,9,100,200,100,0.29723728
2214,,A,Late Iron Age,5,-600,-580,20,0.21023786
2214,,A,Archaic Period,6,-580,-500,80,0.21023786
2215,Cisterna Grande,A,Archaic Period,6,-500,-400,100,0.34360984
2215,Cisterna Grande,B,Early Imperial Period,8,1,100,99,0.28830412
2215,Cisterna Grande,B,Mid-Imperial Period,9,100,200,100,0.28830412
2216,,A,Late Iron Age,5,-600,-580,20,0.66557491
2216,,A,Archaic Period,6,-580,-350,230,0.43063664
2216,,A,Republican Period,7,-350,-200,150,0.43063664
2217,,A,Late Iron Age,5,-600,-580,20,0.30917656
2217,,A,Archaic Period,6,-580,-400,180,0.30917656
2218,,A,Late Iron Age,5,-600,-580,20,0.4382731
2218,,A,Archaic Period,6,-580,-500,80,0.4382731
2218,,B,Early Imperial Period,8,1,100,99,0.24604443
2218,,B,Mid-Imperial Period,9,100,200,100,0.24604443
2219,,A,Late Iron Age,5,-600,-580,20,3.0329411
2219,,A,Archaic Period,6,-580,-500,80,3.0329411
2220,,A,Archaic Period,6,-500,-350,150,1.2106457
2220,,A,Republican Period,7,-350,-200,150,1.2106457
2220,,B,Early Imperial Period,8,1,100,99,0.29352847
2220,,B,Mid-Imperial Period,9,100,200,100,0.29352847
2221,,A,Late Iron Age,5,-600,-580,20,3.146455
2221,,A,Archaic Period,6,-580,-350,230,0.82930917
2221,,A,Republican Period,7,-350,-30,320,0.82930917
2221,,A,Early Imperial Period,8,-30,100,130,0.63724285
2221,,A,Mid-Imperial Period,9,100,200,100,0.63724285
2222,,A,Late Iron Age,5,-650,-580,70,1.1690203
2222,,A,Archaic Period,6,-580,-500,80,1.1690203
2222,,B,Early Imperial Period,8,1,100,99,0.26643273
2222,,B,Mid-Imperial Period,9,100,200,100,0.26643273
2223,,A,Late Iron Age,5,-600,-580,20,1.8629348
2223,,A,Archaic Period,6,-580,-350,230,2.6550457
2223,,A,Republican Period,7,-350,-30,320,2.6550457
2223,,A,Early Imperial Period,8,-30,100,130,0.51321739
2223,,A,Mid-Imperial Period,9,100,200,100,0.51321739
2224,,A,Late Iron Age,5,-600,-580,20,0.46523815
2224,,A,Archaic Period,6,-580,-400,180,0.46523815
2224,,B,Early Imperial Period,8,1,100,99,0.29389763
2224,,B,Mid-Imperial Period,9,100,200,100,0.29389763
2225,,A,Late Iron Age,5,-600,-580,20,0.73858458
2225,,A,Archaic Period,6,-580,-350,230,0.31884199
2225,,A,Republican Period,7,-350,-200,150,0.31884199
2226,,A,Early Imperial Period,8,1,100,99,0.31574389
2226,,A,Mid-Imperial Period,9,100,200,100,0.31574389
2227,,A,Late Iron Age,5,-600,-580,20,2.0665309
2227,,A,Archaic Period,6,-580,-350,230,0.7347365
2227,,A,Republican Period,7,-350,-30,320,0.7347365
2227,,A,Early Imperial Period,8,-30,100,130,0.18051763
2227,,A,Mid-Imperial Period,9,100,200,100,0.18051763
2228,,A,Late Iron Age,5,-600,-580,20,0.47355318
2228,,A,Archaic Period,6,-580,-400,180,0.47355318
2229,,A,Early Imperial Period,8,1,100,99,0.28037924
2229,,A,Mid-Imperial Period,9,100,200,100,0.28037924
2230,,A,Late Iron Age,5,-600,-580,20,0.35342988
2230,,A,Archaic Period,6,-580,-400,180,0.35342988
2230,,B,Early Imperial Period,8,1,100,99,0.26987839
2230,,B,Mid-Imperial Period,9,100,200,100,0.26987839
2231,,A,Late Iron Age,5,-700,-580,120,1.6869121
2231,,A,Archaic Period,6,-580,-400,180,1.6869121
2231,,B,Republican Period,7,-100,-30,70,0.47509351
2231,,B,Early Imperial Period,8,-30,100,130,0.47509351
2231,,B,Mid-Imperial Period,9,100,200,100,0.47509351
2232,,A,Early Imperial Period,8,1,100,99,0.30544898
2232,,A,Mid-Imperial Period,9,100,200,100,0.30544898
2233,,A,Early Imperial Period,8,1,100,99,0.31905219
2233,,A,Mid-Imperial Period,9,100,200,100,0.31905219
2234,,A,Late Iron Age,5,-600,-580,20,2.5420051
2234,,A,Archaic Period,6,-580,-350,230,1.1736991
2234,,A,Republican Period,7,-350,-200,150,1.1736991
2234,,B,Early Imperial Period,8,1,100,99,0.2799654
2234,,B,Mid-Imperial Period,9,100,200,100,0.2799654
2235,,A,Early Imperial Period,8,1,100,99,0.44082564
2235,,A,Mid-Imperial Period,9,100,200,100,0.44082564
2236,,A,Late Iron Age,5,-600,-580,20,1.1205971
2236,,A,Archaic Period,6,-580,-350,230,0.47290471
2236,,A,Republican Period,7,-350,-200,150,0.47290471
2237,,A,Late Iron Age,5,-700,-580,120,1.6387568
2237,,A,Archaic Period,6,-580,-400,180,1.6387568
2238,,A,Archaic Period,6,-400,-350,50,0.82198721
2238,,A,Republican Period,7,-350,-200,150,0.82198721
2239,,A,Republican Period,7,-100,-30,70,0.85433859
2239,,A,Early Imperial Period,8,-30,100,130,0.85433859
2239,,A,Mid-Imperial Period,9,100,200,100,0.85433859
2240,,A,Late Iron Age,5,-600,-580,20,0.51819867
2240,,A,Archaic Period,6,-580,-500,80,0.51819867
2241,,A,Late Iron Age,5,-700,-580,120,2.4640903
2241,,A,Archaic Period,6,-580,-350,230,1.5625073
2241,,A,Republican Period,7,-350,-100,250,1.5625073
2241,,B,Early Imperial Period,8,1,100,99,0.78444302
2241,,B,Mid-Imperial Period,9,100,200,100,0.78444302
2242,,A,Early Imperial Period,8,1,100,99,0.32708544
2242,,A,Mid-Imperial Period,9,100,200,100,0.32708544
2243,,A,Early Imperial Period,8,1,100,99,0.30267394
2243,,A,Mid-Imperial Period,9,100,200,100,0.30267394
2244,Colle Rasto,A,Late Iron Age,5,-600,-580,20,5.2617359
2244,Colle Rasto,A,Archaic Period,6,-580,-500,80,5.2617359
2244,Colle Rasto,B,Republican Period,7,-300,-30,270,7.3581543
2244,Colle Rasto,B,Early Imperial Period,8,-30,100,130,7.3581543
2244,Colle Rasto,B,Mid-Imperial Period,9,100,300,200,7.3581543
2244,Colle Rasto,B,Late Imperial Period,10,300,500,200,7.3581543
2245,Colle Cappelle,A,Early Imperial Period,8,-30,100,130,0.99186498
2245,Colle Cappelle,A,Mid-Imperial Period,9,100,300,200,0.99186498
2246,Muraccia Polese,A,Republican Period,7,-300,-30,270,0.19603252
2246,Muraccia Polese,A,Early Imperial Period,8,-30,100,130,0.19603252
2246,Muraccia Polese,A,Mid-Imperial Period,9,100,300,200,0.19603252
2246,Muraccia Polese,A,Late Imperial Period,10,300,500,200,0.19603252
2247,Colle Caroso,A,Republican Period,7,-300,-30,270,1.1153625
2247,Colle Caroso,A,Early Imperial Period,8,-30,100,130,1.1153625
2247,Colle Caroso,A,Mid-Imperial Period,9,100,300,200,1.1153625
2247,Colle Caroso,A,Late Imperial Period,10,300,500,200,1.1153625
2248,Colle S. Rocco,A,Republican Period,7,-300,-30,270,0.86806089
2248,Colle S. Rocco,A,Early Imperial Period,8,-30,100,130,0.86806089
2248,Colle S. Rocco,A,Mid-Imperial Period,9,100,300,200,0.86806089
2248,Colle S. Rocco,A,Late Imperial Period,10,300,500,200,0.86806089
2249,Colle Occhipecora,A,Republican Period,7,-300,-30,270,0.96844649
2249,Colle Occhipecora,A,Early Imperial Period,8,-30,100,130,0.96844649
2249,Colle Occhipecora,A,Mid-Imperial Period,9,100,300,200,0.96844649
2249,Colle Occhipecora,A,Late Imperial Period,10,300,500,200,0.96844649
2250,Casale Caffarella,A,Republican Period,7,-300,-30,270,0.36068252
2250,Casale Caffarella,A,Early Imperial Period,8,-30,100,130,0.36068252
2250,Casale Caffarella,A,Mid-Imperial Period,9,100,300,200,0.36068252
2250,Casale Caffarella,A,Late Imperial Period,10,300,500,200,0.36068252
2251,Colle Cappelle,A,Republican Period,7,-300,-30,270,0.52383733
2251,Colle Cappelle,A,Early Imperial Period,8,-30,100,130,0.52383733
2251,Colle Cappelle,A,Mid-Imperial Period,9,100,300,200,0.52383733
2251,Colle Cappelle,A,Late Imperial Period,10,300,500,200,0.52383733
2252,Le Tende,A,Republican Period,7,-300,-30,270,2.4944878
2252,Le Tende,A,Early Imperial Period,8,-30,100,130,2.4944878
2252,Le Tende,A,Mid-Imperial Period,9,100,300,200,2.4944878
2252,Le Tende,A,Late Imperial Period,10,300,500,200,2.4944878
2253,Casale Molinara,A,Republican Period,7,-300,-30,270,0.66911072
2253,Casale Molinara,A,Early Imperial Period,8,-30,100,130,0.66911072
2253,Casale Molinara,A,Mid-Imperial Period,9,100,300,200,0.66911072
2253,Casale Molinara,A,Late Imperial Period,10,300,500,200,0.66911072
2254,Ruderi,A,Republican Period,7,-300,-30,270,1.1885365
2254,Ruderi,A,Early Imperial Period,8,-30,100,130,1.1885365
2254,Ruderi,A,Mid-Imperial Period,9,100,300,200,1.1885365
2254,Ruderi,A,Late Imperial Period,10,300,500,200,1.1885365
2255,,A,Republican Period,7,-300,-30,270,0.59487975
2255,,A,Early Imperial Period,8,-30,100,130,0.59487975
2255,,A,Mid-Imperial Period,9,100,300,200,0.59487975
2255,,A,Late Imperial Period,10,300,500,200,0.59487975
2256,Colle Martino,A,Republican Period,7,-300,-30,270,0.51579881
2256,Colle Martino,A,Early Imperial Period,8,-30,100,130,0.51579881
2256,Colle Martino,A,Mid-Imperial Period,9,100,300,200,0.51579881
2256,Colle Martino,A,Late Imperial Period,10,300,500,200,0.51579881
2257,,A,Republican Period,7,-300,-30,270,0.97370332
2257,,A,Early Imperial Period,8,-30,100,130,0.97370332
2257,,A,Mid-Imperial Period,9,100,300,200,0.97370332
2257,,A,Late Imperial Period,10,300,500,200,0.97370332
2258,Casale S. Pietro,A,Republican Period,7,-300,-30,270,0.44518659
2258,Casale S. Pietro,A,Early Imperial Period,8,-30,100,130,0.44518659
2258,Casale S. Pietro,A,Mid-Imperial Period,9,100,300,200,0.44518659
2258,Casale S. Pietro,A,Late Imperial Period,10,300,500,200,0.44518659
2259,Gericomio,A,Republican Period,7,-300,-30,270,1.448155
2259,Gericomio,A,Early Imperial Period,8,-30,100,130,1.448155
2259,Gericomio,A,Mid-Imperial Period,9,100,300,200,1.448155
2259,Gericomio,A,Late Imperial Period,10,300,500,200,1.448155
2260,Civita,A,Republican Period,7,-200,-30,170,0.95707387
2260,Civita,A,Early Imperial Period,8,-30,100,130,0.95707387
2260,Civita,A,Mid-Imperial Period,9,100,300,200,0.95707387
2260,Civita,A,Late Imperial Period,10,300,500,200,0.95707387
2261,,A,Republican Period,7,-300,-30,270,0.64092553
2261,,A,Early Imperial Period,8,-30,100,130,0.64092553
2261,,A,Mid-Imperial Period,9,100,300,200,0.64092553
2261,,A,Late Imperial Period,10,300,500,200,0.64092553
2262,Colle Faustiniano,A,Republican Period,7,-300,-30,270,1.4945071
2262,Colle Faustiniano,A,Early Imperial Period,8,-30,100,130,1.4945071
2262,Colle Faustiniano,A,Mid-Imperial Period,9,100,300,200,1.4945071
2262,Colle Faustiniano,A,Late Imperial Period,10,300,500,200,1.4945071
2263,Colle Faustiniano,A,Republican Period,7,-300,-30,270,0.33609483
2263,Colle Faustiniano,A,Early Imperial Period,8,-30,100,130,0.33609483
2263,Colle Faustiniano,A,Mid-Imperial Period,9,100,300,200,0.33609483
2263,Colle Faustiniano,A,Late Imperial Period,10,300,500,200,0.33609483
2264,Colle del Torrione,A,Republican Period,7,-300,-30,270,1.4347789
2264,Colle del Torrione,A,Early Imperial Period,8,-30,100,130,1.4347789
2264,Colle del Torrione,A,Mid-Imperial Period,9,100,300,200,1.4347789
2264,Colle del Torrione,A,Late Imperial Period,10,300,500,200,1.4347789
2265,Monte S. Filippo,A,Republican Period,7,-300,-30,270,0.60205221
2265,Monte S. Filippo,A,Early Imperial Period,8,-30,100,130,0.60205221
2265,Monte S. Filippo,A,Mid-Imperial Period,9,100,300,200,0.60205221
2265,Monte S. Filippo,A,Late Imperial Period,10,300,500,200,0.60205221
2266,Le Paludi,A,Republican Period,7,-300,-30,270,0.38347927
2266,Le Paludi,A,Early Imperial Period,8,-30,100,130,0.38347927
2266,Le Paludi,A,Mid-Imperial Period,9,100,300,200,0.38347927
2266,Le Paludi,A,Late Imperial Period,10,300,500,200,0.38347927
2267,,A,Republican Period,7,-300,-30,270,0.79425824
2267,,A,Early Imperial Period,8,-30,100,130,0.79425824
2267,,A,Mid-Imperial Period,9,100,300,200,0.79425824
2267,,A,Late Imperial Period,10,300,500,200,0.79425824
2268,,A,Republican Period,7,-300,-30,270,0.99958307
2268,,A,Early Imperial Period,8,-30,100,130,0.99958307
2268,,A,Mid-Imperial Period,9,100,300,200,0.99958307
2268,,A,Late Imperial Period,10,300,500,200,0.99958307
2269,la Iacchina,A,Republican Period,7,-300,-30,270,0.42604458
2269,la Iacchina,A,Early Imperial Period,8,-30,100,130,0.42604458
2269,la Iacchina,A,Mid-Imperial Period,9,100,300,200,0.42604458
2269,la Iacchina,A,Late Imperial Period,10,300,500,200,0.42604458
2270,,A,Republican Period,7,-300,-30,270,0.57134092
2270,,A,Early Imperial Period,8,-30,100,130,0.57134092
2270,,A,Mid-Imperial Period,9,100,300,200,0.57134092
2270,,A,Late Imperial Period,10,300,500,200,0.57134092
2271,Casale Siliotti,A,Republican Period,7,-300,-30,270,1.1438627
2271,Casale Siliotti,A,Early Imperial Period,8,-30,100,130,1.1438627
2271,Casale Siliotti,A,Mid-Imperial Period,9,100,300,200,1.1438627
2271,Casale Siliotti,A,Late Imperial Period,10,300,500,200,1.1438627
2272,Villa Catena,A,Republican Period,7,-300,-30,270,1.0603889
2272,Villa Catena,A,Early Imperial Period,8,-30,100,130,1.0603889
2272,Villa Catena,A,Mid-Imperial Period,9,100,300,200,1.0603889
2272,Villa Catena,A,Late Imperial Period,10,300,500,200,1.0603889
2273,Ruderi,A,Republican Period,7,-300,-30,270,1.9784981
2273,Ruderi,A,Early Imperial Period,8,-30,100,130,1.9784981
2273,Ruderi,A,Mid-Imperial Period,9,100,300,200,1.9784981
2273,Ruderi,A,Late Imperial Period,10,300,500,200,1.9784981
2274,tenuta S. Giovanni,A,Republican Period,7,-300,-30,270,0.46265823
2274,tenuta S. Giovanni,A,Early Imperial Period,8,-30,100,130,0.46265823
2274,tenuta S. Giovanni,A,Mid-Imperial Period,9,100,300,200,0.46265823
2274,tenuta S. Giovanni,A,Late Imperial Period,10,300,500,200,0.46265823
2275,tenuta S. Giovanni,A,Republican Period,7,-300,-30,270,0.83676916
2275,tenuta S. Giovanni,A,Early Imperial Period,8,-30,100,130,0.83676916
2275,tenuta S. Giovanni,A,Mid-Imperial Period,9,100,300,200,0.83676916
2275,tenuta S. Giovanni,A,Late Imperial Period,10,300,500,200,0.83676916
2276,tenuta S. Giovanni,A,Republican Period,7,-300,-30,270,1.471156
2276,tenuta S. Giovanni,A,Early Imperial Period,8,-30,100,130,1.471156
2276,tenuta S. Giovanni,A,Mid-Imperial Period,9,100,300,200,1.471156
2276,tenuta S. Giovanni,A,Late Imperial Period,10,300,500,200,1.471156
2277,Colle della Spina,A,Republican Period,7,-300,-30,270,1.5011516
2277,Colle della Spina,A,Early Imperial Period,8,-30,100,130,1.5011516
2277,Colle della Spina,A,Mid-Imperial Period,9,100,300,200,1.5011516
2277,Colle della Spina,A,Late Imperial Period,10,300,500,200,1.5011516
2278,Casale dell'Oliva,A,Republican Period,7,-300,-30,270,0.63709974
2278,Casale dell'Oliva,A,Early Imperial Period,8,-30,100,130,0.63709974
2278,Casale dell'Oliva,A,Mid-Imperial Period,9,100,300,200,0.63709974
2278,Casale dell'Oliva,A,Late Imperial Period,10,300,500,200,0.63709974
2279,La Mora,A,Republican Period,7,-300,-30,270,0.56553519
2279,La Mora,A,Early Imperial Period,8,-30,100,130,0.56553519
2279,La Mora,A,Mid-Imperial Period,9,100,300,200,0.56553519
2279,La Mora,A,Late Imperial Period,10,300,500,200,0.56553519
2280,Colle Ficozzivoli,A,Republican Period,7,-300,-30,270,0.57764435
2280,Colle Ficozzivoli,A,Early Imperial Period,8,-30,100,130,0.57764435
2280,Colle Ficozzivoli,A,Mid-Imperial Period,9,100,300,200,0.57764435
2280,Colle Ficozzivoli,A,Late Imperial Period,10,300,500,200,0.57764435
2281,Grotta del Mortale,A,Republican Period,7,-300,-30,270,4.3723288
2281,Grotta del Mortale,A,Early Imperial Period,8,-30,100,130,4.3723288
2281,Grotta del Mortale,A,Mid-Imperial Period,9,100,300,200,4.3723288
2281,Grotta del Mortale,A,Late Imperial Period,10,300,500,200,4.3723288
2282,il Campanilaccio,A,Republican Period,7,-300,-30,270,0.95086724
2282,il Campanilaccio,A,Early Imperial Period,8,-30,100,130,0.95086724
2282,il Campanilaccio,A,Mid-Imperial Period,9,100,300,200,0.95086724
2282,il Campanilaccio,A,Late Imperial Period,10,300,500,200,0.95086724
2283,Colle Ruzzano,A,Republican Period,7,-300,-30,270,0.53940171
2283,Colle Ruzzano,A,Early Imperial Period,8,-30,100,130,0.53940171
2283,Colle Ruzzano,A,Mid-Imperial Period,9,100,300,200,0.53940171
2283,Colle Ruzzano,A,Late Imperial Period,10,300,500,200,0.53940171
2284,Colle le Picozze,A,Republican Period,7,-300,-30,270,0.64340651
2284,Colle le Picozze,A,Early Imperial Period,8,-30,100,130,0.64340651
2284,Colle le Picozze,A,Mid-Imperial Period,9,100,300,200,0.64340651
2284,Colle le Picozze,A,Late Imperial Period,10,300,500,200,0.64340651
2285,Colle Le Picozze,A,Republican Period,7,-300,-30,270,0.34706441
2285,Colle Le Picozze,A,Early Imperial Period,8,-30,100,130,0.34706441
2285,Colle Le Picozze,A,Mid-Imperial Period,9,100,300,200,0.34706441
2285,Colle Le Picozze,A,Late Imperial Period,10,300,500,200,0.34706441
2286,S. Giovanni in Campo,A,Republican Period,7,-300,-30,270,0.58785439
2286,S. Giovanni in Campo,A,Early Imperial Period,8,-30,100,130,0.58785439
2286,S. Giovanni in Campo,A,Mid-Imperial Period,9,100,300,200,0.58785439
2286,S. Giovanni in Campo,A,Late Imperial Period,10,300,500,200,0.58785439
2287,La Sedia del Papa,A,Republican Period,7,-300,-30,270,1.1132492
2287,La Sedia del Papa,A,Early Imperial Period,8,-30,100,130,1.1132492
2287,La Sedia del Papa,A,Mid-Imperial Period,9,100,300,200,1.1132492
2287,La Sedia del Papa,A,Late Imperial Period,10,300,500,200,1.1132492
2288,Guadagnolo,A,Early Iron Age,4,-800,-750,50,0.34603873
2288,Guadagnolo,A,Late Iron Age,5,-750,-600,150,0.34603873
2289,,A,Republican Period,7,-300,-30,270,0.5743497
2289,,A,Early Imperial Period,8,-30,100,130,0.5743497
2289,,A,Mid-Imperial Period,9,100,300,200,0.5743497
2289,,A,Late Imperial Period,10,300,500,200,0.5743497
2290,,A,Republican Period,7,-300,-30,270,0.24312225
2290,,A,Early Imperial Period,8,-30,100,130,0.24312225
2290,,A,Mid-Imperial Period,9,100,300,200,0.24312225
2290,,A,Late Imperial Period,10,300,500,200,0.24312225
2291,Madonna del Pizzarello,A,Republican Period,7,-300,-30,270,0.25107175
2291,Madonna del Pizzarello,A,Early Imperial Period,8,-30,100,130,0.25107175
2291,Madonna del Pizzarello,A,Mid-Imperial Period,9,100,300,200,0.25107175
2291,Madonna del Pizzarello,A,Late Imperial Period,10,300,500,200,0.25107175
2293,Casale del Pescatore,A,Early Iron Age,4,-1000,-750,250,0.1699526
2293,Casale del Pescatore,A,Late Iron Age,5,-750,-600,150,0.1699526
2297,Maschio dei Ferrari,A,Early Bronze Age,1,-1800,-1700,100,0.57065386
2297,Maschio dei Ferrari,A,Middle Bronze Age,2,-1700,-1500,200,0.57065386
2298,Colle delle Grotticelle,A,Late Bronze Age,3,-1300,-1100,200,0.58208966
2299,,A,Early Bronze Age,1,-1800,-1700,100,0.6754756
2299,,A,Middle Bronze Age,2,-1700,-1500,200,0.6754756
2300,Tenuta di Bocconcino,A,Republican Period,7,-300,-100,200,0.33235198
2300,Tenuta di Bocconcino,B,Early Imperial Period,8,-30,100,130,0.31097588
2301,pianoro di Boccone,A,Early Imperial Period,8,-30,100,130,0.29708514
2301,pianoro di Boccone,A,Mid-Imperial Period,9,100,300,200,0.29708514
2301,pianoro di Boccone,A,Late Imperial Period,10,300,500,200,0.29708514
2302,pianoro di Boccone,A,Early Imperial Period,8,-30,100,130,0.29305154
2303,,A,Late Iron Age,5,-600,-580,20,0.44111961
2303,,A,Archaic Period,6,-580,-350,230,0.77646565
2303,,A,Republican Period,7,-350,-100,250,0.77646565
2303,,B,Early Imperial Period,8,-30,100,130,0.28709415
2303,,B,Mid-Imperial Period,9,100,300,200,0.28709415
2303,,B,Late Imperial Period,10,300,500,200,0.28709415
2304,,A,Late Iron Age,5,-600,-580,20,0.74598664
2304,,A,Archaic Period,6,-580,-350,230,1.3153728
2304,,A,Republican Period,7,-350,-100,250,1.3153728
2305,Pianoro di Accorrabone,A,Early Imperial Period,8,-30,100,130,0.62908381
2305,Pianoro di Accorrabone,A,Mid-Imperial Period,9,100,300,200,0.62908381
2305,Pianoro di Accorrabone,A,Late Imperial Period,10,300,400,100,0.62908381
2306,Pianoro di Accorrabone,A,Archaic Period,6,-500,-400,100,0.24139109
2307,,A,Early Imperial Period,8,-30,100,130,0.36988312
2307,,A,Mid-Imperial Period,9,100,300,200,0.36988312
2307,,A,Late Imperial Period,10,300,500,200,0.36988312
2308,,A,Early Imperial Period,8,-30,100,130,0.29025543
2308,,A,Mid-Imperial Period,9,100,300,200,0.29025543
2308,,A,Late Imperial Period,10,300,500,200,0.29025543
2309,,A,Late Iron Age,5,-750,-580,170,1.1617469
2309,,A,Archaic Period,6,-580,-350,230,1.644215
2309,,A,Republican Period,7,-350,-100,250,1.644215
2309,,B,Early Imperial Period,8,-30,100,130,0.17535904
2309,,B,Mid-Imperial Period,9,100,300,200,0.17535904
2309,,B,Late Imperial Period,10,300,500,200,0.17535904
2310,,A,Late Iron Age,5,-750,-580,170,0.26183853
2310,,A,Archaic Period,6,-580,-350,230,0.67135692
2310,,A,Republican Period,7,-350,-100,250,0.67135692
2311,Fosso di Tor S. Giovanni,A,Late Iron Age,5,-600,-580,20,0.63565153
2311,Fosso di Tor S. Giovanni,A,Archaic Period,6,-580,-350,230,1.0035975
2311,Fosso di Tor S. Giovanni,A,Republican Period,7,-350,-100,250,1.0035975
2311,Fosso di Tor S. Giovanni,B,Early Imperial Period,8,-30,100,130,0.14156567
2311,Fosso di Tor S. Giovanni,B,Mid-Imperial Period,9,100,300,200,0.14156567
2311,Fosso di Tor S. Giovanni,B,Late Imperial Period,10,300,500,200,0.14156567
2312,Fosso di Tor S. Giovanni,A,Late Iron Age,5,-600,-580,20,0.60865831
2312,Fosso di Tor S. Giovanni,A,Archaic Period,6,-580,-350,230,1.1410873
2312,Fosso di Tor S. Giovanni,A,Republican Period,7,-350,-30,320,1.1410873
2312,Fosso di Tor S. Giovanni,A,Early Imperial Period,8,-30,100,130,0.16680688
2312,Fosso di Tor S. Giovanni,A,Mid-Imperial Period,9,100,300,200,0.16680688
2312,Fosso di Tor S. Giovanni,A,Late Imperial Period,10,300,500,200,0.16680688
2313,,A,Late Iron Age,5,-600,-580,20,0.29209596
2313,,A,Archaic Period,6,-580,-350,230,0.74245346
2313,,A,Republican Period,7,-350,-100,250,0.74245346
2313,,B,Early Imperial Period,8,-30,100,130,0.30980036
2313,,B,Mid-Imperial Period,9,100,300,200,0.30980036
2313,,B,Late Imperial Period,10,300,500,200,0.30980036
2314,,A,Early Imperial Period,8,-30,100,130,0.31056473
2314,,A,Mid-Imperial Period,9,100,300,200,0.31056473
2314,,A,Late Imperial Period,10,300,500,200,0.31056473
2315,,A,Archaic Period,6,-500,-350,150,0.4541173
2315,,A,Republican Period,7,-350,-100,250,0.4541173
2315,,B,Early Imperial Period,8,-30,100,130,0.17904948
2315,,B,Mid-Imperial Period,9,100,300,200,0.17904948
2315,,B,Late Imperial Period,10,300,500,200,0.17904948
2316,,A,Republican Period,7,-300,-100,200,0.82501072
2317,Torre S. Giovanni,A,Late Iron Age,5,-600,-580,20,1.1173354
2317,Torre S. Giovanni,A,Archaic Period,6,-580,-500,80,1.1173354
2317,Torre S. Giovanni,B,Republican Period,7,-300,-100,200,1.4264933
2317,Torre S. Giovanni,C,Early Imperial Period,8,-30,100,130,0.31758282
2317,Torre S. Giovanni,C,Mid-Imperial Period,9,100,300,200,0.31758282
2317,Torre S. Giovanni,C,Late Imperial Period,10,300,500,200,0.31758282
2318,Casaletti,A,Late Iron Age,5,-600,-580,20,0.39614108
2318,Casaletti,A,Archaic Period,6,-580,-500,80,0.39614108
2319,Casale Torre S. Giovanni,A,Archaic Period,6,-500,-400,100,0.15260671
2320,Casale Torre S. Giovanni,A,Late Iron Age,5,-600,-580,20,0.41105965
2320,Casale Torre S. Giovanni,A,Archaic Period,6,-580,-400,180,0.41105965
2321,,A,Late Iron Age,5,-600,-580,20,0.28410277
2321,,A,Archaic Period,6,-580,-500,80,0.28410277
2321,,B,Mid-Imperial Period,9,200,300,100,0.65696025
2321,,B,Late Imperial Period,10,300,400,100,0.65696025
2322,Fondi di Olevano,A,Late Iron Age,5,-600,-580,20,0.29192275
2322,Fondi di Olevano,A,Archaic Period,6,-580,-500,80,0.29192275
2322,Fondi di Olevano,B,Republican Period,7,-100,-30,70,0.22924924
2322,Fondi di Olevano,B,Early Imperial Period,8,-30,100,130,0.22924924
2323,Fondi di Olevano,A,Late Iron Age,5,-600,-580,20,0.27271399
2323,Fondi di Olevano,A,Archaic Period,6,-580,-400,180,0.27271399
2324,,A,Late Iron Age,5,-600,-580,20,0.52566367
2324,,A,Archaic Period,6,-580,-400,180,0.52566367
2324,,B,Republican Period,7,-100,-30,70,0.30008933
2324,,B,Early Imperial Period,8,-30,100,130,0.30008933
2325,Fondi di Torre Lupara,A,Late Iron Age,5,-600,-580,20,0.63767773
2325,Fondi di Torre Lupara,A,Archaic Period,6,-580,-350,230,0.70504689
2325,Fondi di Torre Lupara,A,Republican Period,7,-350,-30,320,0.70504689
2325,Fondi di Torre Lupara,A,Early Imperial Period,8,-30,100,130,0.27705866
2325,Fondi di Torre Lupara,A,Mid-Imperial Period,9,100,200,100,0.27705866
2326,Fondi di Torre Lupara,A,Late Iron Age,5,-700,-580,120,0.75935394
2326,Fondi di Torre Lupara,A,Archaic Period,6,-580,-500,80,0.75935394
2326,Fondi di Torre Lupara,B,Early Imperial Period,8,1,100,99,0.37872416
2326,Fondi di Torre Lupara,B,Mid-Imperial Period,9,100,200,100,0.37872416
2327,,A,Late Iron Age,5,-600,-580,20,0.68520623
2327,,A,Archaic Period,6,-580,-400,180,0.68520623
2328,Casale Olevano,A,Late Iron Age,5,-600,-580,20,0.16658628
2328,Casale Olevano,A,Archaic Period,6,-580,-500,80,0.16658628
2329,,A,Republican Period,7,-200,-30,170,0.28434423
2329,,A,Early Imperial Period,8,-30,100,130,0.28434423
2329,,A,Mid-Imperial Period,9,100,200,100,0.28434423
2330,Fondi di Olevano,A,Late Iron Age,5,-600,-580,20,0.23138754
2330,Fondi di Olevano,A,Archaic Period,6,-580,-350,230,0.5531624
2330,Fondi di Olevano,A,Republican Period,7,-350,-30,320,0.5531624
2330,Fondi di Olevano,A,Early Imperial Period,8,-30,100,130,0.23172149
2330,Fondi di Olevano,A,Mid-Imperial Period,9,100,200,100,0.23172149
2331,Fondi di Olevano,A,Republican Period,7,-100,-30,70,0.27886552
2331,Fondi di Olevano,A,Early Imperial Period,8,-30,100,130,0.27886552
2331,Fondi di Olevano,A,Mid-Imperial Period,9,100,200,100,0.27886552
2332,Fondi di Olevano,A,Late Iron Age,5,-700,-580,120,0.23781565
2332,Fondi di Olevano,A,Archaic Period,6,-580,-350,230,0.50540704
2332,Fondi di Olevano,A,Republican Period,7,-350,-30,320,0.50540704
2332,Fondi di Olevano,A,Early Imperial Period,8,-30,100,130,0.27278706
2332,Fondi di Olevano,A,Mid-Imperial Period,9,100,200,100,0.27278706
2333,Fondi di Olevano,A,Late Iron Age,5,-600,-580,20,0.17266902
2333,Fondi di Olevano,A,Archaic Period,6,-580,-350,230,0.31441882
2333,Fondi di Olevano,A,Republican Period,7,-350,-200,150,0.31441882
2334,Casaletti,A,Late Iron Age,5,-600,-580,20,0.31383559
2334,Casaletti,A,Archaic Period,6,-580,-400,180,0.31383559
2335,Casale Olevano,A,Late Iron Age,5,-600,-580,20,0.22111262
2335,Casale Olevano,A,Archaic Period,6,-580,-350,230,0.50931805
2335,Casale Olevano,A,Republican Period,7,-350,-200,150,0.50931805
2336,Fondi di Olevano,A,Late Iron Age,5,-600,-580,20,0.26130649
2336,Fondi di Olevano,A,Archaic Period,6,-580,-400,180,0.26130649
2337,Casale Olevano,A,Early Imperial Period,8,1,100,99,0.40312877
2337,Casale Olevano,A,Mid-Imperial Period,9,100,200,100,0.40312877
2338,Casale Olevano,A,Republican Period,7,-200,-30,170,0.29765686
2338,Casale Olevano,A,Early Imperial Period,8,-30,100,130,0.29765686
2338,Casale Olevano,A,Mid-Imperial Period,9,100,200,100,0.29765686
2339,,A,Early Imperial Period,8,-30,100,130,0.26751736
2339,,A,Mid-Imperial Period,9,100,200,100,0.26751736
2340,Fondi della Cesarina,A,Early Imperial Period,8,1,100,99,0.64538878
2340,Fondi della Cesarina,A,Mid-Imperial Period,9,100,200,100,0.64538878
2341,Macchia della Cesarina,A,Late Iron Age,5,-600,-580,20,1.3412131
2341,Macchia della Cesarina,A,Archaic Period,6,-580,-350,230,2.2959645
2341,Macchia della Cesarina,A,Republican Period,7,-350,-200,150,2.2959645
2341,Macchia della Cesarina,B,Early Imperial Period,8,1,100,99,0.47408009
2341,Macchia della Cesarina,B,Mid-Imperial Period,9,100,200,100,0.47408009
2342,Macchia della Cesarina,A,Late Iron Age,5,-600,-580,20,1.0224757
2342,Macchia della Cesarina,A,Archaic Period,6,-580,-400,180,1.0224757
2343,Macchia della Cesarina,A,Late Iron Age,5,-600,-580,20,0.2998997
2343,Macchia della Cesarina,A,Archaic Period,6,-580,-500,80,0.2998997
2344,Macchia della Cesarina,A,Early Imperial Period,8,1,100,99,0.35945523
2344,Macchia della Cesarina,A,Mid-Imperial Period,9,100,200,100,0.35945523
2345,Macchia della Cesarina,A,Late Iron Age,5,-600,-580,20,0.30808869
2345,Macchia della Cesarina,A,Archaic Period,6,-580,-350,230,0.5741623
2345,Macchia della Cesarina,A,Republican Period,7,-350,-200,150,0.5741623
2346,Macchia della Cesarina,A,Republican Period,7,-200,-30,170,0.32080895
2347,Macchia della Cesarina,A,Late Iron Age,5,-600,-580,20,0.20968507
2347,Macchia della Cesarina,A,Archaic Period,6,-580,-500,80,0.20968507
2348,,A,Late Iron Age,5,-600,-580,20,0.53643811
2348,,A,Archaic Period,6,-580,-400,180,0.53643811
2349,Macchia della Cesarina,A,Late Iron Age,5,-600,-580,20,0.35221943
2349,Macchia della Cesarina,A,Archaic Period,6,-580,-500,80,0.35221943
2349,Macchia della Cesarina,B,Republican Period,7,-200,-30,170,1.1896261
2349,Macchia della Cesarina,B,Early Imperial Period,8,-30,100,130,0.28193039
2349,Macchia della Cesarina,B,Mid-Imperial Period,9,100,200,100,0.28193039
2350,Macchia della Cesarina,A,Late Iron Age,5,-600,-580,20,0.56753504
2350,Macchia della Cesarina,A,Archaic Period,6,-580,-500,80,0.56753504
2350,Macchia della Cesarina,B,Republican Period,7,-200,-30,170,0.84633261
2351,,A,Late Iron Age,5,-600,-580,20,1.0494446
2351,,A,Archaic Period,6,-580,-400,180,1.0494446
2351,,B,Early Imperial Period,8,1,100,99,0.31356651
2351,,B,Mid-Imperial Period,9,100,200,100,0.31356651
2352,,A,Late Iron Age,5,-600,-580,20,0.5693745
2352,,A,Archaic Period,6,-580,-400,180,0.5693745
2352,,B,Early Imperial Period,8,-30,100,130,0.25077182
2353,,A,Late Iron Age,5,-600,-580,20,0.53597462
2353,,A,Archaic Period,6,-580,-400,180,0.53597462
2353,,B,Early Imperial Period,8,-30,100,130,0.35404137
2354,,A,Republican Period,7,-200,-30,170,0.28977922
2354,,A,Early Imperial Period,8,-30,100,130,0.28955808
2354,,A,Mid-Imperial Period,9,100,300,200,0.28955808
2354,,A,Late Imperial Period,10,300,400,100,0.28955808
2355,,A,Early Imperial Period,8,1,100,99,0.24005112
2355,,A,Mid-Imperial Period,9,100,300,200,0.24005112
2355,,A,Late Imperial Period,10,300,400,100,0.24005112
2356,,A,Late Iron Age,5,-600,-580,20,1.1971507
2356,,A,Archaic Period,6,-580,-350,230,1.4642971
2356,,A,Republican Period,7,-350,-200,150,1.4642971
2356,,B,Early Imperial Period,8,1,100,99,0.57052696
2356,,B,Mid-Imperial Period,9,100,300,200,0.57052696
2356,,B,Late Imperial Period,10,300,400,100,0.57052696
2357,,A,Late Iron Age,5,-600,-580,20,0.16662093
2357,,A,Archaic Period,6,-580,-400,180,0.16662093
2358,,A,Early Imperial Period,8,1,100,99,0.25836512
2358,,A,Mid-Imperial Period,9,100,200,100,0.25836512
2359,Fondi della Cesarina,A,Late Iron Age,5,-600,-580,20,0.22003046
2359,Fondi della Cesarina,A,Archaic Period,6,-580,-400,180,0.22003046
2360,Fondi della Cesarina,A,Late Iron Age,5,-600,-580,20,0.35813263
2360,Fondi della Cesarina,A,Archaic Period,6,-580,-350,230,0.87041092
2360,Fondi della Cesarina,A,Republican Period,7,-350,-30,320,0.87041092
2360,Fondi della Cesarina,A,Early Imperial Period,8,-30,100,130,0.52879286
2360,Fondi della Cesarina,A,Mid-Imperial Period,9,100,200,100,0.52879286
2361,,A,Late Iron Age,5,-600,-580,20,0.26317257
2361,,A,Archaic Period,6,-580,-350,230,0.50676352
2361,,A,Republican Period,7,-350,-200,150,0.50676352
2361,,B,Early Imperial Period,8,1,100,99,0.25697243
2361,,B,Mid-Imperial Period,9,100,300,200,0.25697243
2361,,B,Late Imperial Period,10,300,400,100,0.25697243
2362,,A,Early Imperial Period,8,1,100,99,0.32850906
2362,,A,Mid-Imperial Period,9,100,200,100,0.32850906
2363,Fondi della Cesarina,A,Late Iron Age,5,-600,-580,20,0.37878701
2363,Fondi della Cesarina,A,Archaic Period,6,-580,-350,230,0.97221828
2363,Fondi della Cesarina,A,Republican Period,7,-350,-200,150,0.97221828
2363,,A,Early Imperial Period,8,1,100,99,0.19062202
2363,,A,Mid-Imperial Period,9,100,200,100,0.19062202
2364,Fondi della Cesarina,A,Late Iron Age,5,-600,-580,20,0.54790837
2364,Fondi della Cesarina,A,Archaic Period,6,-580,-350,230,0.84193677
2364,Fondi della Cesarina,A,Republican Period,7,-350,-200,150,0.84193677
2364,Fondi della Cesarina,B,Early Imperial Period,8,1,100,99,0.27360556
2364,Fondi della Cesarina,B,Mid-Imperial Period,9,100,200,100,0.27360556
2365,Fondi della Cesarina,A,Late Iron Age,5,-600,-580,20,0.5338245
2365,Fondi della Cesarina,A,Archaic Period,6,-580,-350,230,0.86728495
2365,Fondi della Cesarina,A,Republican Period,7,-350,-200,150,0.86728495
2365,Fondi della Cesarina,B,Early Imperial Period,8,1,100,99,0.30842701
2365,Fondi della Cesarina,B,Mid-Imperial Period,9,100,200,100,0.30842701
2366,,A,Republican Period,7,-300,-100,200,0.39202628
2367,,A,Early Imperial Period,8,1,100,99,0.60594928
2367,,A,Mid-Imperial Period,9,100,200,100,0.60594928
2368,Casale della Cesarina Vecchia,A,Archaic Period,6,-500,-350,150,0.45496973
2368,Casale della Cesarina Vecchia,A,Republican Period,7,-350,-200,150,0.45496973
2369,Casale della Cesarina Vecchia,A,Late Iron Age,5,-600,-580,20,0.2328968
2369,Casale della Cesarina Vecchia,A,Archaic Period,6,-580,-400,180,0.2328968
2370,Pezze di Ninfa,A,Late Iron Age,5,-700,-580,120,0.5
2370,Pezze di Ninfa,A,Archaic Period,6,-580,-350,230,0.5
2370,Pezze di Ninfa,A,Republican Period,7,-350,-30,320,0.5
2371,Pontesano,A,Republican Period,7,-100,-30,70,1.5
2371,Pontesano,A,Early Imperial Period,8,-30,100,130,1.5
2372,,A,Republican Period,7,-350,-30,320,0.050000001
2372,,A,Early Imperial Period,8,-30,100,130,0.050000001
2373,,A,Republican Period,7,-350,-30,320,0.050000001
2374,Tenuta di Bocconcino,A,Late Iron Age,5,-600,-580,20,0.57988423
2374,Tenuta di Bocconcino,A,Archaic Period,6,-580,-500,80,0.57988423
2374,Tenuta di Bocconcino,B,Republican Period,7,-100,-30,70,0.20137863
2375,Tenuta di Bocconcino,A,Late Iron Age,5,-600,-580,20,0.22707637
2375,Tenuta di Bocconcino,A,Archaic Period,6,-580,-500,80,0.22707637
2376,Tenuta di Bocconcino,A,Late Iron Age,5,-600,-580,20,0.42935309
2376,Tenuta di Bocconcino,A,Archaic Period,6,-580,-350,230,1.1263496
2376,Tenuta di Bocconcino,A,Republican Period,7,-350,-30,320,1.1263496
2376,Tenuta di Bocconcino,A,Early Imperial Period,8,-30,100,130,0.30642423
2376,Tenuta di Bocconcino,A,Mid-Imperial Period,9,100,200,100,0.30642423
2377,Fosso Cinquina,A,Late Iron Age,5,-600,-580,20,0.24585535
2377,Fosso Cinquina,A,Archaic Period,6,-580,-350,230,0.51841873
2377,Fosso Cinquina,A,Republican Period,7,-350,-200,150,0.51841873
2378,Fosso Cinquina,A,Archaic Period,6,-400,-350,50,0.64674127
2378,Fosso Cinquina,A,Republican Period,7,-350,-30,320,0.64674127
2378,Fosso Cinquina,A,Early Imperial Period,8,-30,100,130,0.23692647
2378,Fosso Cinquina,A,Mid-Imperial Period,9,100,200,100,0.23692647
2379,,A,Archaic Period,6,-400,-350,50,0.71224511
2379,,A,Republican Period,7,-350,-30,320,0.71224511
2379,,A,Early Imperial Period,8,-30,100,130,0.39943054
2379,,A,Mid-Imperial Period,9,100,200,100,0.39943054
2380,Tenuta della Cesarina,A,Late Iron Age,5,-600,-580,20,0.25004753
2380,Tenuta della Cesarina,A,Archaic Period,6,-580,-350,230,0.73256648
2380,Tenuta della Cesarina,A,Republican Period,7,-350,-200,150,0.73256648
2381,,A,Late Iron Age,5,-600,-580,20,0.50541425
2381,,A,Archaic Period,6,-580,-400,180,0.50541425
2382,Tenuta della Cesarina,A,Late Iron Age,5,-600,-580,20,0.57089436
2382,Tenuta della Cesarina,A,Archaic Period,6,-580,-500,80,0.57089436
2382,Tenuta della Cesarina,B,Early Imperial Period,8,1,100,99,0.1737943
2382,Tenuta della Cesarina,B,Mid-Imperial Period,9,100,200,100,0.1737943
2383,,A,Late Iron Age,5,-600,-580,20,0.62430936
2383,,A,Archaic Period,6,-580,-350,230,0.85743928
2383,,B,Republican Period,7,-350,-30,320,0.27464649
2383,,B,Early Imperial Period,8,-30,100,130,0.27464649
2383,,B,Mid-Imperial Period,9,100,200,100,0.27464649
2384,,A,Late Iron Age,5,-600,-580,20,0.56256831
2384,,A,Archaic Period,6,-580,-350,230,0.95017833
2384,,A,Republican Period,7,-350,-30,320,0.95017833
2384,,A,Early Imperial Period,8,-30,100,130,0.21558377
2384,,A,Mid-Imperial Period,9,100,200,100,0.21558377
2385,,A,Early Imperial Period,8,1,100,99,0.30176592
2385,,A,Mid-Imperial Period,9,100,200,100,0.30176592
2386,,A,Late Iron Age,5,-600,-580,20,0.26167378
2386,,A,Archaic Period,6,-580,-350,230,0.38070551
2386,,A,Republican Period,7,-350,-200,150,0.38070551
2387,,A,Late Iron Age,5,-600,-580,20,0.25975257
2387,,A,Archaic Period,6,-580,-350,230,0.63350999
2387,,A,Republican Period,7,-350,-200,150,0.63350999
2388,,A,Late Iron Age,5,-600,-580,20,0.14607577
2388,,A,Archaic Period,6,-580,-350,230,0.30936295
2388,,A,Republican Period,7,-350,-200,150,0.30936295
2389,,A,Late Iron Age,5,-600,-580,20,0.17300813
2389,,A,Archaic Period,6,-580,-350,230,0.37809178
2389,,A,Republican Period,7,-350,-200,150,0.37809178
2390,Tenuta della Cesarina,A,Late Iron Age,5,-600,-580,20,0.27774453
2390,,A,Archaic Period,6,-580,-350,230,1.1313219
2390,,A,Republican Period,7,-350,-200,150,1.1313219
2391,,A,Early Imperial Period,8,1,100,99,0.33966926
2391,,A,Mid-Imperial Period,9,100,200,100,0.33966926
2392,Tenuta della Cesarina,A,Early Imperial Period,8,-30,100,130,0.34146664
2392,Tenuta della Cesarina,A,Mid-Imperial Period,9,100,200,100,0.34146664
2393,,A,Republican Period,7,-300,-30,270,0.37735474
2394,,A,Early Imperial Period,8,-30,100,130,0.29877359
2394,,A,Mid-Imperial Period,9,100,200,100,0.29877359
2395,,A,Late Iron Age,5,-600,-580,20,0.33969921
2395,,A,Archaic Period,6,-580,-350,230,0.47338888
2395,,A,Republican Period,7,-350,-30,320,0.47338888
2395,,A,Early Imperial Period,8,-30,100,130,0.24546929
2395,,A,Mid-Imperial Period,9,100,200,100,0.24546929
2396,,A,Late Iron Age,5,-600,-580,20,0.15651715
2396,,A,Archaic Period,6,-580,-350,230,0.43308264
2396,,A,Republican Period,7,-350,-200,150,0.43308264
2397,,A,Archaic Period,6,-400,-350,50,0.28269282
2397,,A,Republican Period,7,-350,-30,320,0.28269282
2398,,A,Late Iron Age,5,-600,-580,20,0.82731211
2398,,A,Archaic Period,6,-580,-400,180,0.82731211
2398,,B,Early Imperial Period,8,1,100,99,0.18511397
2398,,B,Mid-Imperial Period,9,100,200,100,0.18511397
2399,,A,Early Iron Age,4,-800,-750,50,0.82215047
2399,,A,Late Iron Age,5,-750,-580,170,0.82215047
2399,,A,Archaic Period,6,-580,-350,230,1.7203058
2399,,A,Republican Period,7,-350,-200,150,1.7203058
2400,Montebello,A,Late Iron Age,5,-600,-580,20,0.73270679
2400,Montebello,A,Archaic Period,6,-580,-500,80,0.73270679
2400,Montebello,B,Early Imperial Period,8,1,100,99,0.31454271
2400,Montebello,B,Mid-Imperial Period,9,100,200,100,0.31454271
2401,Montebello,A,Late Iron Age,5,-600,-580,20,0.20075966
2401,Montebello,A,Archaic Period,6,-580,-500,80,0.20075966
2401,Montebello,B,Republican Period,7,-100,-30,70,0.28191519
2402,Montebello,A,Late Iron Age,5,-750,-580,170,1.3811512
2402,Montebello,A,Archaic Period,6,-580,-400,180,1.3811512
2402,Montebello,B,Republican Period,7,-100,-30,70,0.2839447
2402,Montebello,B,Early Imperial Period,8,-30,30,60,0.2839447
2403,,A,Republican Period,7,-300,-30,270,0.78616112
2403,,A,Early Imperial Period,8,-30,100,130,0.29592818
2403,,A,Mid-Imperial Period,9,100,200,100,0.29592818
2404,Casale della Madonnella,A,Early Imperial Period,8,1,100,99,0.26732081
2404,Casale della Madonnella,A,Mid-Imperial Period,9,100,200,100,0.26732081
2405,,A,Early Imperial Period,8,1,100,99,0.3008737
2405,,A,Mid-Imperial Period,9,100,200,100,0.3008737
2406,Tenuta Ignis,A,Early Imperial Period,8,1,100,99,0.30100745
2406,Tenuta Ignis,A,Mid-Imperial Period,9,100,200,100,0.30100745
2407,Casale vecchio di Aguzzano,A,Late Iron Age,5,-600,-580,20,1.0604661
2407,Casale vecchio di Aguzzano,A,Archaic Period,6,-580,-400,180,1.0604661
2407,Casale vecchio di Aguzzano,B,Early Imperial Period,8,1,100,99,0.58502132
2407,Casale vecchio di Aguzzano,B,Mid-Imperial Period,9,100,200,100,0.58502132
2408,Podere Anna,A,Republican Period,7,-100,-30,70,0.34918496
2408,Podere Anna,A,Early Imperial Period,8,-30,100,130,0.59852272
2408,Podere Anna,A,Mid-Imperial Period,9,100,300,200,0.59852272
2408,Podere Anna,A,Late Imperial Period,10,300,450,150,0.59852272
2409,,A,Late Iron Age,5,-600,-580,20,0.63965583
2409,,A,Archaic Period,6,-580,-350,230,1.1010885
2409,,A,Republican Period,7,-350,-200,150,1.1010885
2410,,A,Late Iron Age,5,-600,-580,20,0.23769367
2410,,A,Archaic Period,6,-580,-500,80,0.23769367
2411,,A,Mid-Imperial Period,9,100,300,200,0.24529281
2411,,A,Late Imperial Period,10,300,500,200,0.24529281
2412,,A,Archaic Period,6,-500,-350,150,1.6330129
2412,,A,Republican Period,7,-350,-200,150,1.6330129
2412,,B,Early Imperial Period,8,1,100,99,0.24015345
2412,,B,Mid-Imperial Period,9,100,200,100,0.24015345
2413,,A,Late Iron Age,5,-600,-580,20,0.29086304
2413,,A,Archaic Period,6,-580,-350,230,0.44901222
2413,,A,Republican Period,7,-350,-300,50,0.44901222
2414,,A,Early Imperial Period,8,1,100,99,0.26184025
2414,,A,Mid-Imperial Period,9,100,200,100,0.26184025
2415,,A,Late Iron Age,5,-600,-580,20,1.4319657
2415,,A,Archaic Period,6,-580,-350,230,1.2047807
2415,,A,Republican Period,7,-350,-30,320,1.2047807
2415,,A,Early Imperial Period,8,-30,100,130,3.4417949
2415,,A,Mid-Imperial Period,9,100,300,200,3.4417949
2415,,A,Late Imperial Period,10,300,500,200,0.89944893
2416,,A,Early Imperial Period,8,1,100,99,0.30018452
2416,,A,Mid-Imperial Period,9,100,200,100,0.30018452
2417,,A,Late Iron Age,5,-600,-580,20,0.43554965
2417,,A,Archaic Period,6,-580,-400,180,0.43554965
2417,,B,Republican Period,7,-100,-30,70,0.29181355
2417,,B,Early Imperial Period,8,-30,100,130,0.29181355
2418,,A,Late Iron Age,5,-600,-580,20,0.41085845
2418,,A,Archaic Period,6,-580,-350,230,0.79454875
2418,,A,Republican Period,7,-350,-200,150,0.79454875
2419,,A,Late Iron Age,5,-700,-580,120,0.47041926
2419,,A,Archaic Period,6,-580,-350,230,0.80487072
2419,,A,Republican Period,7,-350,-200,150,0.80487072
2419,,B,Early Imperial Period,8,1,100,99,0.25454888
2419,,B,Mid-Imperial Period,9,100,200,100,0.25454888
2420,Casale Cesarina Nuova,A,Late Iron Age,5,-600,-580,20,0.53065282
2420,Casale Cesarina Nuova,A,Archaic Period,6,-580,-400,180,0.53065282
2420,Casale Cesarina Nuova,B,Early Imperial Period,8,1,100,99,0.21854259
2420,Casale Cesarina Nuova,B,Mid-Imperial Period,9,100,200,100,0.21854259
2421,,A,Early Imperial Period,8,1,100,99,0.2559914
2421,,A,Mid-Imperial Period,9,100,200,100,0.2559914
2422,Pianoro di Coazzo,A,Late Iron Age,5,-600,-580,20,0.98324198
2422,Pianoro di Coazzo,A,Archaic Period,6,-580,-400,180,0.98324198
2422,Pianoro di Coazzo,B,Early Imperial Period,8,1,100,99,0.80864626
2422,Pianoro di Coazzo,B,Mid-Imperial Period,9,100,200,100,0.80864626
2423,,A,Late Iron Age,5,-600,-580,20,0.1467787
2423,,A,Archaic Period,6,-580,-500,80,0.1467787
2424,,A,Archaic Period,6,-500,-350,150,0.30193445
2424,,A,Republican Period,7,-350,-200,150,0.30193445
2424,,B,Early Imperial Period,8,-30,100,130,0.23385784
2425,Casale Coazzo,A,Early Imperial Period,8,1,100,99,0.6666525
2425,Casale Coazzo,A,Mid-Imperial Period,9,100,300,200,0.6666525
2426,Casale Coazzo,A,Early Imperial Period,8,-30,100,130,0.28950036
2426,Casale Coazzo,A,Mid-Imperial Period,9,100,300,200,0.56310338
2426,Casale Coazzo,A,Late Imperial Period,10,300,500,200,0.56310338
2427,Casale Coazzo,A,Early Imperial Period,8,1,100,99,0.23093066
2427,Casale Coazzo,A,Mid-Imperial Period,9,100,300,200,0.23093066
2427,Casale Coazzo,A,Late Imperial Period,10,300,500,200,0.23093066
2428,,A,Late Iron Age,5,-600,-580,20,0.38062257
2428,,A,Archaic Period,6,-580,-500,80,0.38062257
2428,,B,Early Imperial Period,8,1,100,99,0.22591539
2428,,B,Mid-Imperial Period,9,100,200,100,0.22591539
2429,,A,Late Iron Age,5,-600,-580,20,0.57445228
2429,,A,Archaic Period,6,-580,-350,230,1.0491992
2429,,A,Republican Period,7,-350,-30,320,1.0491992
2429,,A,Early Imperial Period,8,-30,100,130,0.7337501
2429,,A,Mid-Imperial Period,9,100,200,100,0.7337501
2430,Prato Lauro,A,Late Iron Age,5,-600,-580,20,0.17214987
2430,Prato Lauro,A,Archaic Period,6,-580,-500,80,0.17214987
2430,Prato Lauro,B,Republican Period,7,-100,-30,70,0.27007708
2430,Prato Lauro,B,Early Imperial Period,8,-30,100,130,0.27007708
2430,Prato Lauro,B,Mid-Imperial Period,9,100,300,200,0.27007708
2430,Prato Lauro,B,Late Imperial Period,10,300,500,200,0.27007708
2431,,A,Late Iron Age,5,-600,-580,20,0.53296608
2431,,A,Archaic Period,6,-580,-500,80,0.53296608
2431,,B,Mid-Imperial Period,9,100,300,200,0.3517718
2431,,B,Late Imperial Period,10,300,500,200,0.3517718
2432,,A,Early Imperial Period,8,1,100,99,1.7209429
2432,,A,Mid-Imperial Period,9,100,300,200,1.7209429
2432,,A,Late Imperial Period,10,300,400,100,1.7209429
2433,,A,Late Iron Age,5,-600,-580,20,0.63297921
2433,,A,Archaic Period,6,-580,-500,80,0.63297921
2434,,A,Late Iron Age,5,-600,-580,20,0.19571948
2434,,A,Archaic Period,6,-580,-500,80,0.19571948
2435,Fosso della Cesarina,A,Early Imperial Period,8,1,100,99,0.2930496
2435,Fosso della Cesarina,A,Mid-Imperial Period,9,100,300,200,0.2930496
2435,Fosso della Cesarina,A,Late Imperial Period,10,300,500,200,0.2930496
2436,Torraccio di Capobianco,A,Late Iron Age,5,-600,-580,20,0.65731961
2436,Torraccio di Capobianco,A,Archaic Period,6,-580,-500,80,0.65731961
2436,Torraccio di Capobianco,B,Republican Period,7,-100,-30,70,0.22231141
2436,Torraccio di Capobianco,B,Early Imperial Period,8,-30,100,130,0.22231141
2437,Casaletti,A,Late Iron Age,5,-700,-580,120,0.70880854
2437,Casaletti,A,Archaic Period,6,-580,-350,230,0.96228939
2437,Casaletti,A,Republican Period,7,-350,-200,150,0.96228939
2437,Casaletti,B,Early Imperial Period,8,1,100,99,0.21615243
2437,Casaletti,B,Mid-Imperial Period,9,100,300,200,0.21615243
2438,Casaletti,A,Early Imperial Period,8,1,100,99,0.27773944
2438,Casaletti,A,Mid-Imperial Period,9,100,200,100,0.27773944
2439,Torraccio di Capobianco,A,Late Iron Age,5,-600,-580,20,1.050752
2439,Torraccio di Capobianco,A,Archaic Period,6,-580,-400,180,1.050752
2439,Torraccio di Capobianco,B,Early Imperial Period,8,1,100,99,0.29261622
2439,Torraccio di Capobianco,B,Mid-Imperial Period,9,100,300,200,0.29261622
2440,Torraccio di Capobianco,A,Late Iron Age,5,-600,-580,20,1.0621934
2440,Torraccio di Capobianco,A,Archaic Period,6,-580,-500,80,1.0621934
2440,Torraccio di Capobianco,B,Early Imperial Period,8,1,100,99,0.85495567
2440,Torraccio di Capobianco,B,Mid-Imperial Period,9,100,300,200,0.85495567
2440,Torraccio di Capobianco,B,Late Imperial Period,10,300,500,200,0.85495567
2441,,A,Late Iron Age,5,-600,-580,20,0.22913069
2441,,A,Archaic Period,6,-580,-350,230,0.52308911
2441,,A,Republican Period,7,-350,-200,150,0.52308911
2442,,A,Late Iron Age,5,-600,-580,20,0.38221279
2442,,A,Archaic Period,6,-580,-350,230,0.90854883
2442,,B,Republican Period,7,-350,-30,320,0.33177957
2442,,B,Early Imperial Period,8,-30,100,130,0.33177957
2443,,A,Late Iron Age,5,-600,-580,20,0.70666277
2443,,A,Archaic Period,6,-580,-400,180,0.70666277
2444,,A,Late Iron Age,5,-700,-580,120,1.2179925
2444,,A,Archaic Period,6,-580,-350,230,2.3925154
2444,,B,Republican Period,7,-350,-30,320,0.66186786
2444,,B,Early Imperial Period,8,-30,100,130,0.66186786
2444,,B,Mid-Imperial Period,9,100,300,200,0.66186786
2444,,B,Late Imperial Period,10,300,500,200,0.66186786
2445,tenuta di Capobianco,A,Late Iron Age,5,-600,-580,20,0.29930633
2445,tenuta di Capobianco,A,Archaic Period,6,-580,-500,80,0.29930633
2446,,A,Late Iron Age,5,-600,-580,20,1.18006
2446,,A,Archaic Period,6,-580,-350,230,3.0270422
2446,,A,Republican Period,7,-350,-30,320,3.0270422
2447,Prato Lauro,A,Late Iron Age,5,-600,-580,20,0.43871704
2447,Prato Lauro,A,Archaic Period,6,-580,-400,180,0.43871704
2448,Prato Lauro,A,Late Iron Age,5,-600,-580,20,0.5434472
2448,Prato Lauro,A,Archaic Period,6,-580,-500,80,0.5434472
2449,Prato Lauro,A,Early Imperial Period,8,1,100,99,0.92243654
2449,Prato Lauro,A,Mid-Imperial Period,9,100,300,200,0.92243654
2449,Prato Lauro,A,Late Imperial Period,10,300,500,200,0.92243654
2450,Prato Lauro,A,Late Iron Age,5,-600,-580,20,0.81253076
2450,Prato Lauro,A,Archaic Period,6,-580,-350,230,1.6912339
2450,Prato Lauro,A,Republican Period,7,-350,-30,320,1.6912339
2451,,A,Late Iron Age,5,-600,-580,20,0.16991608
2451,,A,Archaic Period,6,-580,-500,80,0.16991608
2452,Casale delle Vittorie,A,Republican Period,7,-300,-30,270,0.85285759
2452,Casale delle Vittorie,A,Early Imperial Period,8,-30,100,130,0.235963
2452,Casale delle Vittorie,A,Mid-Imperial Period,9,100,200,100,0.235963
2453,Casale delle Vittorie,A,Late Iron Age,5,-600,-580,20,0.13469915
2453,Casale delle Vittorie,A,Archaic Period,6,-580,-500,80,0.13469915
2454,Casale delle Vittorie,A,Late Iron Age,5,-600,-580,20,0.16498992
2454,Casale delle Vittorie,A,Archaic Period,6,-580,-350,230,0.466912
2454,Casale delle Vittorie,A,Republican Period,7,-350,-200,150,0.466912
2455,,A,Late Iron Age,5,-600,-580,20,0.54685163
2455,,A,Archaic Period,6,-580,-500,80,0.54685163
2455,,B,Early Imperial Period,8,1,100,99,0.25453454
2455,,B,Mid-Imperial Period,9,100,200,100,0.25453454
2456,Villa Serafini,A,Early Imperial Period,8,1,100,99,0.32919678
2456,Villa Serafini,A,Mid-Imperial Period,9,100,200,100,0.32919678
2457,Villa Serafini,A,Archaic Period,6,-400,-350,50,0.46968547
2457,Villa Serafini,A,Republican Period,7,-350,-200,150,0.46968547
2458,,A,Early Imperial Period,8,1,100,99,0.33217326
2458,,A,Mid-Imperial Period,9,100,200,100,0.33217326
2459,Casale delle Vittorie,A,Early Imperial Period,8,1,100,99,0.34729454
2459,Casale delle Vittorie,A,Mid-Imperial Period,9,100,200,100,0.34729454
2460,Casale delle Vittorie,A,Archaic Period,6,-400,-350,50,0.49356747
2460,Casale delle Vittorie,A,Republican Period,7,-350,-200,150,0.49356747
2461,,A,Late Iron Age,5,-600,-580,20,1.399022
2461,,A,Archaic Period,6,-580,-400,180,1.399022
2461,,B,Republican Period,7,-100,-30,70,0.99141312
2461,,B,Early Imperial Period,8,-30,100,130,0.99141312
2461,,B,Mid-Imperial Period,9,100,200,100,0.99141312
2462,,A,Late Bronze Age,3,-1200,-1020,180,0.11288931
2462,,A,Early Iron Age,4,-1020,-750,270,0.16497435
2462,,A,Late Iron Age,5,-750,-580,170,0.16497435
2462,,A,Archaic Period,6,-580,-350,230,0.16497435
2462,,A,Republican Period,7,-350,-30,320,0.42528638
2462,,A,Early Imperial Period,8,-30,100,130,0.42528638
2462,,A,Mid-Imperial Period,9,100,200,100,0.42528638
2463,,A,Early Iron Age,4,-800,-750,50,0.22854289
2463,,A,Late Iron Age,5,-750,-580,170,0.22854289
2463,,A,Archaic Period,6,-580,-350,230,0.56790435
2463,,A,Republican Period,7,-350,-200,150,0.56790435
2464,,A,Early Iron Age,4,-800,-750,50,0.23504356
2464,,A,Late Iron Age,5,-750,-580,170,0.23504356
2464,,A,Archaic Period,6,-580,-350,230,0.45877042
2464,,A,Republican Period,7,-350,-30,320,0.45877042
2465,,A,Late Iron Age,5,-600,-580,20,0.37719202
2465,,A,Archaic Period,6,-580,-400,180,0.37719202
2466,,A,Early Imperial Period,8,1,100,99,0.26532763
2466,,A,Mid-Imperial Period,9,100,200,100,0.26532763
2467,,A,Late Iron Age,5,-600,-580,20,0.23626707
2467,,A,Archaic Period,6,-580,-400,180,0.23626707
2468,Casale Capobianco,A,Early Imperial Period,8,1,100,99,0.95785624
2468,Casale Capobianco,A,Mid-Imperial Period,9,100,300,200,0.95785624
2469,,A,Middle Bronze Age,2,-1500,-1300,200,0.1494192
2469,,A,Late Bronze Age,3,-1300,-1020,280,0.1494192
2469,,A,Early Iron Age,4,-1020,-1000,20,0.1494192
2470,,A,Republican Period,7,-200,-30,170,0.32063493
2470,,A,Early Imperial Period,8,-30,100,130,0.32063493
2471,Case Nuove,A,Republican Period,7,-100,-30,70,0.49921623
2471,Case Nuove,A,Early Imperial Period,8,-30,100,130,0.19300306
2472,Case Nuove,A,Late Iron Age,5,-600,-580,20,0.71321243
2472,Case Nuove,A,Archaic Period,6,-580,-400,180,0.71321243
2472,Case Nuove,B,Republican Period,7,-100,-30,70,0.23233549
2472,Case Nuove,B,Early Imperial Period,8,-30,100,130,0.23233549
2473,Case Nuove,A,Early Imperial Period,8,1,100,99,0.35704431
2474,Case Nuove,A,Early Imperial Period,8,1,100,99,0.35749766
2474,Case Nuove,A,Mid-Imperial Period,9,100,200,100,0.35749766
2475,Case Nuove,A,Early Imperial Period,8,1,100,99,0.25298887
2476,Case Nuove,A,Archaic Period,6,-500,-350,150,0.78386402
2476,Case Nuove,A,Republican Period,7,-350,-200,150,0.78386402
2476,Case Nuove,B,Early Imperial Period,8,1,100,99,0.20638561
2476,Case Nuove,B,Mid-Imperial Period,9,100,200,100,0.20638561
2477,Case Nuove,A,Late Iron Age,5,-600,-580,20,0.69058251
2477,Case Nuove,A,Archaic Period,6,-580,-400,180,0.69058251
2477,Case Nuove,B,Republican Period,7,-50,-30,20,0.21041547
2477,Case Nuove,B,Early Imperial Period,8,-30,100,130,0.21041547
2478,Case Nuove,A,Late Iron Age,5,-600,-580,20,0.61259568
2478,Case Nuove,A,Archaic Period,6,-580,-350,230,1.5710547
2478,Case Nuove,A,Republican Period,7,-350,-200,150,1.5710547
2479,Case Nuove,A,Early Imperial Period,8,1,100,99,0.34262666
2479,Case Nuove,A,Mid-Imperial Period,9,100,200,100,0.34262666
2480,,A,Republican Period,7,-200,-30,170,0.72313416
2481,,A,Early Imperial Period,8,1,100,99,0.29635656
2482,Riserva Grande,A,Early Imperial Period,8,1,100,99,0.34419969
2482,Riserva Grande,A,Mid-Imperial Period,9,100,200,100,0.34419969
2483,Riserva Grande,A,Archaic Period,6,-500,-350,150,0.64672339
2483,Riserva Grande,A,Republican Period,7,-350,-200,150,0.64672339
2484,Riserva Grande,A,Archaic Period,6,-500,-350,150,0.67199033
2484,Riserva Grande,A,Republican Period,7,-350,-200,150,0.67199033
2485,Riserva Grande,A,Late Iron Age,5,-600,-580,20,0.22182429
2485,Riserva Grande,A,Archaic Period,6,-580,-350,230,0.5241096
2485,Riserva Grande,A,Republican Period,7,-350,-200,150,0.5241096
2485,Riserva Grande,B,Early Imperial Period,8,1,100,99,0.30284223
2485,Riserva Grande,B,Mid-Imperial Period,9,100,200,100,0.30284223
2486,Riserva S. Antonio,A,Late Iron Age,5,-600,-580,20,0.42328152
2486,Riserva S. Antonio,A,Archaic Period,6,-580,-350,230,0.95763749
2486,Riserva S. Antonio,A,Republican Period,7,-350,-200,150,0.95763749
2486,Riserva S. Antonio,B,Early Imperial Period,8,1,100,99,0.3002483
2487,Riserva S. Antonio,A,Late Iron Age,5,-600,-580,20,1.2628458
2487,Riserva S. Antonio,A,Archaic Period,6,-580,-350,230,1.7051029
2487,Riserva S. Antonio,B,Republican Period,7,-350,-30,320,0.5676223
2487,Riserva S. Antonio,B,Early Imperial Period,8,-30,100,130,0.5676223
2487,Riserva S. Antonio,B,Mid-Imperial Period,9,100,200,100,0.5676223
2488,,A,Late Iron Age,5,-600,-580,20,0.16928297
2488,,A,Archaic Period,6,-580,-350,230,0.38426533
2488,,A,Republican Period,7,-350,-200,150,0.38426533
2489,,A,Early Imperial Period,8,1,100,99,0.23151504
2489,,A,Mid-Imperial Period,9,100,200,100,0.23151504
2490,,A,Republican Period,7,-100,-30,70,0.31709513
2490,,A,Early Imperial Period,8,-30,100,130,0.31709513
2491,,A,Late Iron Age,5,-600,-580,20,0.35853314
2491,,A,Archaic Period,6,-580,-350,230,0.69896793
2491,,B,Republican Period,7,-350,-30,320,0.3064706
2491,,B,Early Imperial Period,8,-30,100,130,0.3064706
2492,,A,Late Iron Age,5,-600,-580,20,1.0555911
2492,,A,Archaic Period,6,-580,-400,180,1.0555911
2492,,B,Early Imperial Period,8,1,100,99,0.32500863
2492,,B,Mid-Imperial Period,9,100,200,100,0.32500863
2493,Torre Lupara,A,Early Imperial Period,8,1,100,99,0.32567313
2493,Torre Lupara,A,Mid-Imperial Period,9,100,200,100,0.32567313
2494,Torre Lupara,A,Early Imperial Period,8,1,100,99,0.28812116
2494,Torre Lupara,A,Mid-Imperial Period,9,100,200,100,0.28812116
2495,Fondi di Torre Lupara,A,Early Imperial Period,8,1,100,99,0.2927255
2495,Fondi di Torre Lupara,A,Mid-Imperial Period,9,100,200,100,0.2927255
2496,,A,Late Iron Age,5,-600,-580,20,0.53820199
2496,,A,Archaic Period,6,-580,-350,230,1.1125998
2496,,A,Republican Period,7,-350,-200,150,1.1125998
2497,,A,Late Iron Age,5,-600,-580,20,0.53760737
2497,,A,Archaic Period,6,-580,-350,230,1.0306401
2497,,A,Republican Period,7,-350,-200,150,1.0306401
2497,,B,Early Imperial Period,8,1,100,99,0.2416576
2497,,B,Mid-Imperial Period,9,100,200,100,0.2416576
2498,Torre Lupara,A,Early Imperial Period,8,1,100,99,0.74448836
2498,Torre Lupara,A,Mid-Imperial Period,9,100,200,100,0.74448836
2499,,A,Early Imperial Period,8,1,100,99,0.30555302
2499,,A,Mid-Imperial Period,9,100,200,100,0.30555302
2500,,A,Late Iron Age,5,-600,-580,20,0.22076759
2500,,A,Archaic Period,6,-580,-500,80,0.22076759
2501,,A,Late Iron Age,5,-600,-580,20,0.29114789
2501,,A,Archaic Period,6,-580,-350,230,1.1588192
2501,,A,Republican Period,7,-350,-200,150,1.1588192
2501,,B,Early Imperial Period,8,1,100,99,0.42439336
2501,,B,Mid-Imperial Period,9,100,300,200,0.42439336
2501,,B,Late Imperial Period,10,300,400,100,0.42439336
2502,,A,Early Imperial Period,8,1,100,99,0.75381958
2502,,A,Mid-Imperial Period,9,100,200,100,0.75381958
2503,,A,Archaic Period,6,-500,-350,150,1.1152872
2503,,A,Republican Period,7,-350,-200,150,1.1152872
2503,,B,Early Imperial Period,8,1,100,99,0.51620257
2503,,B,Mid-Imperial Period,9,100,200,100,0.51620257
2503,,C,Late Imperial Period,10,400,500,100,0.51620257
2504,,A,Early Imperial Period,8,1,100,99,0.28669378
2504,,A,Mid-Imperial Period,9,100,200,100,0.28669378
2505,,A,Early Imperial Period,8,1,100,99,0.2169337
2505,,A,Mid-Imperial Period,9,100,200,100,0.2169337
2506,,A,Late Iron Age,5,-700,-580,120,0.46807146
2506,,A,Archaic Period,6,-580,-500,80,0.46807146
2507,Monte Carnale,A,Archaic Period,6,-400,-350,50,0.81188899
2507,Monte Carnale,A,Republican Period,7,-350,-200,150,0.81188899
2507,Monte Carnale,B,Early Imperial Period,8,1,100,99,0.29340693
2508,Fosso S. Lucia,A,Early Iron Age,4,-800,-750,50,0.41155061
2508,Fosso S. Lucia,A,Late Iron Age,5,-750,-580,170,0.41155061
2508,Fosso S. Lucia,A,Archaic Period,6,-580,-350,230,0.98939979
2508,Fosso S. Lucia,A,Republican Period,7,-350,-30,320,0.3564674
2509,,A,Early Imperial Period,8,1,100,99,0.2298799
2510,,A,Early Imperial Period,8,1,100,99,0.26088616
2510,,A,Mid-Imperial Period,9,100,200,100,0.26088616
2511,,A,Archaic Period,6,-400,-350,50,0.55970144
2511,,A,Republican Period,7,-350,-30,320,0.23741646
2511,,A,Early Imperial Period,8,-30,100,130,0.23741646
2511,,A,Mid-Imperial Period,9,100,200,100,0.23741646
2512,,A,Archaic Period,6,-400,-350,50,0.63632596
2512,,A,Republican Period,7,-350,-200,150,0.63632596
2513,,A,Early Imperial Period,8,1,100,99,0.24044621
2513,,A,Mid-Imperial Period,9,100,200,100,0.24044621
2514,,A,Late Iron Age,5,-600,-580,20,0.35406715
2514,,A,Archaic Period,6,-580,-400,180,0.35406715
2514,,B,Early Imperial Period,8,1,100,99,0.29805222
2514,,B,Mid-Imperial Period,9,100,200,100,0.29805222
2515,Quarto di S. Lucia,A,Late Iron Age,5,-600,-580,20,0.38736883
2515,Quarto di S. Lucia,A,Archaic Period,6,-580,-400,180,0.64741915
2516,Quarto di S. Lucia,A,Early Imperial Period,8,1,100,99,0.32224712
2516,Quarto di S. Lucia,A,Mid-Imperial Period,9,100,200,100,0.32224712
2517,Quarto di S. Lucia,A,Late Iron Age,5,-600,-580,20,0.14772741
2517,Quarto di S. Lucia,A,Archaic Period,6,-580,-500,80,0.14772741
2518,Quarto di S. Lucia,A,Archaic Period,6,-500,-350,150,0.85706723
2518,Quarto di S. Lucia,A,Republican Period,7,-350,-200,150,0.85706723
2519,Quarto di S. Lucia,A,Late Iron Age,5,-600,-580,20,0.21356973
2519,Quarto di S. Lucia,A,Archaic Period,6,-580,-500,80,0.21356973
2519,Quarto di S. Lucia,B,Republican Period,7,-100,-30,70,0.22655655
2519,Quarto di S. Lucia,B,Early Imperial Period,8,-30,100,130,0.22655655
2520,Quarto di S. Lucia,A,Late Iron Age,5,-600,-580,20,0.24084653
2520,Quarto di S. Lucia,A,Archaic Period,6,-580,-500,80,0.24084653
2521,Quarto di S. Lucia,A,Early Imperial Period,8,1,100,99,0.32544124
2521,Quarto di S. Lucia,A,Mid-Imperial Period,9,100,200,100,0.32544124
2522,Quarto di Monte Gentile,A,Late Iron Age,5,-600,-580,20,0.21998464
2522,Quarto di Monte Gentile,A,Archaic Period,6,-580,-350,230,0.44429794
2522,Quarto di Monte Gentile,A,Republican Period,7,-350,-200,150,0.44429794
2522,Quarto di S. Lucia,B,Early Imperial Period,8,1,100,99,0.22680354
2522,Quarto di S. Lucia,B,Mid-Imperial Period,9,100,200,100,0.22680354
2523,Torraccia di Monte Gentile,A,Late Iron Age,5,-600,-580,20,0.1486098
2523,Torraccia di Monte Gentile,A,Archaic Period,6,-580,-500,80,0.1486098
2524,Quarto di Monte Gentile,A,Late Iron Age,5,-600,-580,20,0.34219792
2524,Quarto di Monte Gentile,A,Archaic Period,6,-580,-400,180,0.54812562
2524,Quarto di Monte Gentile,B,Republican Period,7,-100,-30,70,0.22271407
2524,Quarto di Monte Gentile,B,Early Imperial Period,8,-30,100,130,0.22271407
2524,Quarto di Monte Gentile,B,Mid-Imperial Period,9,100,300,200,0.22271407
2525,Casale Fonte di Papa,A,Late Iron Age,5,-600,-580,20,0.36684841
2525,Casale Fonte di Papa,A,Archaic Period,6,-580,-350,230,0.89619666
2525,Casale Fonte di Papa,B,Republican Period,7,-350,-30,320,0.27333155
2525,Casale Fonte di Papa,B,Early Imperial Period,8,-30,100,130,0.27333155
2525,Casale Fonte di Papa,B,Mid-Imperial Period,9,100,300,200,0.27333155
2525,Casale Fonte di Papa,B,Late Imperial Period,10,300,400,100,0.27333155
2526,,A,Late Iron Age,5,-600,-580,20,0.13890398
2526,,A,Archaic Period,6,-580,-500,80,0.13890398
2527,,A,Late Iron Age,5,-600,-580,20,0.16671345
2527,,A,Archaic Period,6,-580,-350,230,0.42865455
2527,,A,Republican Period,7,-350,-200,150,0.42865455
2527,,B,Early Imperial Period,8,1,100,99,0.28069627
2527,,B,Mid-Imperial Period,9,100,300,200,0.28069627
2528,,A,Late Iron Age,5,-600,-580,20,0.15032037
2528,,A,Archaic Period,6,-580,-500,80,0.15032037
2529,Riserva di Mezzo,A,Late Iron Age,5,-600,-580,20,0.37804243
2529,Riserva di Mezzo,A,Archaic Period,6,-580,-400,180,0.37804243
2529,Riserva di Mezzo,B,Early Imperial Period,8,1,100,99,0.26798669
2530,Riserva di Mezzo,A,Early Imperial Period,8,1,100,99,0.34001333
2531,Riserva di Mezzo,A,Late Iron Age,5,-600,-580,20,0.35051531
2531,Riserva di Mezzo,A,Archaic Period,6,-580,-350,230,0.69552326
2531,Riserva di Mezzo,A,Republican Period,7,-350,-200,150,0.69552326
2532,Riserva S. Antonio,A,Late Iron Age,5,-600,-580,20,0.2645677
2532,Riserva S. Antonio,A,Archaic Period,6,-580,-350,230,0.58187371
2532,Riserva S. Antonio,A,Republican Period,7,-350,-200,150,0.58187371
2533,Riserva S. Antonio,A,Archaic Period,6,-400,-350,50,0.46860629
2533,Riserva S. Antonio,A,Republican Period,7,-350,-30,320,0.46860629
2533,Riserva S. Antonio,A,Early Imperial Period,8,-30,100,130,0.25723004
2533,Riserva S. Antonio,A,Mid-Imperial Period,9,100,200,100,0.25723004
2534,,A,Late Iron Age,5,-600,-580,20,0.32758719
2534,,A,Archaic Period,6,-580,-400,180,0.32758719
2535,,A,Mid-Imperial Period,9,100,200,100,0.526748
2536,Casale la Pedica,A,Late Iron Age,5,-600,-580,20,0.12193418
2536,Casale la Pedica,A,Archaic Period,6,-580,-500,80,0.12193418
2537,Casale la Pedica,A,Late Iron Age,5,-600,-580,20,0.1673793
2537,Casale la Pedica,A,Archaic Period,6,-580,-400,180,0.1673793
2538,Riserva della Capanna,A,Late Iron Age,5,-600,-580,20,0.788656
2538,Riserva della Capanna,A,Archaic Period,6,-580,-350,230,1.4087726
2538,Riserva della Capanna,A,Republican Period,7,-350,-200,150,1.4087726
2538,Riserva della Capanna,B,Early Imperial Period,8,-30,100,130,0.24097341
2539,Riserva della Capanna,A,Late Iron Age,5,-600,-580,20,0.25360027
2539,Riserva della Capanna,A,Archaic Period,6,-580,-350,230,0.37326732
2539,Riserva della Capanna,A,Republican Period,7,-350,-200,150,0.37326732
2540,Riserva della Capanna,A,Late Iron Age,5,-600,-580,20,0.94387406
2540,Riserva della Capanna,A,Archaic Period,6,-580,-350,230,1.4631985
2540,Riserva della Capanna,B,Republican Period,7,-350,-30,320,1.2625777
2540,Riserva della Capanna,B,Early Imperial Period,8,-30,100,130,1.2625777
2540,Riserva della Capanna,B,Mid-Imperial Period,9,100,200,100,1.2625777
2541,Riserva della Capanna,A,Archaic Period,6,-500,-350,150,1.035526
2541,Riserva della Capanna,A,Republican Period,7,-350,-30,320,0.27565864
2541,Riserva della Capanna,A,Early Imperial Period,8,-30,100,130,0.27565864
2542,Riserva della Capanna,A,Archaic Period,6,-500,-350,150,0.25102887
2542,Riserva della Capanna,B,Republican Period,7,-350,-30,320,0.34815615
2542,Riserva della Capanna,B,Early Imperial Period,8,-30,100,130,0.34815615
2543,Riserva della Capanna,A,Late Iron Age,5,-600,-580,20,0.30798149
2543,Riserva della Capanna,A,Archaic Period,6,-580,-350,230,0.68090594
2543,Riserva della Capanna,A,Republican Period,7,-350,-30,320,0.68090594
2544,,A,Late Iron Age,5,-600,-580,20,0.32377344
2544,,A,Archaic Period,6,-580,-350,230,0.59021491
2544,,A,Republican Period,7,-350,-200,150,0.59021491
2545,Marco Simone Vecchio,A,Late Bronze Age,3,-1300,-1020,280,2.8828943
2545,Marco Simone Vecchio,A,Early Iron Age,4,-1020,-750,270,3.7871296
2545,Marco Simone Vecchio,A,Late Iron Age,5,-750,-580,170,24.606594
2545,Marco Simone Vecchio,A,Archaic Period,6,-580,-350,230,24.606594
2545,Marco Simone Vecchio,A,Republican Period,7,-350,-30,320,13.237075
2545,Marco Simone Vecchio,A,Early Imperial Period,8,-30,100,130,2.2557368
2545,Marco Simone Vecchio,A,Mid-Imperial Period,9,100,300,200,1.0876912
2545,Marco Simone Vecchio,A,Late Imperial Period,10,300,400,100,1.0876912
2546,Marco Simone Vecchio,A,Late Iron Age,5,-600,-580,20,0.4226515
2546,Marco Simone Vecchio,A,Archaic Period,6,-580,-500,80,0.4226515
2547,Casale Marco Simone,A,Late Iron Age,5,-600,-580,20,0.28657034
2547,Casale Marco Simone,A,Archaic Period,6,-580,-350,230,0.49547201
2547,Casale Marco Simone,A,Republican Period,7,-350,-200,150,0.49547201
2548,Casale Marco Simone,A,Late Iron Age,5,-600,-580,20,0.3774519
2548,Casale Marco Simone,A,Archaic Period,6,-580,-500,80,0.3774519
2549,Fosso Capaldo,A,Early Iron Age,4,-800,-750,50,0.41088346
2549,Fosso Capaldo,A,Late Iron Age,5,-750,-580,170,0.41088346
2549,Fosso Capaldo,A,Archaic Period,6,-580,-500,80,0.41088346
2549,Fosso Capaldo,B,Republican Period,7,-100,-30,70,0.25105497
2549,Fosso Capaldo,B,Early Imperial Period,8,-30,100,130,0.25105497
2549,Fosso Capaldo,B,Mid-Imperial Period,9,100,300,200,0.25105497
2549,Fosso Capaldo,B,Late Imperial Period,10,300,400,100,0.25105497
2550,Monte Capaldo,A,Archaic Period,6,-400,-350,50,0.49503478
2550,Monte Capaldo,A,Republican Period,7,-350,-200,150,0.49503478
2551,Monte Capaldo,A,Late Iron Age,5,-600,-580,20,0.29302627
2551,Monte Capaldo,A,Archaic Period,6,-580,-500,80,0.29302627
2551,Monte Capaldo,B,Republican Period,7,-200,-30,170,0.24935056
2551,Monte Capaldo,B,Early Imperial Period,8,-30,100,130,0.24935056
2551,Monte Capaldo,B,Mid-Imperial Period,9,100,200,100,0.24935056
2552,Monte Capaldo,A,Early Imperial Period,8,1,100,99,0.24549
2552,Monte Capaldo,A,Mid-Imperial Period,9,100,200,100,0.24549
2553,Monte del Sorbo,A,Archaic Period,6,-400,-350,50,0.7061733
2553,Monte del Sorbo,A,Republican Period,7,-350,-30,320,0.7061733
2554,,A,Early Imperial Period,8,1,100,99,0.29962471
2554,,A,Mid-Imperial Period,9,100,200,100,0.29962471
2555,,A,Early Imperial Period,8,1,100,99,0.23904161
2555,,A,Mid-Imperial Period,9,100,200,100,0.23904161
2556,Colle Laghetto,A,Early Imperial Period,8,1,100,99,0.25059715
2556,Colle Laghetto,A,Mid-Imperial Period,9,100,200,100,0.25059715
2557,,A,Early Imperial Period,8,1,100,99,0.31002709
2557,,A,Mid-Imperial Period,9,100,200,100,0.31002709
2558,cratere di Marco Simone,A,Middle Bronze Age,2,-1700,-1300,400,0.26802254
2558,cratere di Marco Simone,A,Late Bronze Age,3,-1300,-1020,280,0.26802254
2558,cratere di Marco Simone,B,Early Iron Age,4,-1020,-750,270,0.62644631
2558,cratere di Marco Simone,B,Late Iron Age,5,-750,-580,170,0.32678318
2558,cratere di Marco Simone,B,Archaic Period,6,-580,-500,80,0.32678318
2559,,A,Republican Period,7,-200,-30,170,0.34517553
2559,,A,Early Imperial Period,8,-30,100,130,0.34517553
2559,,A,Mid-Imperial Period,9,100,300,200,0.34517553
2559,,A,Late Imperial Period,10,300,500,200,0.34517553
2560,,A,Late Iron Age,5,-600,-580,20,0.23716831
2560,,A,Archaic Period,6,-580,-350,230,0.56791788
2560,,A,Republican Period,7,-350,-200,150,0.56791788
2561,,A,Archaic Period,6,-500,-350,150,0.70871913
2561,,A,Republican Period,7,-350,-200,150,0.70871913
2561,,B,Early Imperial Period,8,1,100,99,0.30763909
2561,,B,Mid-Imperial Period,9,100,300,200,0.30763909
2561,,B,Late Imperial Period,10,300,400,100,0.30763909
2562,,A,Early Imperial Period,8,-30,100,130,1.0434997
2562,,A,Mid-Imperial Period,9,100,300,200,1.0434997
2562,,A,Late Imperial Period,10,300,400,100,1.0434997
2563,Laghetto di Marco Simone,A,Middle Bronze Age,2,-1700,-1300,400,0.13542922
2563,Laghetto di Marco Simone,A,Late Bronze Age,3,-1300,-1020,280,0.13542922
2563,Laghetto di Marco Simone,A,Early Iron Age,4,-1020,-1000,20,0.13542922
2564,Laghetto di Marco Simone,A,Archaic Period,6,-500,-350,150,1.4659554
2564,Laghetto di Marco Simone,A,Republican Period,7,-350,-200,150,1.4659554
2564,Laghetto di Marco Simone,B,Early Imperial Period,8,-30,100,130,0.28279665
2564,Laghetto di Marco Simone,B,Mid-Imperial Period,9,100,300,200,0.28279665
2565,Laghetto,A,Middle Bronze Age,2,-1700,-1300,400,0.25720254
2565,Laghetto,A,Late Bronze Age,3,-1300,-1020,280,0.25720254
2565,Laghetto,A,Early Iron Age,4,-1020,-1000,20,0.25720254
2566,Tenuta di Marco Simone,A,Late Iron Age,5,-600,-580,20,0.28843099
2566,Tenuta di Marco Simone,A,Archaic Period,6,-580,-400,180,0.28843099
2567,Tenuta di Marco Simone,A,Late Iron Age,5,-600,-580,20,1.172491
2567,Tenuta di Marco Simone,A,Archaic Period,6,-580,-500,80,1.172491
2567,Tenuta di Marco Simone,B,Republican Period,7,-100,-30,70,0.496025
2567,Tenuta di Marco Simone,B,Early Imperial Period,8,-30,100,130,0.496025
2567,Tenuta di Marco Simone,B,Mid-Imperial Period,9,100,300,200,0.496025
2567,Tenuta di Marco Simone,B,Late Imperial Period,10,300,400,100,0.496025
2568,Tenuta della Macchia Marco Simone,A,Late Iron Age,5,-600,-580,20,0.26939788
2568,Tenuta della Macchia Marco Simone,A,Archaic Period,6,-580,-400,180,0.26939788
2569,Tenuta della Macchia Marco Simone,A,Late Iron Age,5,-600,-580,20,0.57922322
2569,Tenuta della Macchia Marco Simone,A,Archaic Period,6,-580,-400,180,0.57922322
2569,Tenuta della Macchia Marco Simone,B,Early Imperial Period,8,1,100,99,0.50835985
2569,Tenuta della Macchia Marco Simone,B,Mid-Imperial Period,9,100,300,200,0.50835985
2569,Tenuta della Macchia Marco Simone,B,Late Imperial Period,10,300,400,100,0.50835985
2570,,A,Republican Period,7,-50,-30,20,0.24668276
2570,,A,Early Imperial Period,8,-30,100,130,0.24668276
2571,Castello Marco Simone,A,Early Iron Age,4,-800,-750,50,0.26924899
2571,Castello Marco Simone,A,Late Iron Age,5,-750,-600,150,0.26924899
2572,,A,Republican Period,7,-200,-30,170,0.69258201
2572,,B,Early Imperial Period,8,-30,100,130,0.69258201
2572,,B,Mid-Imperial Period,9,100,300,200,0.69258201
2572,,B,Late Imperial Period,10,300,400,100,0.69258201
2573,,A,Late Iron Age,5,-600,-580,20,0.3940492
2573,,A,Archaic Period,6,-580,-350,230,0.99174994
2573,,A,Republican Period,7,-350,-200,150,0.99174994
2574,Monte d'Oro,A,Archaic Period,6,-400,-350,50,0.60720915
2574,Monte d'Oro,A,Republican Period,7,-350,-200,150,0.60720915
2574,Monte d'Oro,B,Early Imperial Period,8,1,100,99,0.26403847
2574,Monte d'Oro,B,Mid-Imperial Period,9,100,300,200,0.26403847
2574,Monte d'Oro,B,Late Imperial Period,10,300,400,100,0.26403847
2575,Monte d'Oro,A,Late Iron Age,5,-600,-580,20,0.37099391
2575,Monte d'Oro,A,Archaic Period,6,-580,-500,80,0.37099391
2576,Monte d'Oro,A,Early Imperial Period,8,1,100,99,0.29763472
2577,Tenuta di Marco Simone,A,Late Iron Age,5,-600,-580,20,0.15734662
2577,Tenuta di Marco Simone,A,Archaic Period,6,-580,-500,80,0.15734662
2577,Tenuta di Marco Simone,B,Early Imperial Period,8,1,100,99,0.26380974
2577,Tenuta di Marco Simone,B,Mid-Imperial Period,9,100,200,100,0.26380974
2578,Tenuta di Marco Simone,A,Archaic Period,6,-400,-350,50,0.57321388
2578,Tenuta di Marco Simone,A,Republican Period,7,-350,-100,250,0.57321388
2579,Tenuta della Macchia di Marco Simone,A,Late Iron Age,5,-600,-580,20,0.78323799
2579,Tenuta della Macchia di Marco Simone,A,Archaic Period,6,-580,-350,230,1.2750487
2579,Tenuta della Macchia di Marco Simone,A,Republican Period,7,-350,-200,150,1.2750487
2579,Tenuta della Macchia di Marco Simone,B,Early Imperial Period,8,1,100,99,0.41730851
2579,Tenuta della Macchia di Marco Simone,B,Mid-Imperial Period,9,100,300,200,0.41730851
2579,Tenuta della Macchia di Marco Simone,B,Late Imperial Period,10,300,400,100,0.41730851
2580,,A,Late Iron Age,5,-600,-580,20,0.29710963
2580,,A,Archaic Period,6,-580,-350,230,0.82492161
2580,,A,Republican Period,7,-350,-200,150,0.82492161
2581,,A,Late Iron Age,5,-600,-580,20,0.71798718
2581,,A,Archaic Period,6,-580,-400,180,0.71798718
2581,,B,Republican Period,7,-100,-30,70,0.34213057
2581,,B,Early Imperial Period,8,-30,100,130,0.34213057
2582,,A,Late Iron Age,5,-600,-580,20,0.16259854
2582,,A,Archaic Period,6,-580,-500,80,0.16259854
2583,,A,Late Iron Age,5,-600,-580,20,0.24790224
2583,,A,Archaic Period,6,-580,-350,230,1.123368
2583,,A,Republican Period,7,-350,-30,320,1.123368
2583,,A,Early Imperial Period,8,-30,100,130,0.43162972
2583,,A,Mid-Imperial Period,9,100,200,100,0.43162972
2584,,A,Archaic Period,6,-400,-350,50,0.4249514
2584,,A,Republican Period,7,-350,-200,150,0.4249514
2585,,A,Early Imperial Period,8,1,100,99,0.250442
2585,,A,Mid-Imperial Period,9,100,200,100,0.250442
2586,,A,Late Iron Age,5,-600,-580,20,1.0955575
2586,,A,Archaic Period,6,-580,-350,230,2.2303748
2586,,A,Republican Period,7,-350,-30,320,2.2303748
2586,,A,Early Imperial Period,8,-30,100,130,0.89986289
2587,,A,Late Iron Age,5,-600,-580,20,0.18847398
2587,,A,Archaic Period,6,-580,-350,230,0.39821044
2587,,A,Republican Period,7,-350,-200,150,0.39821044
2588,,A,Archaic Period,6,-500,-400,100,0.54837155
2588,,B,Early Imperial Period,8,1,100,99,0.20147222
2588,,B,Mid-Imperial Period,9,100,200,100,0.20147222
2589,,A,Late Iron Age,5,-600,-580,20,0.2851941
2589,,A,Archaic Period,6,-580,-500,80,0.2851941
2590,,A,Late Iron Age,5,-600,-580,20,0.36040527
2590,,A,Archaic Period,6,-580,-500,80,0.36040527
2591,Tenuta Piscarelli,A,Late Iron Age,5,-600,-580,20,0.70383418
2591,Tenuta Piscarelli,A,Archaic Period,6,-580,-500,80,0.70383418
2591,Tenuta Piscarelli,B,Early Imperial Period,8,1,100,99,0.29108843
2591,Tenuta Piscarelli,B,Mid-Imperial Period,9,100,200,100,0.29108843
2592,,A,Late Iron Age,5,-600,-580,20,0.605142
2592,,A,Archaic Period,6,-580,-400,180,0.605142
2593,Monte dello Spavento,A,Early Imperial Period,8,1,100,99,0.4315562
2593,Monte dello Spavento,A,Mid-Imperial Period,9,100,200,100,0.4315562
2594,Monte dello Spavento,A,Late Iron Age,5,-600,-580,20,0.69601673
2594,Monte dello Spavento,A,Archaic Period,6,-580,-350,230,1.2942541
2594,Monte dello Spavento,A,Republican Period,7,-350,-200,150,1.2942541
2594,Monte dello Spavento,B,Early Imperial Period,8,1,100,99,0.28454939
2594,Monte dello Spavento,B,Mid-Imperial Period,9,100,300,200,0.28454939
2594,Monte dello Spavento,B,Late Imperial Period,10,300,400,100,0.28454939
2595,,A,Late Iron Age,5,-600,-580,20,0.84451097
2595,,A,Archaic Period,6,-580,-500,80,0.84451097
2595,,B,Early Imperial Period,8,1,100,99,0.62754524
2595,,B,Mid-Imperial Period,9,100,200,100,0.62754524
2596,Casale Forno,A,Late Iron Age,5,-600,-580,20,0.27026084
2596,Casale Forno,A,Archaic Period,6,-580,-500,80,0.27026084
2597,Riserva Cacciatore,A,Late Iron Age,5,-600,-580,20,0.21815327
2597,Riserva Cacciatore,A,Archaic Period,6,-580,-500,80,0.21815327
2598,Riserva Cacciatore,A,Late Iron Age,5,-600,-580,20,0.55849391
2598,Riserva Cacciatore,A,Archaic Period,6,-580,-350,230,0.87980843
2598,Riserva Cacciatore,A,Republican Period,7,-350,-30,320,0.87980843
2598,Riserva Cacciatore,A,Early Imperial Period,8,-30,100,130,0.20581008
2598,Riserva Cacciatore,A,Mid-Imperial Period,9,100,200,100,0.20581008
2599,Casale Ovile,A,Late Iron Age,5,-600,-580,20,0.2257484
2599,Casale Ovile,A,Archaic Period,6,-580,-500,80,0.2257484
2600,Riserva Cacciatore,A,Late Iron Age,5,-600,-580,20,0.18375027
2600,Riserva Cacciatore,A,Archaic Period,6,-580,-500,80,0.18375027
2601,,A,Early Imperial Period,8,1,100,99,0.3430914
2601,,A,Mid-Imperial Period,9,100,200,100,0.3430914
2602,Riserva Cacciatore,A,Archaic Period,6,-500,-350,150,0.81451094
2602,Riserva Cacciatore,A,Republican Period,7,-350,-200,150,0.81451094
2602,Riserva Cacciatore,B,Early Imperial Period,8,1,100,99,0.23603252
2602,Riserva Cacciatore,B,Mid-Imperial Period,9,100,200,100,0.23603252
2603,Riserva Cacciatore,A,Late Iron Age,5,-600,-580,20,0.44692481
2603,Riserva Cacciatore,A,Archaic Period,6,-580,-400,180,0.44692481
2603,Riserva Cacciatore,B,Early Imperial Period,8,1,100,99,0.22077088
2603,Riserva Cacciatore,B,Mid-Imperial Period,9,100,200,100,0.22077088
2604,Casale di Pratolungo,A,Late Iron Age,5,-600,-580,20,0.57149559
2604,Casale di Pratolungo,A,Archaic Period,6,-580,-500,80,0.57149559
2604,Casale di Pratolungo,B,Early Imperial Period,8,1,100,99,0.5361864
2604,Casale di Pratolungo,B,Mid-Imperial Period,9,100,200,100,0.5361864
2605,,A,Archaic Period,6,-500,-350,150,0.86347055
2605,,A,Republican Period,7,-350,-200,150,0.86347055
2606,,A,Late Iron Age,5,-600,-580,20,0.1315026
2606,,A,Archaic Period,6,-580,-500,80,0.1315026
2607,,A,Early Imperial Period,8,1,100,99,0.31811389
2607,,A,Mid-Imperial Period,9,100,200,100,0.31811389
2608,,A,Late Iron Age,5,-700,-580,120,0.2904318
2608,,A,Archaic Period,6,-580,-350,230,0.73152345
2608,,A,Republican Period,7,-350,-200,150,0.73152345
2609,,A,Late Iron Age,5,-600,-580,20,0.43660861
2609,,A,Archaic Period,6,-580,-350,230,0.72124922
2609,,A,Republican Period,7,-350,-30,320,0.21495843
2609,,A,Early Imperial Period,8,-30,100,130,0.21495843
2610,,A,Late Iron Age,5,-600,-580,20,0.23935941
2610,,A,Archaic Period,6,-580,-500,80,0.23935941
2611,,A,Late Iron Age,5,-600,-580,20,0.15852155
2611,,A,Archaic Period,6,-580,-500,80,0.15852155
2611,,B,Early Imperial Period,8,1,100,99,0.27466074
2612,,A,Late Iron Age,5,-700,-580,120,0.17164482
2612,,A,Archaic Period,6,-580,-350,230,0.33817184
2612,,A,Republican Period,7,-350,-200,150,0.33817184
2613,,A,Late Iron Age,5,-700,-580,120,0.070863165
2613,,A,Archaic Period,6,-580,-350,230,0.21468914
2613,,A,Republican Period,7,-350,-200,150,0.21468914
2614,,A,Late Iron Age,5,-600,-580,20,0.38976714
2614,,A,Archaic Period,6,-580,-400,180,0.38976714
2615,,A,Late Iron Age,5,-700,-580,120,0.18280523
2615,,A,Archaic Period,6,-580,-350,230,0.40904811
2615,,A,Republican Period,7,-350,-30,320,0.40904811
2616,Fondi di Monastero,A,Early Imperial Period,8,1,100,99,0.24015814
2616,Fondi di Monastero,A,Mid-Imperial Period,9,100,200,100,0.24015814
2617,Fondi di Monastero,A,Archaic Period,6,-400,-350,50,0.42153493
2617,Fondi di Monastero,A,Republican Period,7,-350,-200,150,0.42153493
2618,Fondi di Monastero,A,Early Imperial Period,8,1,100,99,0.34673813
2618,Fondi di Monastero,A,Mid-Imperial Period,9,100,200,100,0.34673813
2619,Fondi di Monastero,A,Late Iron Age,5,-600,-580,20,0.29411504
2619,Fondi di Monastero,A,Archaic Period,6,-580,-400,180,0.29411504
2620,Fondi di Monastero,A,Early Imperial Period,8,1,100,99,0.26930717
2620,Fondi di Monastero,A,Mid-Imperial Period,9,100,200,100,0.26930717
2621,Fondi di Coazzo,A,Late Iron Age,5,-600,-580,20,0.2656163
2621,Fondi di Coazzo,A,Archaic Period,6,-580,-350,230,0.40616786
2621,Fondi di Coazzo,A,Republican Period,7,-350,-30,320,0.40616786
2622,,A,Late Iron Age,5,-600,-580,20,0.1961952
2622,,A,Archaic Period,6,-580,-350,230,0.47454214
2622,,A,Republican Period,7,-350,-200,150,0.47454214
2623,,A,Early Imperial Period,8,1,100,99,0.24383107
2623,,A,Mid-Imperial Period,9,100,200,100,0.24383107
2624,Fondi di Coazzo,A,Archaic Period,6,-500,-350,150,0.32781351
2624,Fondi di Coazzo,A,Republican Period,7,-350,-200,150,0.32781351
2625,Tenuta di S. Basilio,A,Late Iron Age,5,-600,-580,20,0.57624561
2625,Tenuta di S. Basilio,A,Archaic Period,6,-580,-350,230,0.83110291
2625,Tenuta di S. Basilio,A,Republican Period,7,-350,-200,150,0.83110291
2627,Tenuta di S. Basilio,A,Archaic Period,6,-500,-400,100,0.17651264
2628,Tenuta di S. Basilio,A,Late Iron Age,5,-600,-580,20,0.67850429
2628,Tenuta di S. Basilio,A,Archaic Period,6,-580,-400,180,0.67850429
2628,Tenuta di S. Basilio,B,Republican Period,7,-100,-30,70,0.1740226
2628,Tenuta di S. Basilio,B,Early Imperial Period,8,-30,100,130,0.1740226
2628,Tenuta di S. Basilio,B,Mid-Imperial Period,9,100,300,200,0.1740226
2629,,A,Late Iron Age,5,-600,-580,20,0.47235605
2629,,A,Archaic Period,6,-580,-500,80,0.47235605
2629,,B,Early Imperial Period,8,1,100,99,0.26052323
2629,,B,Mid-Imperial Period,9,100,200,100,0.26052323
2630,,A,Early Imperial Period,8,1,100,99,0.29570639
2630,,A,Mid-Imperial Period,9,100,200,100,0.29570639
2631,,A,Late Iron Age,5,-600,-580,20,0.27377763
2631,,A,Archaic Period,6,-580,-350,230,0.53823763
2631,,A,Republican Period,7,-350,-200,150,0.53823763
2631,,B,Early Imperial Period,8,1,100,99,0.2328285
2632,Fondi di Monastero,A,Late Iron Age,5,-600,-580,20,0.33507118
2632,Fondi di Monastero,A,Archaic Period,6,-580,-500,80,0.33507118
2633,Fondi di Monastero,A,Late Iron Age,5,-600,-580,20,0.19438469
2633,Fondi di Monastero,A,Archaic Period,6,-580,-500,80,0.19438469
2634,,A,Archaic Period,6,-400,-350,50,0.39048383
2634,,A,Republican Period,7,-350,-200,150,0.39048383
2635,,A,Early Imperial Period,8,1,100,99,0.27420065
2635,,A,Mid-Imperial Period,9,100,200,100,0.27420065
2636,,A,Early Imperial Period,8,1,100,99,0.22405738
2636,,A,Mid-Imperial Period,9,100,200,100,0.22405738
2637,Casale Monastero,A,Mid-Imperial Period,9,100,200,100,0.45901296
2638,,A,Late Iron Age,5,-600,-580,20,0.23640785
2638,,A,Archaic Period,6,-580,-500,80,0.23640785
2638,,B,Early Imperial Period,8,1,100,99,0.25268674
2638,,B,Mid-Imperial Period,9,100,200,100,0.25268674
2639,,A,Early Imperial Period,8,1,100,99,0.23877501
2639,,A,Mid-Imperial Period,9,100,200,100,0.23877501
2640,,A,Early Imperial Period,8,1,100,99,0.17590418
2640,,A,Mid-Imperial Period,9,100,200,100,0.17590418
2641,,A,Late Iron Age,5,-600,-580,20,0.88342249
2641,,A,Archaic Period,6,-580,-400,180,0.88342249
2641,,B,Republican Period,7,-100,-30,70,0.17353462
2641,,B,Early Imperial Period,8,-30,100,130,0.17353462
2642,,A,Early Imperial Period,8,1,100,99,0.24375238
2642,,A,Mid-Imperial Period,9,100,200,100,0.24375238
2643,,A,Archaic Period,6,-500,-400,100,0.7110281
2643,,B,Republican Period,7,-100,-30,70,0.57727468
2643,,B,Early Imperial Period,8,-30,100,130,0.57727468
2643,,B,Mid-Imperial Period,9,100,300,200,0.57727468
2643,,B,Late Imperial Period,10,300,400,100,0.57727468
2644,,A,Late Iron Age,5,-600,-580,20,0.28942782
2644,,A,Archaic Period,6,-580,-500,80,0.28942782
2645,,A,Archaic Period,6,-400,-350,50,0.72223794
2645,,A,Republican Period,7,-350,-200,150,0.72223794
2646,,A,Early Imperial Period,8,1,100,99,0.27843177
2646,,A,Mid-Imperial Period,9,100,200,100,0.27843177
2647,,A,Early Imperial Period,8,1,100,99,0.29719305
2647,,A,Mid-Imperial Period,9,100,200,100,0.29719305
2648,Casale nuovo di Aguzzano,A,Late Iron Age,5,-600,-580,20,0.47178575
2648,Casale nuovo di Aguzzano,A,Archaic Period,6,-580,-350,230,0.7762028
2648,Casale nuovo di Aguzzano,B,Republican Period,7,-350,-30,320,0.19533145
2649,,A,Late Iron Age,5,-600,-580,20,0.13993551
2649,,A,Archaic Period,6,-580,-500,80,0.13993551
2650,,A,Early Imperial Period,8,1,100,99,0.34486762
2650,,A,Mid-Imperial Period,9,100,200,100,0.34486762
2651,,A,Archaic Period,6,-500,-350,150,0.47626731
2651,,A,Republican Period,7,-350,-200,150,0.47626731
2651,,B,Early Imperial Period,8,1,100,99,0.16816394
2651,,B,Mid-Imperial Period,9,100,200,100,0.16816394
2652,Torre Rebibbia,A,Late Iron Age,5,-600,-580,20,0.67395473
2652,Torre Rebibbia,A,Archaic Period,6,-580,-500,80,0.67395473
2653,Torre di Aguzzano,A,Archaic Period,6,-500,-350,150,0.57340443
2653,Torre di Aguzzano,B,Republican Period,7,-350,-30,320,0.55725849
2653,Torre di Aguzzano,B,Early Imperial Period,8,-30,100,130,0.55725849
2653,Torre di Aguzzano,B,Mid-Imperial Period,9,100,200,100,0.55725849
2654,,A,Early Imperial Period,8,1,100,99,0.17762084
2654,,A,Mid-Imperial Period,9,100,200,100,0.17762084
2655,,A,Republican Period,7,-200,-30,170,0.71142942
2655,,A,Early Imperial Period,8,-30,100,130,0.71142942
2655,,A,Mid-Imperial Period,9,100,300,200,0.71142942
2655,,A,Late Imperial Period,10,300,400,100,0.71142942
2656,,A,Early Imperial Period,8,1,100,99,0.21766597
2656,,A,Mid-Imperial Period,9,100,200,100,0.21766597
2657,,A,Early Imperial Period,8,1,100,99,0.17368902
2657,,A,Mid-Imperial Period,9,100,200,100,0.17368902
2658,,A,Late Iron Age,5,-700,-580,120,3.475673
2658,,A,Archaic Period,6,-580,-350,230,4.926302
2658,,A,Republican Period,7,-350,-30,320,2.5980022
2658,,A,Early Imperial Period,8,-30,100,130,0.45939353
2658,,A,Mid-Imperial Period,9,100,200,100,0.45939353
2659,,A,Early Imperial Period,8,1,100,99,0.40276474
2659,,A,Mid-Imperial Period,9,100,300,200,0.40276474
2659,,A,Late Imperial Period,10,300,400,100,0.40276474
2660,,A,Early Imperial Period,8,1,100,99,0.26097307
2660,,A,Mid-Imperial Period,9,100,200,100,0.26097307
2661,,A,Early Imperial Period,8,1,100,99,0.26098067
2661,,A,Mid-Imperial Period,9,100,200,100,0.26098067
2662,,A,Late Iron Age,5,-600,-580,20,2.0980401
2662,,A,Archaic Period,6,-580,-350,230,2.0980401
2662,,A,Republican Period,7,-350,-30,320,0.91381174
2662,,B,Early Imperial Period,8,1,100,99,0.83543909
2662,,B,Mid-Imperial Period,9,100,200,100,0.22027859
2663,,A,Early Imperial Period,8,1,100,99,0.18890375
2663,,A,Mid-Imperial Period,9,100,200,100,0.18890375
2664,,A,Early Imperial Period,8,1,100,99,0.21135445
2664,,A,Mid-Imperial Period,9,100,200,100,0.21135445
2665,,A,Early Imperial Period,8,1,100,99,0.28303394
2665,,A,Mid-Imperial Period,9,100,200,100,0.28303394
2666,Casale Tabaccaia,A,Early Imperial Period,8,1,100,99,0.7167455
2666,Casale Tabaccaia,A,Mid-Imperial Period,9,100,200,100,0.7167455
2667,,A,Early Imperial Period,8,1,100,99,0.29180318
2667,,A,Mid-Imperial Period,9,100,200,100,0.29180318
2668,,A,Early Imperial Period,8,1,100,99,0.23838452
2668,,A,Mid-Imperial Period,9,100,300,200,0.23838452
2668,,A,Late Imperial Period,10,300,400,100,0.23838452
2669,,A,Early Imperial Period,8,1,100,99,0.24665141
2670,,A,Late Iron Age,5,-600,-580,20,1.0765524
2670,,A,Archaic Period,6,-580,-400,180,1.0765524
2670,,B,Republican Period,7,-200,-30,170,0.24153806
2670,,B,Early Imperial Period,8,-30,100,130,0.24153806
2671,,A,Early Imperial Period,8,1,100,99,0.28209829
2671,,A,Mid-Imperial Period,9,100,200,100,0.28209829
2672,,A,Republican Period,7,-100,-30,70,0.65451133
2672,,A,Early Imperial Period,8,-30,100,130,0.65451133
2672,,A,Mid-Imperial Period,9,100,300,200,0.65451133
2672,,A,Late Imperial Period,10,300,400,100,0.65451133
2673,,A,Early Imperial Period,8,1,100,99,0.25084689
2673,,A,Mid-Imperial Period,9,100,200,100,0.25084689
2674,,A,Early Imperial Period,8,1,100,99,0.25084507
2674,,A,Mid-Imperial Period,9,100,200,100,0.25084507
2675,,A,Late Iron Age,5,-600,-580,20,0.87740183
2675,,A,Archaic Period,6,-580,-350,230,0.98032308
2675,,A,Republican Period,7,-350,-200,150,0.98032308
2676,,A,Archaic Period,6,-500,-350,150,1.043366
2676,,A,Republican Period,7,-350,-200,150,1.043366
2677,,A,Early Imperial Period,8,1,100,99,0.21227027
2677,,A,Mid-Imperial Period,9,100,200,100,0.21227027
2678,,A,Early Imperial Period,8,1,100,99,0.3439365
2678,,A,Mid-Imperial Period,9,100,200,100,0.3439365
2679,,A,Early Imperial Period,8,1,100,99,0.23050928
2679,,A,Mid-Imperial Period,9,100,200,100,0.23050928
2680,,A,Early Imperial Period,8,1,100,99,0.29837015
2681,,A,Republican Period,7,-100,-30,70,0.26961923
2681,,A,Early Imperial Period,8,-30,100,130,0.26961923
2681,,A,Mid-Imperial Period,9,100,200,100,0.26961923
2682,,A,Late Iron Age,5,-600,-580,20,0.73743415
2682,,A,Archaic Period,6,-580,-400,180,0.73743415
2683,,A,Late Iron Age,5,-600,-580,20,1.0453994
2683,,A,Archaic Period,6,-580,-500,80,1.0453994
2684,,A,Late Iron Age,5,-600,-580,20,0.46968889
2684,,A,Archaic Period,6,-580,-500,80,0.46968889
2684,,B,Early Imperial Period,8,1,100,99,0.21659842
2684,,B,Mid-Imperial Period,9,100,200,100,0.21659842
2685,,A,Early Imperial Period,8,1,100,99,0.29469246
2685,,A,Mid-Imperial Period,9,100,200,100,0.29469246
2686,,A,Late Iron Age,5,-600,-580,20,0.45552167
2686,,A,Archaic Period,6,-580,-350,230,0.78685635
2686,,A,Republican Period,7,-350,-200,150,0.78685635
2686,,B,Early Imperial Period,8,1,100,99,0.1836513
2686,,B,Mid-Imperial Period,9,100,200,100,0.1836513
2687,Casale delle Capannacce,A,Early Imperial Period,8,1,100,99,0.24953379
2687,Casale delle Capannacce,A,Mid-Imperial Period,9,100,200,100,0.24953379
2688,Casale delle Capannacce,A,Early Imperial Period,8,1,100,99,0.29665402
2688,Casale delle Capannacce,A,Mid-Imperial Period,9,100,200,100,0.29665402
2689,Casale delle Capannacce,A,Early Imperial Period,8,1,100,99,0.29665366
2689,Casale delle Capannacce,A,Mid-Imperial Period,9,100,200,100,0.29665366
2690,,A,Early Imperial Period,8,1,100,99,0.27578753
2690,,A,Mid-Imperial Period,9,100,200,100,0.27578753
2691,,A,Early Imperial Period,8,1,100,99,0.30255914
2691,,A,Mid-Imperial Period,9,100,200,100,0.30255914
2692,,A,Early Imperial Period,8,1,100,99,0.29560003
2692,,A,Mid-Imperial Period,9,100,200,100,0.29560003
2693,,A,Early Imperial Period,8,1,100,99,0.32225403
2693,,A,Mid-Imperial Period,9,100,200,100,0.32225403
2694,,A,Republican Period,7,-100,-30,70,0.28773984
2694,,A,Early Imperial Period,8,-30,100,130,0.28773984
2694,,A,Mid-Imperial Period,9,100,300,200,0.28773984
2695,,A,Early Imperial Period,8,1,100,99,0.37700564
2695,,A,Mid-Imperial Period,9,100,200,100,0.37700564
2696,Vignaccia,A,Early Imperial Period,8,1,100,99,0.28200474
2696,Vignaccia,A,Mid-Imperial Period,9,100,200,100,0.28200474
2697,Vignaccia,A,Early Imperial Period,8,1,100,99,0.27635896
2697,Vignaccia,A,Mid-Imperial Period,9,100,200,100,0.27635896
2698,I Casaletti,A,Late Iron Age,5,-600,-580,20,1.309839
2698,I Casaletti,A,Archaic Period,6,-580,-400,180,1.309839
2698,I Casaletti,B,Early Imperial Period,8,1,100,99,0.25036323
2698,I Casaletti,B,Mid-Imperial Period,9,100,200,100,0.25036323
2699,I Casaletti,A,Republican Period,7,-100,-30,70,0.23275672
2699,I Casaletti,A,Early Imperial Period,8,-30,100,130,0.23275672
2699,I Casaletti,A,Mid-Imperial Period,9,100,200,100,0.23275672
2700,,A,Late Iron Age,5,-600,-580,20,0.93624032
2700,,A,Archaic Period,6,-580,-400,180,0.93624032
2700,,B,Early Imperial Period,8,1,100,99,0.19474344
2700,,B,Mid-Imperial Period,9,100,200,100,0.19474344
2701,,A,Late Iron Age,5,-600,-580,20,0.35617059
2701,,A,Archaic Period,6,-580,-500,80,0.35617059
2702,,A,Late Iron Age,5,-600,-580,20,0.6523692
2702,,A,Archaic Period,6,-580,-350,230,1.6808871
2702,,A,Republican Period,7,-350,-30,320,1.6808871
2702,,A,Early Imperial Period,8,-30,100,130,0.28988466
2703,,A,Late Iron Age,5,-600,-580,20,0.72352916
2703,,A,Archaic Period,6,-580,-400,180,0.72352916
2703,,A,Early Imperial Period,8,1,100,99,0.22266567
2704,,A,Late Iron Age,5,-600,-580,20,0.17026913
2704,,A,Archaic Period,6,-580,-500,80,0.17026913
2705,,A,Archaic Period,6,-500,-350,150,0.60507846
2705,,A,Republican Period,7,-350,-200,150,0.60507846
2706,,A,Late Iron Age,5,-600,-580,20,0.8029083
2706,,A,Archaic Period,6,-580,-350,230,1.7808069
2706,,A,Republican Period,7,-350,-200,150,1.7808069
2706,,B,Early Imperial Period,8,1,100,99,0.24142244
2706,,B,Mid-Imperial Period,9,100,200,100,0.24142244
2707,,A,Late Iron Age,5,-600,-580,20,1.7628925
2707,,A,Archaic Period,6,-580,-500,80,1.7628925
2708,,A,Early Imperial Period,8,1,100,99,0.31152976
2708,,A,Mid-Imperial Period,9,100,200,100,0.31152976
2709,,A,Early Imperial Period,8,1,100,99,0.27555001
2709,,A,Mid-Imperial Period,9,100,200,100,0.27555001
2710,,A,Early Imperial Period,8,1,100,99,0.25101602
2710,,A,Mid-Imperial Period,9,100,200,100,0.25101602
2711,,A,Early Imperial Period,8,1,100,99,0.22567153
2711,,A,Mid-Imperial Period,9,100,200,100,0.22567153
2712,,A,Late Iron Age,5,-600,-580,20,0.35170344
2712,,A,Archaic Period,6,-580,-350,230,0.7546078
2712,,A,Republican Period,7,-350,-30,320,0.7546078
2713,tenuta di S. Eusebio,A,Mid-Imperial Period,9,100,300,200,0.61072445
2713,tenuta di S. Eusebio,A,Late Imperial Period,10,300,400,100,0.61072445
2714,,A,Late Iron Age,5,-600,-580,20,0.37519264
2714,,A,Archaic Period,6,-580,-400,180,0.37519264
2715,,A,Early Imperial Period,8,1,100,99,0.31257963
2715,,A,Mid-Imperial Period,9,100,200,100,0.31257963
2716,Quarto S. Eusebio,A,Late Iron Age,5,-600,-580,20,0.62791139
2716,Quarto S. Eusebio,A,Archaic Period,6,-580,-500,80,0.62791139
2716,Quarto S. Eusebio,B,Early Imperial Period,8,1,100,99,0.21634944
2716,Quarto S. Eusebio,B,Mid-Imperial Period,9,100,200,100,0.21634944
2717,Colle S. Antonio,A,Early Imperial Period,8,1,100,99,1.6034058
2717,Colle S. Antonio,A,Mid-Imperial Period,9,100,300,200,1.6034058
2717,Colle S. Antonio,A,Late Imperial Period,10,300,500,200,1.6034058
2718,colle Vitriano,A,Republican Period,7,-200,-30,170,0.64913404
2718,colle Vitriano,A,Early Imperial Period,8,-30,100,130,1.6140561
2718,colle Vitriano,A,Mid-Imperial Period,9,100,300,200,1.6140561
2718,colle Vitriano,A,Late Imperial Period,10,300,500,200,1.6140561
2719,colle Vitriano,A,Republican Period,7,-200,-30,170,1.1129425
2719,colle Vitriano,A,Early Imperial Period,8,-30,100,130,1.1129425
2719,colle Vitriano,A,Mid-Imperial Period,9,100,300,200,1.1129425
2719,colle Vitriano,A,Late Imperial Period,10,300,500,200,1.1129425
2720,colle Vitriano,A,Republican Period,7,-200,-30,170,0.47378469
2720,colle Vitriano,A,Early Imperial Period,8,-30,100,130,0.47378469
2720,colle Vitriano,A,Mid-Imperial Period,9,100,300,200,0.47378469
2720,colle Vitriano,A,Late Imperial Period,10,300,500,200,0.47378469
2721,colle Vitriano,A,Late Iron Age,5,-600,-580,20,0.71516293
2721,colle Vitriano,A,Archaic Period,6,-580,-500,80,0.71516293
2721,colle Vitriano,B,Early Imperial Period,8,-30,100,130,0.71516293
2721,colle Vitriano,B,Mid-Imperial Period,9,100,300,200,0.71516293
2721,colle Vitriano,B,Late Imperial Period,10,300,500,200,0.71516293
2722,colle Vitriano,A,Republican Period,7,-100,-30,70,1.1449302
2723,colle Lecinone,A,Republican Period,7,-200,-30,170,1.0037457
2723,colle Lecinone,A,Early Imperial Period,8,-30,100,130,1.0037457
2723,colle Lecinone,A,Mid-Imperial Period,9,100,300,200,1.0037457
2723,colle Lecinone,A,Late Imperial Period,10,300,500,200,1.0037457
2724,Scalzacane,A,Republican Period,7,-200,-30,170,1.292945
2724,Scalzacane,A,Early Imperial Period,8,-30,100,130,1.292945
2724,Scalzacane,A,Mid-Imperial Period,9,100,300,200,1.292945
2724,Scalzacane,A,Late Imperial Period,10,300,500,200,1.292945
2725,Scalzacane,A,Republican Period,7,-100,-30,70,2.0071666
2725,Scalzacane,A,Early Imperial Period,8,-30,100,130,2.0071666
2725,Scalzacane,A,Mid-Imperial Period,9,100,300,200,2.0071666
2725,Scalzacane,A,Late Imperial Period,10,300,500,200,2.0071666
2726,,A,Early Imperial Period,8,-30,100,130,0.84281307
2726,,A,Mid-Imperial Period,9,100,300,200,0.84281307
2726,,A,Late Imperial Period,10,300,500,200,0.84281307
2727,,A,Republican Period,7,-200,-30,170,0.77843457
2727,,A,Early Imperial Period,8,-30,100,130,0.77843457
2727,,A,Mid-Imperial Period,9,100,300,200,0.77843457
2727,,A,Late Imperial Period,10,300,500,200,0.77843457
2728,,A,Republican Period,7,-100,-30,70,0.75853527
2728,,A,Early Imperial Period,8,-30,100,130,0.75853527
2728,,A,Mid-Imperial Period,9,100,300,200,0.75853527
2728,,A,Late Imperial Period,10,300,500,200,0.75853527
2729,,A,Archaic Period,6,-500,-350,150,0.50076759
2729,,A,Republican Period,7,-350,-200,150,0.50076759
2730,,A,Archaic Period,6,-500,-350,150,0.53073555
2730,,A,Republican Period,7,-350,-200,150,0.53073555
2731,,A,Republican Period,7,-200,-30,170,0.95479447
2731,,A,Early Imperial Period,8,-30,100,130,0.95479447
2731,,A,Mid-Imperial Period,9,100,300,200,0.95479447
2731,,A,Late Imperial Period,10,300,500,200,0.95479447
2732,,A,Early Imperial Period,8,-30,100,130,0.32469812
2732,,A,Mid-Imperial Period,9,100,300,200,0.32469812
2732,,A,Late Imperial Period,10,300,500,200,0.32469812
2733,,A,Archaic Period,6,-400,-350,50,0.40142757
2733,,A,Republican Period,7,-350,-200,150,0.40142757
2734,,A,Archaic Period,6,-400,-350,50,0.20739986
2734,,A,Republican Period,7,-350,-200,150,0.20739986
2735,colle Nocello,A,Republican Period,7,-200,-30,170,1.4116859
2735,colle Nocello,A,Early Imperial Period,8,-30,100,130,1.4116859
2735,colle Nocello,A,Mid-Imperial Period,9,100,300,200,1.4116859
2735,colle Nocello,A,Late Imperial Period,10,300,500,200,1.4116859
2736,,A,Republican Period,7,-200,-30,170,1.4610628
2736,,A,Early Imperial Period,8,-30,100,130,1.4610628
2736,,A,Mid-Imperial Period,9,100,300,200,1.4610628
2736,,A,Late Imperial Period,10,300,500,200,1.4610628
2737,colle Nocello,A,Republican Period,7,-200,-30,170,1.670024
2737,colle Nocello,A,Early Imperial Period,8,-30,100,130,1.670024
2737,colle Nocello,A,Mid-Imperial Period,9,100,300,200,1.670024
2737,colle Nocello,A,Late Imperial Period,10,300,500,200,1.670024
2738,Cozzano,A,Republican Period,7,-200,-30,170,0.99977684
2738,Cozzano,A,Early Imperial Period,8,-30,100,130,0.99977684
2738,Cozzano,A,Mid-Imperial Period,9,100,300,200,0.99977684
2738,Cozzano,A,Late Imperial Period,10,300,500,200,0.99977684
2739,casale Bellini,A,Early Imperial Period,8,-30,100,130,0.94230914
2739,casale Bellini,A,Mid-Imperial Period,9,100,300,200,0.94230914
2739,casale Bellini,A,Late Imperial Period,10,300,500,200,0.94230914
2740,casale Imperi,A,Early Imperial Period,8,-30,100,130,0.88770264
2740,casale Imperi,A,Mid-Imperial Period,9,100,300,200,0.88770264
2740,casale Imperi,A,Late Imperial Period,10,300,500,200,0.88770264
2741,,A,Archaic Period,6,-400,-350,50,0.7202636
2741,,A,Republican Period,7,-350,-200,150,0.7202636
2741,,B,Early Imperial Period,8,-30,100,130,0.7202636
2741,,B,Mid-Imperial Period,9,100,300,200,0.7202636
2741,,B,Late Imperial Period,10,300,500,200,0.7202636
2742,,A,Republican Period,7,-300,-200,100,0.94691145
2742,,B,Early Imperial Period,8,-30,100,130,0.94691145
2742,,B,Mid-Imperial Period,9,100,300,200,0.94691145
2742,,B,Late Imperial Period,10,300,500,200,0.94691145
2743,,A,Early Imperial Period,8,-30,100,130,0.60777426
2743,,A,Mid-Imperial Period,9,100,300,200,0.60777426
2743,,A,Late Imperial Period,10,300,500,200,0.60777426
2744,,A,Early Bronze Age,1,-2300,-1700,600,0.26471078
2744,,A,Middle Bronze Age,2,-1700,-1300,400,0.26471078
2744,,A,Late Bronze Age,3,-1300,-1020,280,0.26471078
2744,,A,Early Iron Age,4,-1020,-1000,20,0.26471078
2745,,A,Republican Period,7,-200,-30,170,1.0659646
2745,,A,Early Imperial Period,8,-30,100,130,1.0659646
2746,,A,Republican Period,7,-200,-30,170,2.0017791
2746,,A,Early Imperial Period,8,-30,100,130,2.0017791
2746,,A,Mid-Imperial Period,9,100,300,200,2.0017791
2746,,A,Late Imperial Period,10,300,500,200,2.0017791
2747,,A,Republican Period,7,-200,-30,170,1.5766369
2748,villa di Munazio Planco,A,Republican Period,7,-200,-30,170,1.7919302
2748,villa di Munazio Planco,A,Early Imperial Period,8,-30,100,130,1.7919302
2748,villa di Munazio Planco,A,Mid-Imperial Period,9,100,300,200,1.7919302
2748,villa di Munazio Planco,A,Late Imperial Period,10,300,500,200,1.7919302
2749,,A,Republican Period,7,-200,-30,170,1.5176672
2749,,A,Early Imperial Period,8,-30,100,130,1.5176672
2749,,A,Mid-Imperial Period,9,100,300,200,1.5176672
2749,,A,Late Imperial Period,10,300,500,200,1.5176672
2750,,A,Early Imperial Period,8,-30,100,130,1.6130885
2750,,A,Mid-Imperial Period,9,100,300,200,1.6130885
2750,,A,Late Imperial Period,10,300,500,200,1.6130885
2751,Villa dei Pisoni,A,Republican Period,7,-200,-30,170,2.4180591
2751,Villa dei Pisoni,A,Early Imperial Period,8,-30,100,130,2.4180591
2751,Villa dei Pisoni,A,Mid-Imperial Period,9,100,300,200,2.4180591
2751,Villa dei Pisoni,A,Late Imperial Period,10,300,500,200,2.4180591
2752,contrada Pisoni,A,Republican Period,7,-200,-30,170,1.910756
2752,contrada Pisoni,A,Early Imperial Period,8,-30,100,130,1.910756
2752,contrada Pisoni,A,Mid-Imperial Period,9,100,300,200,1.910756
2752,contrada Pisoni,A,Late Imperial Period,10,300,500,200,1.910756
2753,contrada Pisoni,A,Republican Period,7,-200,-30,170,0.50856495
2753,contrada Pisoni,A,Early Imperial Period,8,-30,100,130,0.50856495
2753,contrada Pisoni,A,Mid-Imperial Period,9,100,300,200,0.50856495
2753,contrada Pisoni,A,Late Imperial Period,10,300,500,200,0.50856495
2754,,A,Republican Period,7,-200,-30,170,1.6163111
2754,,A,Early Imperial Period,8,-30,100,130,1.6163111
2754,,A,Mid-Imperial Period,9,100,300,200,1.6163111
2755,,A,Republican Period,7,-200,-30,170,1.1652334
2755,,A,Early Imperial Period,8,-30,100,130,1.1652334
2755,,A,Mid-Imperial Period,9,100,300,200,1.1652334
2755,,A,Late Imperial Period,10,300,500,200,1.1652334
2756,,A,Republican Period,7,-100,-30,70,1.0671817
2756,,A,Early Imperial Period,8,-30,100,130,1.0671817
2756,,A,Mid-Imperial Period,9,100,300,200,1.0671817
2756,,A,Late Imperial Period,10,300,500,200,1.0671817
2757,,A,Republican Period,7,-100,-30,70,1.3155324
2757,,A,Early Imperial Period,8,-30,100,130,1.3155324
2757,,A,Mid-Imperial Period,9,100,300,200,1.3155324
2757,,A,Late Imperial Period,10,300,500,200,1.3155324
2758,Pianelle dei Signori Reali,A,Republican Period,7,-200,-30,170,1.4416808
2758,Pianelle dei Signori Reali,A,Early Imperial Period,8,-30,100,130,1.4416808
2758,Pianelle dei Signori Reali,A,Mid-Imperial Period,9,100,300,200,1.4416808
2758,Pianelle dei Signori Reali,A,Late Imperial Period,10,300,500,200,1.4416808
2759,Casale Rosa,A,Republican Period,7,-200,-30,170,1.460204
2759,Casale Rosa,A,Early Imperial Period,8,-30,100,130,1.460204
2759,Casale Rosa,A,Mid-Imperial Period,9,100,300,200,1.460204
2759,Casale Rosa,A,Late Imperial Period,10,300,500,200,1.460204
2760,,A,Republican Period,7,-200,-30,170,1.59101
2760,,A,Early Imperial Period,8,-30,100,130,1.59101
2760,,A,Mid-Imperial Period,9,100,300,200,1.59101
2760,,A,Late Imperial Period,10,300,500,200,1.59101
2761,Grotta Papale,A,Republican Period,7,-200,-30,170,2.4051938
2761,Grotta Papale,A,Early Imperial Period,8,-30,100,130,2.4051938
2761,Grotta Papale,A,Mid-Imperial Period,9,100,300,200,2.4051938
2761,Grotta Papale,A,Late Imperial Period,10,300,500,200,2.4051938
2762,,A,Early Imperial Period,8,-30,100,130,1.0469861
2762,,A,Mid-Imperial Period,9,100,300,200,1.0469861
2762,,A,Late Imperial Period,10,300,500,200,1.0469861
2763,,A,Late Iron Age,5,-600,-580,20,0.61740202
2763,,A,Archaic Period,6,-580,-350,230,0.61740202
2763,,A,Republican Period,7,-350,-200,150,0.61740202
2764,,A,Early Imperial Period,8,-30,100,130,0.95313567
2764,,A,Mid-Imperial Period,9,100,300,200,0.95313567
2764,,A,Late Imperial Period,10,300,500,200,0.95313567
2765,Quarto Pomata,A,Early Imperial Period,8,-30,100,130,1.1759117
2765,Quarto Pomata,A,Mid-Imperial Period,9,100,300,200,1.1759117
2765,Quarto Pomata,A,Late Imperial Period,10,300,500,200,1.1759117
2766,,A,Early Imperial Period,8,-30,100,130,1.1672111
2766,,A,Mid-Imperial Period,9,100,300,200,1.1672111
2766,,A,Late Imperial Period,10,300,500,200,1.1672111
2767,casale S. Angelo,A,Republican Period,7,-200,-30,170,1.0880061
2767,casale S. Angelo,A,Early Imperial Period,8,-30,100,130,1.0880061
2767,casale S. Angelo,A,Mid-Imperial Period,9,100,300,200,1.0880061
2767,casale S. Angelo,A,Late Imperial Period,10,300,500,200,1.0880061
2768,,A,Early Imperial Period,8,-30,100,130,1.0562057
2768,,A,Mid-Imperial Period,9,100,300,200,1.0562057
2768,,A,Late Imperial Period,10,300,500,200,1.0562057
2769,,A,Early Iron Age,4,-800,-750,50,0.23223655
2769,,A,Late Iron Age,5,-750,-700,50,0.23223655
2770,Galli,A,Republican Period,7,-200,-30,170,1.0610981
2771,,A,Republican Period,7,-200,-30,170,1.0122917
2771,,A,Early Imperial Period,8,-30,100,130,1.0122917
2771,,A,Mid-Imperial Period,9,100,300,200,1.0122917
2771,,A,Late Imperial Period,10,300,500,200,1.0122917
2772,,A,Early Imperial Period,8,-30,100,130,0.51786172
2772,,A,Mid-Imperial Period,9,100,300,200,0.51786172
2772,,A,Late Imperial Period,10,300,500,200,0.51786172
2773,,A,Republican Period,7,-200,-30,170,1.4445683
2773,,A,Early Imperial Period,8,-30,100,130,1.4445683
2773,,A,Mid-Imperial Period,9,100,300,200,1.4445683
2773,,A,Late Imperial Period,10,300,500,200,1.4445683
2774,,A,Early Imperial Period,8,-30,100,130,0.97305304
2774,,A,Mid-Imperial Period,9,100,300,200,0.97305304
2774,,A,Late Imperial Period,10,300,500,200,0.97305304
2775,,A,Early Imperial Period,8,1,100,99,1.0638779
2775,,A,Mid-Imperial Period,9,100,200,100,1.0638779
2776,,A,Mid-Imperial Period,9,100,300,200,1.808586
2776,,A,Late Imperial Period,10,300,500,200,1.808586
2777,colle di S. Stefano,A,Republican Period,7,-200,-30,170,7.9092851
2777,colle di S. Stefano,A,Early Imperial Period,8,-30,100,130,7.9092851
2777,colle di S. Stefano,A,Mid-Imperial Period,9,100,300,200,7.9092851
2777,colle di S. Stefano,A,Late Imperial Period,10,300,500,200,7.9092851
2778,,A,Republican Period,7,-200,-30,170,1.4315628
2778,,A,Early Imperial Period,8,-30,100,130,1.4315628
2778,,A,Mid-Imperial Period,9,100,300,200,1.4315628
2778,,A,Late Imperial Period,10,300,500,200,1.4315628
2779,,A,Early Imperial Period,8,-30,100,130,1.1406462
2779,,A,Mid-Imperial Period,9,100,300,200,1.1406462
2779,,A,Late Imperial Period,10,300,500,200,1.1406462
2780,,A,Republican Period,7,-200,-30,170,1.21439
2780,,A,Early Imperial Period,8,-30,100,130,1.21439
2780,,A,Mid-Imperial Period,9,100,300,200,1.21439
2780,,A,Late Imperial Period,10,300,500,200,1.21439
2781,,A,Republican Period,7,-100,-30,70,1.4494275
2781,,A,Early Imperial Period,8,-30,100,130,1.4494275
2781,,A,Mid-Imperial Period,9,100,300,200,1.4494275
2781,,A,Late Imperial Period,10,300,500,200,1.4494275
2782,colle Fiorito,A,Late Iron Age,5,-700,-600,100,0.68131626
2782,colle Fiorito,B,Early Imperial Period,8,-30,100,130,1.3455541
2782,colle Fiorito,B,Mid-Imperial Period,9,100,300,200,1.3455541
2782,colle Fiorito,B,Late Imperial Period,10,300,500,200,1.3455541
2783,,A,Early Imperial Period,8,-30,100,130,1.3363793
2783,,A,Mid-Imperial Period,9,100,300,200,1.3363793
2783,,A,Late Imperial Period,10,300,500,200,1.3363793
2784,,A,Early Bronze Age,1,-2300,-1700,600,1.3915558
2784,,A,Middle Bronze Age,2,-1700,-1300,400,1.3915558
2784,,A,Late Bronze Age,3,-1300,-1020,280,1.3915558
2784,,A,Early Iron Age,4,-1020,-750,270,1.3915558
2784,,A,Late Iron Age,5,-750,-580,170,1.3915558
2784,,A,Archaic Period,6,-580,-500,80,1.3915558
2785,casale di Corcolle,A,Early Imperial Period,8,1,100,99,1.3101873
2785,casale di Corcolle,A,Mid-Imperial Period,9,100,300,200,1.3101873
2785,casale di Corcolle,A,Late Imperial Period,10,300,500,200,1.3101873
2786,,A,Early Imperial Period,8,1,100,99,0.97976077
2786,,A,Mid-Imperial Period,9,100,300,200,0.97976077
2786,,A,Late Imperial Period,10,300,500,200,0.97976077
2787,colle Cesarano,A,Early Imperial Period,8,1,100,99,1.1717288
2787,colle Cesarano,A,Mid-Imperial Period,9,100,300,200,1.1717288
2787,colle Cesarano,A,Late Imperial Period,10,300,500,200,1.1717288
2788,colle Cesarano,A,Early Imperial Period,8,1,100,99,1.3056033
2788,colle Cesarano,A,Mid-Imperial Period,9,100,300,200,1.3056033
2788,colle Cesarano,A,Late Imperial Period,10,300,500,200,1.3056033
2789,,A,Early Imperial Period,8,1,100,99,1.053949
2789,,A,Mid-Imperial Period,9,100,300,200,1.053949
2789,,A,Late Imperial Period,10,300,500,200,1.053949
2790,colle Cesarano,A,Late Iron Age,5,-700,-580,120,0.96627617
2790,colle Cesarano,A,Archaic Period,6,-580,-500,80,0.96627617
2791,,A,Republican Period,7,-200,-30,170,0.91536957
2791,,A,Early Imperial Period,8,-30,100,130,0.91536957
2791,,A,Mid-Imperial Period,9,100,300,200,0.91536957
2791,,A,Late Imperial Period,10,300,500,200,0.91536957
2792,,A,Early Imperial Period,8,1,100,99,1.5030762
2792,,A,Mid-Imperial Period,9,100,200,100,1.5030762
2793,colle Merulino,A,Republican Period,7,-200,-30,170,1.4523408
2793,colle Merulino,A,Early Imperial Period,8,-30,100,130,1.4523408
2793,colle Merulino,A,Mid-Imperial Period,9,100,300,200,1.4523408
2793,colle Merulino,A,Late Imperial Period,10,300,500,200,1.4523408
2794,,A,Early Imperial Period,8,-30,100,130,1.0601021
2794,,A,Mid-Imperial Period,9,100,300,200,1.0601021
2794,,A,Late Imperial Period,10,300,500,200,1.0601021
2795,,A,Late Iron Age,5,-700,-580,120,0.63417703
2795,,A,Archaic Period,6,-580,-500,80,0.63417703
2795,,B,Republican Period,7,-100,-30,70,1.5764161
2795,,B,Early Imperial Period,8,-30,100,130,1.5764161
2795,,B,Mid-Imperial Period,9,100,300,200,1.5764161
2795,,B,Late Imperial Period,10,300,500,200,1.5764161
2796,,A,Republican Period,7,-200,-30,170,1.3209671
2796,,A,Early Imperial Period,8,-30,100,130,1.3209671
2796,,A,Mid-Imperial Period,9,100,300,200,1.3209671
2796,,A,Late Imperial Period,10,300,500,200,1.3209671
2797,,A,Republican Period,7,-200,-30,170,1.1471604
2797,,A,Early Imperial Period,8,-30,100,130,1.1471604
2797,,A,Mid-Imperial Period,9,100,300,200,1.1471604
2797,,A,Late Imperial Period,10,300,500,200,1.1471604
2798,,A,Early Imperial Period,8,-30,100,130,1.3997651
2798,,A,Mid-Imperial Period,9,100,300,200,1.3997651
2798,,A,Late Imperial Period,10,300,500,200,1.3997651
2799,,A,Early Imperial Period,8,-30,100,130,1.3999032
2799,,A,Mid-Imperial Period,9,100,300,200,1.3999032
2799,,A,Late Imperial Period,10,300,500,200,1.3999032
2800,,A,Republican Period,7,-200,-30,170,1.1555901
2800,,A,Early Imperial Period,8,-30,100,130,1.1555901
2800,,A,Mid-Imperial Period,9,100,300,200,1.1555901
2800,,A,Late Imperial Period,10,300,500,200,1.1555901
2801,localita' S. Martino,A,Republican Period,7,-200,-30,170,1.9016795
2801,localita' S. Martino,A,Early Imperial Period,8,-30,100,130,1.9016795
2801,localita' S. Martino,A,Mid-Imperial Period,9,100,300,200,1.9016795
2801,localita' S. Martino,A,Late Imperial Period,10,300,500,200,1.9016795
2802,,A,Early Bronze Age,1,-2300,-1700,600,0.37152171
2802,,B,Early Iron Age,4,-800,-750,50,0.37152171
2802,,B,Late Iron Age,5,-750,-600,150,0.37152171
2803,,A,Early Bronze Age,1,-2300,-1700,600,0.1876483
2803,,A,Middle Bronze Age,2,-1700,-1300,400,0.1876483
2803,,A,Late Bronze Age,3,-1300,-1020,280,0.1876483
2803,,B,Early Iron Age,4,-1020,-750,270,0.1876483
2803,,B,Late Iron Age,5,-750,-600,150,0.1876483
2804,,A,Early Bronze Age,1,-2300,-1700,600,0.2093579
2804,,A,Middle Bronze Age,2,-1700,-1300,400,0.2093579
2805,fosso di Ponte Terra,A,Middle Bronze Age,2,-1700,-1300,400,0.14901726
2806,,A,Early Bronze Age,1,-2300,-1700,600,0.26345527
2806,,A,Middle Bronze Age,2,-1700,-1300,400,0.26345527
2806,,A,Late Bronze Age,3,-1300,-1020,280,0.26345527
2806,,A,Early Iron Age,4,-1020,-800,220,0.26345527
2807,colle S. Stefano,A,Late Iron Age,5,-700,-580,120,0.38155961
2807,colle S. Stefano,A,Archaic Period,6,-580,-500,80,0.38155961
2808,Tor Cervara,A,Early Imperial Period,8,-30,100,130,0.88735527
2808,Tor Cervara,A,Mid-Imperial Period,9,100,300,200,0.88735527
2808,Tor Cervara,A,Late Imperial Period,10,300,500,200,0.88735527
2809,Tor Cervara,A,Republican Period,7,-300,-30,270,1.3297923
2809,Tor Cervara,A,Early Imperial Period,8,-30,100,130,1.3297923
2809,Tor Cervara,A,Mid-Imperial Period,9,100,300,200,1.3297923
2809,Tor Cervara,A,Late Imperial Period,10,300,500,200,1.3297923
2810,Cervelletta,A,Early Imperial Period,8,-30,100,130,1.4468025
2810,Cervelletta,A,Mid-Imperial Period,9,100,300,200,1.4468025
2810,Cervelletta,A,Late Imperial Period,10,300,500,200,1.4468025
2811,casale Bonetta,A,Early Imperial Period,8,-30,100,130,0.73029315
2811,casale Bonetta,A,Mid-Imperial Period,9,100,300,200,0.73029315
2811,casale Bonetta,A,Late Imperial Period,10,300,500,200,0.73029315
2812,casale Bonetta,A,Republican Period,7,-100,-30,70,0.58253396
2813,casale Bonetta,A,Early Iron Age,4,-1000,-800,200,0.71145362
2814,casale Bonetta,A,Republican Period,7,-300,-30,270,0.60709995
2814,casale Bonetta,A,Early Imperial Period,8,-30,100,130,0.60709995
2814,casale Bonetta,A,Mid-Imperial Period,9,100,300,200,0.60709995
2814,casale Bonetta,A,Late Imperial Period,10,300,500,200,0.60709995
2815,torre della Rustica,A,Late Iron Age,5,-600,-580,20,0.75843036
2815,torre della Rustica,A,Archaic Period,6,-580,-500,80,0.75843036
2815,torre della Rustica,B,Early Imperial Period,8,-30,100,130,0.75843036
2815,torre della Rustica,B,Mid-Imperial Period,9,100,300,200,0.75843036
2815,torre della Rustica,B,Late Imperial Period,10,300,500,200,0.75843036
2816,torre della Rustica,A,Early Imperial Period,8,-30,100,130,0.73685414
2816,torre della Rustica,A,Mid-Imperial Period,9,100,300,200,0.73685414
2816,torre della Rustica,A,Late Imperial Period,10,300,500,200,0.73685414
2817,La Rustica,A,Early Imperial Period,8,-30,100,130,0.34093335
2817,La Rustica,A,Mid-Imperial Period,9,100,300,200,0.34093335
2817,La Rustica,A,Late Imperial Period,10,300,500,200,0.34093335
2818,La Rustica,A,Archaic Period,6,-500,-400,100,0.70238417
2819,,A,Early Imperial Period,8,-30,100,130,0.85541809
2819,,A,Mid-Imperial Period,9,100,300,200,0.85541809
2819,,A,Late Imperial Period,10,300,500,200,0.85541809
2820,,A,Early Imperial Period,8,-30,100,130,0.70684987
2820,,A,Mid-Imperial Period,9,100,300,200,0.70684987
2820,,A,Late Imperial Period,10,300,500,200,0.70684987
2821,colle Le Piscine,A,Early Imperial Period,8,-30,100,130,0.56490183
2821,colle Le Piscine,A,Mid-Imperial Period,9,100,300,200,0.56490183
2821,colle Le Piscine,A,Late Imperial Period,10,300,500,200,0.56490183
2822,Quarto di S. Eusebio,A,Late Iron Age,5,-600,-580,20,2.580169
2822,Quarto di S. Eusebio,A,Archaic Period,6,-580,-400,180,2.580169
2823,Torraccia,A,Early Imperial Period,8,-30,100,130,0.70122766
2823,Torraccia,A,Mid-Imperial Period,9,100,300,200,0.70122766
2823,Torraccia,A,Late Imperial Period,10,300,500,200,0.70122766
2824,Torre di S. Eusebio,A,Mid-Imperial Period,9,200,300,100,0.66154444
2824,Torre di S. Eusebio,A,Late Imperial Period,10,300,500,200,0.66154444
2825,Torre della Rustica,A,Archaic Period,6,-400,-350,50,0.85365176
2825,Torre della Rustica,A,Republican Period,7,-350,-200,150,0.85365176
2825,Torre della Rustica,B,Early Imperial Period,8,-30,100,130,0.85365176
2825,Torre della Rustica,B,Mid-Imperial Period,9,100,300,200,0.85365176
2825,Torre della Rustica,B,Late Imperial Period,10,300,500,200,0.85365176
2826,settlement (villa),A,Early Imperial Period,8,-30,100,130,0.48388854
2826,settlement (villa),A,Mid-Imperial Period,9,100,300,200,0.48388854
2826,settlement (villa),A,Late Imperial Period,10,300,500,200,0.48388854
2827,Torre di S. Eusebio,A,Early Imperial Period,8,-30,100,130,0.12906314
2827,Torre di S. Eusebio,A,Mid-Imperial Period,9,100,300,200,0.12906314
2827,Torre di S. Eusebio,A,Late Imperial Period,10,300,500,200,0.12906314
2828,casale di Salone,A,Early Imperial Period,8,-30,100,130,1.3327657
2828,casale di Salone,A,Mid-Imperial Period,9,100,300,200,1.3327657
2828,casale di Salone,A,Late Imperial Period,10,300,500,200,1.3327657
2829,casale di Salone,A,Early Imperial Period,8,-30,100,130,0.56516582
2829,casale di Salone,A,Mid-Imperial Period,9,100,300,200,0.56516582
2829,casale di Salone,A,Late Imperial Period,10,300,500,200,0.56516582
2830,casale di Salone,A,Early Imperial Period,8,-30,100,130,0.53923059
2830,casale di Salone,A,Mid-Imperial Period,9,100,300,200,0.53923059
2830,casale di Salone,A,Late Imperial Period,10,300,500,200,0.53923059
2831,casale di Salone,A,Archaic Period,6,-500,-350,150,0.2877005
2831,casale di Salone,A,Republican Period,7,-350,-30,320,0.2877005
2832,casale di Salone,A,Republican Period,7,-200,-30,170,1.6431324
2832,casale di Salone,A,Early Imperial Period,8,-30,100,130,1.6431324
2832,casale di Salone,A,Mid-Imperial Period,9,100,300,200,1.6431324
2832,casale di Salone,A,Late Imperial Period,10,300,500,200,1.6431324
2833,Vigne di Salone,A,Late Iron Age,5,-600,-580,20,0.82462388
2833,Vigne di Salone,A,Archaic Period,6,-580,-500,80,0.82462388
2834,casale di Salone Vecchio,A,Early Imperial Period,8,-30,100,130,1.8168056
2834,casale di Salone Vecchio,A,Mid-Imperial Period,9,100,300,200,1.8168056
2834,casale di Salone Vecchio,A,Late Imperial Period,10,300,500,200,1.8168056
2835,Salone,A,Late Imperial Period,10,300,500,200,1.818431
2836,Torre di S. Eusebio,A,Early Imperial Period,8,-30,100,130,0.38991842
2836,Torre di S. Eusebio,A,Mid-Imperial Period,9,100,300,200,0.38991842
2836,Torre di S. Eusebio,A,Late Imperial Period,10,300,500,200,0.38991842
2837,Case Rosse,A,Early Imperial Period,8,-30,100,130,0.51486742
2837,Case Rosse,A,Mid-Imperial Period,9,100,300,200,0.51486742
2837,Case Rosse,A,Late Imperial Period,10,300,500,200,0.51486742
2838,Case Rosse,A,Early Imperial Period,8,-30,100,130,0.39443427
2838,Case Rosse,A,Mid-Imperial Period,9,100,300,200,0.39443427
2838,Case Rosse,A,Late Imperial Period,10,300,500,200,0.39443427
2839,Case Rosse,A,Late Iron Age,5,-600,-580,20,0.36478364
2839,Case Rosse,A,Archaic Period,6,-580,-500,80,0.36478364
2840,Case Rosse,A,Early Imperial Period,8,-30,100,130,0.63438231
2840,Case Rosse,A,Mid-Imperial Period,9,100,300,200,0.63438231
2840,Case Rosse,A,Late Imperial Period,10,300,500,200,0.63438231
2841,Case Rosse,A,Early Imperial Period,8,-30,100,130,1.1197243
2841,Case Rosse,A,Mid-Imperial Period,9,100,300,200,1.1197243
2841,Case Rosse,A,Late Imperial Period,10,300,500,200,1.1197243
2842,Case Rosse,A,Early Imperial Period,8,-30,100,130,0.41044411
2842,Case Rosse,A,Mid-Imperial Period,9,100,300,200,0.41044411
2842,Case Rosse,A,Late Imperial Period,10,300,500,200,0.41044411
2843,Case Rosse,A,Archaic Period,6,-500,-400,100,0.59064156
2844,Case Rosse,A,Archaic Period,6,-500,-400,100,0.31550121
2844,Case Rosse,B,Early Imperial Period,8,-30,100,130,0.31550121
2844,Case Rosse,B,Mid-Imperial Period,9,100,300,200,0.31550121
2844,Case Rosse,B,Late Imperial Period,10,300,500,200,0.31550121
2845,Casale Rosso,A,Late Iron Age,5,-600,-580,20,2.8425825
2845,Casale Rosso,A,Archaic Period,6,-580,-500,80,2.8425825
2846,Casale Rosso,A,Republican Period,7,-300,-30,270,0.40835452
2847,Casale Rosso,A,Early Imperial Period,8,-30,100,130,0.47307783
2847,Casale Rosso,A,Mid-Imperial Period,9,100,300,200,0.47307783
2847,Casale Rosso,A,Late Imperial Period,10,300,500,200,0.47307783
2848,Casale Rosso,A,Early Imperial Period,8,-30,100,130,0.39447275
2848,Casale Rosso,A,Mid-Imperial Period,9,100,300,200,0.39447275
2848,Casale Rosso,A,Late Imperial Period,10,300,500,200,0.39447275
2849,Casale del Cavaliere,A,Archaic Period,6,-400,-350,50,1.8551961
2849,Casale del Cavaliere,A,Republican Period,7,-350,-200,150,1.8551961
2850,Casale del Cavaliere,A,Archaic Period,6,-500,-350,150,0.5871982
2850,Casale del Cavaliere,A,Republican Period,7,-350,-30,320,0.5871982
2851,Casale del Cavaliere,A,Archaic Period,6,-500,-400,100,0.90859663
2851,Casale del Cavaliere,B,Early Imperial Period,8,-30,100,130,0.90859663
2851,Casale del Cavaliere,B,Mid-Imperial Period,9,100,300,200,0.90859663
2851,Casale del Cavaliere,B,Late Imperial Period,10,300,500,200,0.90859663
2852,Casale del Cavaliere,A,Early Imperial Period,8,-30,100,130,2.1882715
2852,Casale del Cavaliere,A,Mid-Imperial Period,9,100,300,200,2.1882715
2852,Casale del Cavaliere,A,Late Imperial Period,10,300,500,200,2.1882715
2853,,A,Archaic Period,6,-500,-400,100,0.45845729
2853,,B,Early Imperial Period,8,-30,100,130,0.45845729
2853,,B,Mid-Imperial Period,9,100,300,200,0.45845729
2853,,B,Late Imperial Period,10,300,500,200,0.45845729
2854,,A,Early Imperial Period,8,-30,100,130,0.58473653
2854,,A,Mid-Imperial Period,9,100,300,200,0.58473653
2854,,A,Late Imperial Period,10,300,500,200,0.58473653
2855,,A,Early Imperial Period,8,-30,100,130,0.6484108
2855,,A,Mid-Imperial Period,9,100,300,200,0.6484108
2855,,A,Late Imperial Period,10,300,500,200,0.6484108
2856,Casalone dell'Osa,A,Early Imperial Period,8,-30,100,130,1.1205393
2856,Casalone dell'Osa,A,Mid-Imperial Period,9,100,300,200,1.1205393
2856,Casalone dell'Osa,A,Late Imperial Period,10,300,500,200,1.1205393
2857,,A,Early Imperial Period,8,-30,100,130,0.8026042
2857,,A,Mid-Imperial Period,9,100,300,200,0.8026042
2857,,A,Late Imperial Period,10,300,500,200,0.8026042
2858,,A,Early Imperial Period,8,-30,100,130,0.62478673
2858,,A,Mid-Imperial Period,9,100,300,200,0.62478673
2858,,A,Late Imperial Period,10,300,500,200,0.62478673
2859,,A,Early Imperial Period,8,-30,100,130,0.56668788
2859,,A,Mid-Imperial Period,9,100,300,200,0.56668788
2859,,A,Late Imperial Period,10,300,500,200,0.56668788
2860,Lunghezza,A,Archaic Period,6,-400,-350,50,2.189487
2860,Lunghezza,A,Republican Period,7,-350,-30,320,2.189487
2860,Lunghezza,A,Early Imperial Period,8,-30,100,130,2.189487
2860,Lunghezza,A,Mid-Imperial Period,9,100,300,200,2.189487
2860,Lunghezza,A,Late Imperial Period,10,300,500,200,2.189487
2861,Lunghezza,A,Early Imperial Period,8,-30,100,130,1.3146791
2861,Lunghezza,A,Mid-Imperial Period,9,100,300,200,1.3146791
2861,Lunghezza,A,Late Imperial Period,10,300,500,200,1.3146791
2862,,A,Archaic Period,6,-400,-350,50,1.283097
2862,,A,Republican Period,7,-350,-200,150,1.283097
2862,,B,Early Imperial Period,8,-30,100,130,1.283097
2862,,B,Mid-Imperial Period,9,100,300,200,1.283097
2862,,B,Late Imperial Period,10,300,500,200,1.283097
2863,casale Bonzone,A,Early Imperial Period,8,-30,100,130,0.79747307
2863,casale Bonzone,A,Mid-Imperial Period,9,100,300,200,0.79747307
2863,casale Bonzone,A,Late Imperial Period,10,300,500,200,0.79747307
2864,casale Bonzone,A,Early Imperial Period,8,-30,100,130,2.3914356
2864,casale Bonzone,A,Mid-Imperial Period,9,100,300,200,2.3914356
2864,casale Bonzone,A,Late Imperial Period,10,300,500,200,2.3914356
2865,casale Cerrone,A,Early Imperial Period,8,-30,100,130,0.92406344
2865,casale Cerrone,A,Mid-Imperial Period,9,100,300,200,0.92406344
2865,casale Cerrone,A,Late Imperial Period,10,300,500,200,0.92406344
2866,casale Cerrone,A,Early Imperial Period,8,-30,100,130,0.88610941
2866,casale Cerrone,A,Mid-Imperial Period,9,100,300,200,0.88610941
2866,casale Cerrone,A,Late Imperial Period,10,300,500,200,0.88610941
2867,casale Cerroncino,A,Early Imperial Period,8,-30,100,130,0.8175751
2867,casale Cerroncino,A,Mid-Imperial Period,9,100,300,200,0.8175751
2867,casale Cerroncino,A,Late Imperial Period,10,300,500,200,0.8175751
2868,casale Cerroncino,A,Early Imperial Period,8,-30,100,130,0.80188537
2868,casale Cerroncino,A,Mid-Imperial Period,9,100,300,200,0.80188537
2868,casale Cerroncino,A,Late Imperial Period,10,300,500,200,0.80188537
2869,,A,Republican Period,7,-100,-30,70,1.015887
2870,,A,Early Imperial Period,8,-30,100,130,2.0749917
2870,,A,Mid-Imperial Period,9,100,300,200,2.0749917
2870,,A,Late Imperial Period,10,300,500,200,2.0749917
2871,,A,Early Imperial Period,8,-30,100,130,0.48536155
2871,,A,Mid-Imperial Period,9,100,300,200,0.48536155
2871,,A,Late Imperial Period,10,300,500,200,0.48536155
2872,,A,Early Imperial Period,8,-30,100,130,1.2914857
2872,,A,Mid-Imperial Period,9,100,300,200,1.2914857
2872,,A,Late Imperial Period,10,300,500,200,1.2914857
2873,casale Vigna di Salone,A,Late Iron Age,5,-600,-580,20,1.3124681
2873,casale Vigna di Salone,A,Archaic Period,6,-580,-500,80,1.3124681
2873,casale Vigna di Salone,B,Republican Period,7,-200,-30,170,1.3124681
2873,casale Vigna di Salone,B,Early Imperial Period,8,-30,100,130,1.3124681
2873,casale Vigna di Salone,B,Mid-Imperial Period,9,100,300,200,1.3124681
2873,casale Vigna di Salone,B,Late Imperial Period,10,300,500,200,1.3124681
2874,casale Vigna di Salone,A,Late Iron Age,5,-600,-580,20,0.46629974
2874,casale Vigna di Salone,A,Archaic Period,6,-580,-500,80,0.46629974
2874,casale Vigna di Salone,B,Early Imperial Period,8,-30,100,130,0.46629974
2874,casale Vigna di Salone,B,Mid-Imperial Period,9,100,300,200,0.46629974
2874,casale Vigna di Salone,B,Late Imperial Period,10,300,500,200,0.46629974
2875,Vacchereccia,A,Archaic Period,6,-400,-350,50,0.75444067
2875,Vacchereccia,A,Republican Period,7,-350,-200,150,0.75444067
2875,Vacchereccia,B,Early Imperial Period,8,-30,100,130,0.75444067
2875,Vacchereccia,B,Mid-Imperial Period,9,100,300,200,0.75444067
2875,Vacchereccia,B,Late Imperial Period,10,300,500,200,0.75444067
2876,Valle Maggiore,A,Early Imperial Period,8,-30,100,130,0.81566817
2876,Valle Maggiore,A,Mid-Imperial Period,9,100,300,200,0.81566817
2876,Valle Maggiore,A,Late Imperial Period,10,300,500,200,0.81566817
2877,Centro Cavalli,A,Early Imperial Period,8,-30,100,130,0.32361004
2877,Centro Cavalli,A,Mid-Imperial Period,9,100,300,200,0.32361004
2877,Centro Cavalli,A,Late Imperial Period,10,300,500,200,0.32361004
2878,,A,Early Imperial Period,8,-30,100,130,2.5724776
2878,,A,Mid-Imperial Period,9,100,300,200,2.5724776
2878,,A,Late Imperial Period,10,300,500,200,2.5724776
2879,,A,Early Imperial Period,8,-30,100,130,0.70702904
2879,,A,Mid-Imperial Period,9,100,300,200,0.70702904
2879,,A,Late Imperial Period,10,300,500,200,0.70702904
2880,,A,Archaic Period,6,-400,-350,50,1.2954465
2880,,A,Republican Period,7,-350,-300,50,1.2954465
2880,,B,Early Imperial Period,8,-30,100,130,1.2954465
2880,,B,Mid-Imperial Period,9,100,300,200,1.2954465
2880,,B,Late Imperial Period,10,300,500,200,1.2954465
2881,,A,Early Imperial Period,8,-30,100,130,2.1151283
2881,,A,Mid-Imperial Period,9,100,300,200,2.1151283
2881,,A,Late Imperial Period,10,300,500,200,2.1151283
2882,,A,Republican Period,7,-200,-30,170,0.61308616
2883,,A,Early Imperial Period,8,-30,100,130,0.89773989
2883,,A,Mid-Imperial Period,9,100,300,200,0.89773989
2883,,A,Late Imperial Period,10,300,500,200,0.89773989
2884,,A,Early Imperial Period,8,-30,100,130,2.3082705
2884,,A,Mid-Imperial Period,9,100,300,200,2.3082705
2884,,A,Late Imperial Period,10,300,500,200,2.3082705
2885,,A,Early Imperial Period,8,-30,100,130,0.46518239
2885,,A,Mid-Imperial Period,9,100,300,200,0.46518239
2885,,A,Late Imperial Period,10,300,500,200,0.46518239
2886,,A,Early Imperial Period,8,-30,100,130,0.63637072
2886,,A,Mid-Imperial Period,9,100,300,200,0.63637072
2886,,A,Late Imperial Period,10,300,500,200,0.63637072
2887,,A,Republican Period,7,-200,-30,170,1.3979747
2888,,A,Early Imperial Period,8,-30,100,130,0.66734612
2888,,A,Mid-Imperial Period,9,100,300,200,0.66734612
2888,,A,Late Imperial Period,10,300,500,200,0.66734612
2889,Tor Sapienza,A,Early Imperial Period,8,-30,100,130,0.6920386
2890,Tor Sapienza,A,Republican Period,7,-100,-30,70,0.59985226
2891,,A,Early Imperial Period,8,-30,100,130,0.68922561
2891,,A,Mid-Imperial Period,9,100,300,200,0.68922561
2891,,A,Late Imperial Period,10,300,500,200,0.68922561
2892,casale della Cervelletta,A,Republican Period,7,-200,-30,170,1.6653903
2892,casale della Cervelletta,B,Early Imperial Period,8,-30,100,130,1.6653903
2892,casale della Cervelletta,B,Mid-Imperial Period,9,100,300,200,1.6653903
2892,casale della Cervelletta,B,Late Imperial Period,10,300,500,200,1.6653903
2893,casale di Boccaleone,A,Early Imperial Period,8,-30,100,130,0.74096835
2893,casale di Boccaleone,A,Mid-Imperial Period,9,100,300,200,0.74096835
2893,casale di Boccaleone,A,Late Imperial Period,10,300,500,200,0.74096835
2894,,A,Early Imperial Period,8,-30,100,130,0.32595763
2894,,A,Mid-Imperial Period,9,100,300,200,0.32595763
2894,,A,Late Imperial Period,10,300,500,200,0.32595763
2895,,A,Republican Period,7,-100,-30,70,0.4665499
2896,,A,Republican Period,7,-100,-30,70,0.72142434
2896,,A,Early Imperial Period,8,-30,100,130,0.72142434
2896,,A,Mid-Imperial Period,9,100,300,200,0.72142434
2896,,A,Late Imperial Period,10,300,500,200,0.72142434
2897,,A,Early Imperial Period,8,-30,100,130,1.0261168
2897,,A,Mid-Imperial Period,9,100,300,200,1.0261168
2897,,A,Late Imperial Period,10,300,500,200,1.0261168
2898,,A,Late Iron Age,5,-600,-580,20,0.52890766
2898,,A,Archaic Period,6,-580,-400,180,0.52890766
2899,casale di Casa Rossa,A,Early Imperial Period,8,-30,100,130,0.75964952
2899,casale di Casa Rossa,A,Mid-Imperial Period,9,100,300,200,0.75964952
2899,casale di Casa Rossa,A,Late Imperial Period,10,300,500,200,0.75964952
2900,,A,Early Imperial Period,8,-30,100,130,0.54528791
2900,,A,Mid-Imperial Period,9,100,300,200,0.54528791
2900,,A,Late Imperial Period,10,300,500,200,0.54528791
2901,colle della Formicola,A,Early Imperial Period,8,-30,100,130,0.92771441
2901,colle della Formicola,A,Mid-Imperial Period,9,100,300,200,0.92771441
2901,colle della Formicola,A,Late Imperial Period,10,300,500,200,0.92771441
2902,Tor Sapienza,A,Early Imperial Period,8,-30,100,130,1.6876419
2902,Tor Sapienza,A,Mid-Imperial Period,9,100,300,200,1.6876419
2902,Tor Sapienza,A,Late Imperial Period,10,300,500,200,1.6876419
2903,Tor Sapienza,A,Early Imperial Period,8,-30,100,130,0.85703254
2903,Tor Sapienza,A,Mid-Imperial Period,9,100,300,200,0.85703254
2903,Tor Sapienza,A,Late Imperial Period,10,300,500,200,0.85703254
2904,,A,Early Imperial Period,8,-30,100,130,0.67370605
2904,,A,Mid-Imperial Period,9,100,300,200,0.67370605
2904,,A,Late Imperial Period,10,300,500,200,0.67370605
2905,,A,Republican Period,7,-300,-100,200,0.57140231
2905,,B,Early Imperial Period,8,-30,100,130,0.55261314
2905,,B,Mid-Imperial Period,9,100,300,200,0.55261314
2905,,B,Late Imperial Period,10,300,500,200,0.55261314
2906,fosso di Tor Tre Teste,A,Early Imperial Period,8,-30,100,130,0.40228856
2906,fosso di Tor Tre Teste,A,Mid-Imperial Period,9,100,300,200,0.40228856
2906,fosso di Tor Tre Teste,A,Late Imperial Period,10,300,500,200,0.40228856
2907,casale dell'Omo,A,Early Imperial Period,8,-30,100,130,0.6069265
2907,casale dell'Omo,A,Mid-Imperial Period,9,100,300,200,0.6069265
2907,casale dell'Omo,A,Late Imperial Period,10,300,500,200,0.6069265
2908,casale dell'Omo,A,Early Imperial Period,8,-30,100,130,0.43014091
2908,casale dell'Omo,A,Mid-Imperial Period,9,100,300,200,0.43014091
2908,casale dell'Omo,A,Late Imperial Period,10,300,500,200,0.43014091
2909,casale dell'Omo,A,Early Imperial Period,8,-30,100,130,0.72873986
2909,casale dell'Omo,A,Mid-Imperial Period,9,100,300,200,0.72873986
2909,casale dell'Omo,A,Late Imperial Period,10,300,500,200,0.72873986
2910,,A,Early Imperial Period,8,-30,100,130,0.86824751
2910,,A,Mid-Imperial Period,9,100,300,200,0.86824751
2910,,A,Late Imperial Period,10,300,500,200,0.86824751
2911,,A,Early Imperial Period,8,-30,100,130,0.83302855
2911,,A,Mid-Imperial Period,9,100,300,200,0.83302855
2911,,A,Late Imperial Period,10,300,500,200,0.83302855
2912,,A,Early Imperial Period,8,-30,100,130,0.99833089
2912,,A,Mid-Imperial Period,9,100,300,200,0.99833089
2912,,A,Late Imperial Period,10,300,500,200,0.99833089
2913,,A,Archaic Period,6,-400,-350,50,0.58529353
2913,,A,Republican Period,7,-350,-200,150,0.58529353
2914,,A,Early Imperial Period,8,-30,100,130,0.91622996
2914,,A,Mid-Imperial Period,9,100,300,200,0.91622996
2914,,A,Late Imperial Period,10,300,500,200,0.91622996
2915,,A,Early Imperial Period,8,-30,100,130,1.422973
2915,,A,Mid-Imperial Period,9,100,300,200,1.422973
2915,,A,Late Imperial Period,10,300,500,200,1.422973
2916,Colle Mentuccia,A,Late Iron Age,5,-600,-580,20,0.9194153
2916,Colle Mentuccia,A,Archaic Period,6,-580,-350,230,3.3522811
2916,Colle Mentuccia,A,Republican Period,7,-350,-30,320,3.3522811
2916,Colle Mentuccia,A,Early Imperial Period,8,-30,100,130,3.3522811
2916,Colle Mentuccia,A,Mid-Imperial Period,9,100,300,200,3.3522811
2916,Colle Mentuccia,A,Late Imperial Period,10,300,500,200,3.3522811
2917,,A,Early Imperial Period,8,-30,100,130,0.44757512
2917,,A,Mid-Imperial Period,9,100,300,200,0.44757512
2917,,A,Late Imperial Period,10,300,500,200,0.44757512
2918,,A,Early Imperial Period,8,-30,100,130,0.61009073
2918,,A,Mid-Imperial Period,9,100,300,200,0.61009073
2918,,A,Late Imperial Period,10,300,500,200,0.61009073
2919,,A,Early Imperial Period,8,-30,100,130,0.44442815
2919,,A,Mid-Imperial Period,9,100,300,200,0.44442815
2919,,A,Late Imperial Period,10,300,500,200,0.44442815
2920,Tor Angela Nuova,A,Late Iron Age,5,-600,-580,20,1.7666078
2920,Tor Angela Nuova,A,Archaic Period,6,-580,-350,230,1.9517201
2920,Tor Angela Nuova,A,Republican Period,7,-350,-30,320,4.2194481
2920,Tor Angela Nuova,A,Early Imperial Period,8,-30,100,130,10.470169
2920,Tor Angela Nuova,A,Mid-Imperial Period,9,100,300,200,10.470169
2920,Tor Angela Nuova,A,Late Imperial Period,10,300,500,200,10.470169
2921,casale Torragna,A,Early Imperial Period,8,-30,100,130,0.69365466
2921,casale Torragna,A,Mid-Imperial Period,9,100,300,200,0.69365466
2921,casale Torragna,A,Late Imperial Period,10,300,500,200,0.69365466
2922,,A,Late Iron Age,5,-600,-580,20,0.87386179
2922,,A,Archaic Period,6,-580,-500,80,0.87386179
2922,,B,Republican Period,7,-100,-30,70,1.4839293
2922,,B,Early Imperial Period,8,-30,100,130,1.4839293
2922,,B,Mid-Imperial Period,9,100,300,200,1.4839293
2922,,B,Late Imperial Period,10,300,500,200,1.4839293
2923,,A,Early Imperial Period,8,-30,100,130,1.0813167
2923,,A,Mid-Imperial Period,9,100,300,200,1.0813167
2923,,A,Late Imperial Period,10,300,500,200,1.0813167
2924,,A,Republican Period,7,-100,-30,70,1.1099007
2924,,A,Early Imperial Period,8,-30,100,130,1.1099007
2924,,A,Mid-Imperial Period,9,100,300,200,1.1099007
2924,,A,Late Imperial Period,10,300,500,200,1.1099007
2925,,A,Early Imperial Period,8,-30,100,130,0.85408688
2925,,A,Mid-Imperial Period,9,100,300,200,0.85408688
2925,,A,Late Imperial Period,10,300,500,200,0.85408688
2926,,A,Archaic Period,6,-400,-350,50,0.71277821
2926,,A,Republican Period,7,-350,-200,150,0.71277821
2927,,A,Early Imperial Period,8,-30,100,130,0.55718678
2927,,A,Mid-Imperial Period,9,100,300,200,0.55718678
2927,,A,Late Imperial Period,10,300,500,200,0.55718678
2928,,A,Late Iron Age,5,-600,-580,20,0.47329956
2928,,A,Archaic Period,6,-580,-500,80,0.47329956
2928,,B,Republican Period,7,-100,-30,70,0.47329956
2928,,B,Early Imperial Period,8,-30,100,130,0.47329956
2928,,B,Mid-Imperial Period,9,100,300,200,0.47329956
2928,,B,Late Imperial Period,10,300,500,200,0.47329956
2929,,A,Late Iron Age,5,-600,-580,20,0.86481708
2929,,A,Archaic Period,6,-580,-500,80,0.86481708
2930,,A,Early Imperial Period,8,-30,100,130,0.43327224
2930,,A,Mid-Imperial Period,9,100,300,200,0.43327224
2930,,A,Late Imperial Period,10,300,500,200,0.43327224
2931,,A,Late Iron Age,5,-600,-580,20,0.19488117
2931,,A,Archaic Period,6,-580,-500,80,0.19488117
2931,,B,Early Imperial Period,8,-30,100,130,0.77882385
2931,,B,Mid-Imperial Period,9,100,300,200,0.77882385
2931,,B,Late Imperial Period,10,300,500,200,0.77882385
2932,,A,Early Imperial Period,8,-30,100,130,0.44056118
2932,,A,Mid-Imperial Period,9,100,300,200,0.44056118
2932,,A,Late Imperial Period,10,300,500,200,0.44056118
2933,,A,Early Imperial Period,8,-30,100,130,0.81425864
2933,,A,Mid-Imperial Period,9,100,300,200,0.81425864
2933,,A,Late Imperial Period,10,300,500,200,0.81425864
2934,,A,Early Imperial Period,8,-30,100,130,0.57829291
2934,,A,Mid-Imperial Period,9,100,300,200,0.57829291
2934,,A,Late Imperial Period,10,300,500,200,0.57829291
2935,,A,Early Imperial Period,8,-30,100,130,0.31475723
2935,,A,Mid-Imperial Period,9,100,300,200,0.31475723
2935,,A,Late Imperial Period,10,300,500,200,0.31475723
2936,,A,Late Iron Age,5,-600,-580,20,1.6878328
2936,,A,Archaic Period,6,-580,-350,230,1.6878328
2936,,A,Republican Period,7,-350,-30,320,1.6878328
2936,,A,Early Imperial Period,8,-30,100,130,1.6878328
2936,,A,Mid-Imperial Period,9,100,300,200,1.6878328
2936,,A,Late Imperial Period,10,300,500,200,1.6878328
2937,,A,Early Imperial Period,8,-30,100,130,0.49177244
2937,,A,Mid-Imperial Period,9,100,300,200,0.49177244
2937,,A,Late Imperial Period,10,300,500,200,0.49177244
2938,,A,Late Iron Age,5,-600,-580,20,0.87361383
2938,,A,Archaic Period,6,-580,-500,80,0.87361383
2938,,B,Early Imperial Period,8,-30,100,130,0.87361383
2938,,B,Mid-Imperial Period,9,100,300,200,0.87361383
2938,,B,Late Imperial Period,10,300,500,200,0.87361383
2939,,A,Early Imperial Period,8,-30,100,130,1.1151223
2939,,A,Mid-Imperial Period,9,100,300,200,1.1151223
2939,,A,Late Imperial Period,10,300,500,200,1.1151223
2940,,A,Republican Period,7,-200,-30,170,0.34907696
2941,tenuta dei Ponzoni,A,Early Imperial Period,8,-30,100,130,0.76178682
2941,tenuta dei Ponzoni,A,Mid-Imperial Period,9,100,300,200,0.76178682
2941,tenuta dei Ponzoni,A,Late Imperial Period,10,300,500,200,0.76178682
2942,,A,Republican Period,7,-200,-30,170,0.90060103
2942,,A,Early Imperial Period,8,-30,100,130,0.90060103
2942,,A,Mid-Imperial Period,9,100,300,200,0.90060103
2942,,A,Late Imperial Period,10,300,500,200,0.90060103
2943,fosso di Montegiardino,A,Early Imperial Period,8,-30,100,130,0.83227432
2943,fosso di Montegiardino,A,Mid-Imperial Period,9,100,300,200,0.83227432
2943,fosso di Montegiardino,A,Late Imperial Period,10,300,500,200,0.83227432
2944,fosso di Montegiardino,A,Republican Period,7,-100,-30,70,0.66352576
2944,fosso di Montegiardino,A,Early Imperial Period,8,-30,100,130,0.66352576
2944,fosso di Montegiardino,A,Mid-Imperial Period,9,100,300,200,0.66352576
2944,fosso di Montegiardino,A,Late Imperial Period,10,300,500,200,0.66352576
2945,Riserva Nuova,A,Early Imperial Period,8,-30,100,130,2.1415782
2945,Riserva Nuova,A,Mid-Imperial Period,9,100,300,200,2.1415782
2945,Riserva Nuova,A,Late Imperial Period,10,300,500,200,2.1415782
2946,Riserva Nuova,A,Early Imperial Period,8,-30,100,130,0.69360214
2946,Riserva Nuova,A,Mid-Imperial Period,9,100,300,200,0.69360214
2946,Riserva Nuova,A,Late Imperial Period,10,300,500,200,0.69360214
2947,,A,Early Imperial Period,8,-30,100,130,1.1596763
2947,,A,Mid-Imperial Period,9,100,300,200,1.1596763
2947,,A,Late Imperial Period,10,300,500,200,1.1596763
2948,,A,Archaic Period,6,-400,-350,50,0.6195417
2948,,A,Republican Period,7,-350,-200,150,0.6195417
2948,,B,Early Imperial Period,8,-30,100,130,0.6195417
2948,,B,Mid-Imperial Period,9,100,300,200,0.6195417
2948,,B,Late Imperial Period,10,300,500,200,0.6195417
2949,,A,Early Imperial Period,8,-30,100,130,1.1479205
2949,,A,Mid-Imperial Period,9,100,300,200,1.1479205
2949,,A,Late Imperial Period,10,300,500,200,1.1479205
2950,,A,Early Imperial Period,8,-30,100,130,0.57290596
2950,,A,Mid-Imperial Period,9,100,300,200,0.57290596
2950,,A,Late Imperial Period,10,300,500,200,0.57290596
2951,,A,Early Imperial Period,8,-30,100,130,0.65471011
2951,,A,Mid-Imperial Period,9,100,300,200,0.65471011
2951,,A,Late Imperial Period,10,300,500,200,0.65471011
2952,,A,Early Imperial Period,8,-30,100,130,0.52762449
2952,,A,Mid-Imperial Period,9,100,300,200,0.52762449
2952,,A,Late Imperial Period,10,300,500,200,0.52762449
2953,,A,Early Imperial Period,8,-30,100,130,0.51540911
2953,,A,Mid-Imperial Period,9,100,300,200,0.51540911
2953,,A,Late Imperial Period,10,300,500,200,0.51540911
2954,Ovile dell'Osa,A,Early Imperial Period,8,-30,100,130,0.57002193
2954,Ovile dell'Osa,A,Mid-Imperial Period,9,100,300,200,0.57002193
2954,Ovile dell'Osa,A,Late Imperial Period,10,300,500,200,0.57002193
2955,Ovile dell'Osa,A,Early Imperial Period,8,-30,100,130,0.61420339
2955,Ovile dell'Osa,A,Mid-Imperial Period,9,100,300,200,0.61420339
2955,Ovile dell'Osa,A,Late Imperial Period,10,300,500,200,0.61420339
2956,Ovile dell'Osa,A,Early Imperial Period,8,-30,100,130,0.55816805
2956,Ovile dell'Osa,A,Mid-Imperial Period,9,100,300,200,0.55816805
2956,Ovile dell'Osa,A,Late Imperial Period,10,300,500,200,0.55816805
2957,fosso dell'Osa,A,Archaic Period,6,-400,-350,50,1.475966
2957,fosso dell'Osa,A,Republican Period,7,-350,-200,150,1.475966
2957,fosso dell'Osa,B,Early Imperial Period,8,-30,100,130,4.6464138
2957,fosso dell'Osa,B,Mid-Imperial Period,9,100,300,200,4.6464138
2957,fosso dell'Osa,B,Late Imperial Period,10,300,500,200,4.6464138
2958,,A,Late Iron Age,5,-600,-580,20,0.50380099
2958,,A,Archaic Period,6,-580,-500,80,0.50380099
2958,,B,Early Imperial Period,8,-30,100,130,0.50380099
2958,,B,Mid-Imperial Period,9,100,300,200,0.50380099
2958,,B,Late Imperial Period,10,300,500,200,0.50380099
2959,,A,Early Imperial Period,8,-30,100,130,0.88716751
2959,,A,Mid-Imperial Period,9,100,300,200,0.88716751
2959,,A,Late Imperial Period,10,300,500,200,0.88716751
2960,,A,Early Imperial Period,8,-30,100,130,1.5513369
2960,,A,Mid-Imperial Period,9,100,300,200,1.5513369
2960,,A,Late Imperial Period,10,300,500,200,1.5513369
2961,,A,Early Imperial Period,8,-30,100,130,0.50585091
2961,,A,Mid-Imperial Period,9,100,300,200,0.50585091
2961,,A,Late Imperial Period,10,300,500,200,0.50585091
2962,,A,Early Imperial Period,8,-30,100,130,0.71598351
2962,,A,Mid-Imperial Period,9,100,300,200,0.71598351
2962,,A,Late Imperial Period,10,300,500,200,0.71598351
2963,Casalone dell'Osa,A,Late Iron Age,5,-600,-580,20,1.5856578
2963,Casalone dell'Osa,A,Archaic Period,6,-580,-350,230,1.5856578
2963,Casalone dell'Osa,A,Republican Period,7,-350,-30,320,1.5856578
2963,Casalone dell'Osa,A,Early Imperial Period,8,-30,100,130,0.57261908
2963,Casalone dell'Osa,A,Mid-Imperial Period,9,100,300,200,0.57261908
2963,Casalone dell'Osa,A,Late Imperial Period,10,300,500,200,0.57261908
2964,,A,Early Imperial Period,8,-30,100,130,0.43273741
2964,,A,Mid-Imperial Period,9,100,300,200,0.43273741
2964,,A,Late Imperial Period,10,300,500,200,0.43273741
2965,,A,Early Imperial Period,8,-30,100,130,0.29532567
2965,,A,Mid-Imperial Period,9,100,300,200,0.29532567
2965,,A,Late Imperial Period,10,300,500,200,0.29532567
2966,,A,Early Imperial Period,8,-30,100,130,0.29532886
2966,,A,Mid-Imperial Period,9,100,300,200,0.29532886
2966,,A,Late Imperial Period,10,300,500,200,0.29532886
2967,,A,Early Imperial Period,8,-30,100,130,0.62683767
2967,,A,Mid-Imperial Period,9,100,300,200,0.62683767
2967,,A,Late Imperial Period,10,300,500,200,0.62683767
2968,,A,Archaic Period,6,-400,-350,50,0.58897972
2968,,A,Republican Period,7,-350,-30,320,0.58897972
2968,,A,Early Imperial Period,8,-30,100,130,0.58897972
2968,,A,Mid-Imperial Period,9,100,300,200,0.58897972
2968,,A,Late Imperial Period,10,300,500,200,0.58897972
2969,Riserva dell'Ara,A,Republican Period,7,-100,-30,70,0.84812582
2969,Riserva dell'Ara,A,Early Imperial Period,8,-30,100,130,0.84812582
2970,Tenuta della Lunghezza,A,Archaic Period,6,-400,-350,50,1.0294319
2970,Tenuta della Lunghezza,A,Republican Period,7,-350,-30,320,1.0294319
2970,Tenuta della Lunghezza,A,Early Imperial Period,8,-30,100,130,1.0294319
2970,Tenuta della Lunghezza,A,Mid-Imperial Period,9,100,300,200,1.0294319
2970,Tenuta della Lunghezza,A,Late Imperial Period,10,300,500,200,1.0294319
2971,Tenuta della Lunghezza,A,Archaic Period,6,-500,-350,150,0.78624135
2971,Tenuta della Lunghezza,A,Republican Period,7,-350,-100,250,0.78624135
2971,Tenuta della Lunghezza,B,Early Imperial Period,8,-30,100,130,0.78624135
2971,Tenuta della Lunghezza,B,Mid-Imperial Period,9,100,300,200,0.78624135
2971,Tenuta della Lunghezza,B,Late Imperial Period,10,300,500,200,0.78624135
2972,,A,Early Imperial Period,8,-30,100,130,0.58728498
2972,,A,Mid-Imperial Period,9,100,300,200,0.58728498
2972,,A,Late Imperial Period,10,300,500,200,0.58728498
2973,,A,Early Imperial Period,8,-30,100,130,0.58730376
2973,,A,Mid-Imperial Period,9,100,300,200,0.58730376
2973,,A,Late Imperial Period,10,300,500,200,0.58730376
2974,,A,Early Imperial Period,8,-30,100,130,1.2376349
2974,,A,Mid-Imperial Period,9,100,300,200,1.2376349
2974,,A,Late Imperial Period,10,300,500,200,1.2376349
2975,,A,Early Imperial Period,8,-30,100,130,1.5920577
2975,,A,Mid-Imperial Period,9,100,300,200,1.5920577
2975,,A,Late Imperial Period,10,300,500,200,1.5920577
2976,,A,Late Iron Age,5,-600,-580,20,0.91850495
2976,,A,Archaic Period,6,-580,-350,230,0.91850495
2976,,A,Republican Period,7,-350,-30,320,0.91850495
2976,,A,Early Imperial Period,8,-30,100,130,0.91850495
2976,,A,Mid-Imperial Period,9,100,300,200,0.91850495
2976,,A,Late Imperial Period,10,300,500,200,0.91850495
2977,,A,Early Imperial Period,8,-30,100,130,0.74109888
2977,,A,Mid-Imperial Period,9,100,300,200,0.74109888
2977,,A,Late Imperial Period,10,300,500,200,0.74109888
2978,,A,Early Imperial Period,8,-30,100,130,0.6346541
2978,,A,Mid-Imperial Period,9,100,300,200,0.6346541
2978,,A,Late Imperial Period,10,300,500,200,0.6346541
2979,,A,Early Imperial Period,8,-30,100,130,0.35562572
2979,,A,Mid-Imperial Period,9,100,300,200,0.35562572
2979,,A,Late Imperial Period,10,300,500,200,0.35562572
2980,,A,Republican Period,7,-100,-30,70,1.251245
2980,,A,Early Imperial Period,8,-30,100,130,1.251245
2980,,A,Mid-Imperial Period,9,100,300,200,1.251245
2980,,A,Late Imperial Period,10,300,500,200,1.251245
2981,,A,Archaic Period,6,-500,-400,100,0.35283691
2981,,B,Early Imperial Period,8,-30,100,130,0.35283691
2981,,B,Mid-Imperial Period,9,100,300,200,0.35283691
2981,,B,Late Imperial Period,10,300,500,200,0.35283691
2982,Riserva del Castellaccio,A,Late Iron Age,5,-600,-580,20,0.34866863
2982,Riserva del Castellaccio,A,Archaic Period,6,-580,-500,80,0.34866863
2982,Riserva del Castellaccio,B,Republican Period,7,-100,-30,70,1.2370427
2982,Riserva del Castellaccio,B,Early Imperial Period,8,-30,100,130,1.2370427
2982,Riserva del Castellaccio,B,Mid-Imperial Period,9,100,300,200,1.2370427
2982,Riserva del Castellaccio,B,Late Imperial Period,10,300,500,200,1.2370427
2983,Riserva del Castellaccio,A,Early Imperial Period,8,-30,100,130,1.5711921
2983,Riserva del Castellaccio,A,Mid-Imperial Period,9,100,300,200,1.5711921
2983,Riserva del Castellaccio,A,Late Imperial Period,10,300,500,200,1.5711921
2984,Riserva del Castellaccio,A,Early Imperial Period,8,-30,100,130,0.42489237
2984,Riserva del Castellaccio,A,Mid-Imperial Period,9,100,300,200,0.42489237
2984,Riserva del Castellaccio,A,Late Imperial Period,10,300,500,200,0.42489237
2985,,A,Early Imperial Period,8,-30,100,130,0.79068494
2985,,A,Mid-Imperial Period,9,100,300,200,0.79068494
2985,,A,Late Imperial Period,10,300,500,200,0.79068494
2986,,A,Early Imperial Period,8,-30,100,130,1.3326424
2986,,A,Mid-Imperial Period,9,100,300,200,1.3326424
2986,,A,Late Imperial Period,10,300,500,200,1.3326424
2987,,A,Late Iron Age,5,-600,-580,20,2.6762123
2987,,A,Archaic Period,6,-580,-400,180,2.6762123
2987,,B,Early Imperial Period,8,-30,100,130,2.6762123
2987,,B,Mid-Imperial Period,9,100,300,200,2.6762123
2987,,B,Late Imperial Period,10,300,500,200,2.6762123
2988,,A,Late Iron Age,5,-600,-580,20,0.50679493
2988,,A,Archaic Period,6,-580,-500,80,0.50679493
2988,,B,Early Imperial Period,8,-30,100,130,0.50679493
2988,,B,Mid-Imperial Period,9,100,300,200,0.50679493
2988,,B,Late Imperial Period,10,300,500,200,0.50679493
2989,,A,Archaic Period,6,-400,-350,50,0.83188796
2989,,B,Republican Period,7,-350,-30,320,1.4761624
2989,,B,Early Imperial Period,8,-30,100,130,3.8719165
2989,,B,Mid-Imperial Period,9,100,300,200,3.8719165
2989,,B,Late Imperial Period,10,300,500,200,3.8719165
2990,,A,Early Imperial Period,8,-30,100,130,0.46186292
2990,,A,Mid-Imperial Period,9,100,300,200,0.46186292
2990,,A,Late Imperial Period,10,300,500,200,0.46186292
2991,,A,Late Iron Age,5,-600,-580,20,0.2857829
2991,,A,Archaic Period,6,-580,-350,230,0.2857829
2991,,A,Republican Period,7,-350,-30,320,0.2857829
2991,,A,Early Imperial Period,8,-30,100,130,0.2857829
2991,,A,Mid-Imperial Period,9,100,300,200,0.2857829
2991,,A,Late Imperial Period,10,300,500,200,0.2857829
2992,,A,Late Iron Age,5,-600,-580,20,0.50127488
2992,,A,Archaic Period,6,-580,-350,230,0.50127488
2992,,A,Republican Period,7,-350,-30,320,0.50127488
2992,,A,Early Imperial Period,8,-30,100,130,0.50127488
2992,,A,Mid-Imperial Period,9,100,300,200,0.50127488
2992,,A,Late Imperial Period,10,300,500,200,0.50127488
2993,,A,Late Iron Age,5,-600,-580,20,1.0481876
2993,,A,Archaic Period,6,-580,-350,230,1.0481876
2993,,A,Republican Period,7,-350,-30,320,1.0481876
2993,,A,Early Imperial Period,8,-30,100,130,1.0481876
2993,,A,Mid-Imperial Period,9,100,300,200,1.0481876
2993,,A,Late Imperial Period,10,300,500,200,1.0481876
2994,casale Le Pecorelle,A,Early Imperial Period,8,-30,100,130,2.8466551
2994,casale Le Pecorelle,A,Mid-Imperial Period,9,100,300,200,2.8466551
2994,casale Le Pecorelle,A,Late Imperial Period,10,300,500,200,2.8466551
2995,,A,Early Imperial Period,8,-30,100,130,2.5217164
2995,,A,Mid-Imperial Period,9,100,300,200,2.5217164
2995,,A,Late Imperial Period,10,300,500,200,2.5217164
2996,,A,Late Iron Age,5,-600,-580,20,0.34773955
2996,,A,Archaic Period,6,-580,-500,80,0.34773955
2997,,A,Late Iron Age,5,-600,-580,20,0.58755529
2997,,A,Archaic Period,6,-580,-500,80,0.58755529
2997,,B,Early Imperial Period,8,-30,100,130,0.58755529
2997,,B,Mid-Imperial Period,9,100,300,200,0.58755529
2997,,B,Late Imperial Period,10,300,500,200,0.58755529
2998,,A,Early Imperial Period,8,-30,100,130,0.70731694
2998,,A,Mid-Imperial Period,9,100,300,200,0.70731694
2998,,A,Late Imperial Period,10,300,500,200,0.70731694
2999,,A,Archaic Period,6,-500,-400,100,0.28890926
2999,,B,Early Imperial Period,8,-30,100,130,0.84583765
2999,,B,Mid-Imperial Period,9,100,300,200,0.84583765
2999,,B,Late Imperial Period,10,300,500,200,0.84583765
3000,tenuta di Pantano,A,Archaic Period,6,-400,-350,50,0.57889485
3000,tenuta di Pantano,A,Republican Period,7,-350,-30,320,0.57889485
3001,tenuta di Pantano,A,Late Iron Age,5,-600,-580,20,0.5997988
3001,tenuta di Pantano,A,Archaic Period,6,-580,-500,80,0.5997988
3001,tenuta di Pantano,B,Early Imperial Period,8,-30,100,130,0.5997988
3001,tenuta di Pantano,B,Mid-Imperial Period,9,100,300,200,0.5997988
3001,tenuta di Pantano,B,Late Imperial Period,10,300,500,200,0.5997988
3002,,A,Early Imperial Period,8,-30,100,130,1.8290274
3002,,A,Mid-Imperial Period,9,100,300,200,1.8290274
3002,,A,Late Imperial Period,10,300,500,200,1.8290274
3003,,A,Early Imperial Period,8,-30,100,130,1.471916
3003,,A,Mid-Imperial Period,9,100,300,200,1.471916
3003,,A,Late Imperial Period,10,300,500,200,1.471916
3004,,A,Early Imperial Period,8,-30,100,130,2.4725709
3004,,A,Mid-Imperial Period,9,100,300,200,2.4725709
3004,,A,Late Imperial Period,10,300,500,200,2.4725709
3005,tenuta di Pantano,A,Late Iron Age,5,-600,-580,20,1.5375381
3005,tenuta di Pantano,A,Archaic Period,6,-580,-500,80,1.5375381
3005,tenuta di Pantano,B,Early Imperial Period,8,-30,100,130,1.5375381
3005,tenuta di Pantano,B,Mid-Imperial Period,9,100,300,200,1.5375381
3005,tenuta di Pantano,B,Late Imperial Period,10,300,500,200,1.5375381
3006,tenuta di Pantano,A,Early Imperial Period,8,-30,100,130,0.19005281
3006,tenuta di Pantano,A,Mid-Imperial Period,9,100,300,200,0.19005281
3006,tenuta di Pantano,A,Late Imperial Period,10,300,500,200,0.19005281
3007,tenuta di Pantano,A,Late Iron Age,5,-600,-580,20,0.72715223
3007,tenuta di Pantano,A,Archaic Period,6,-580,-500,80,0.72715223
3007,tenuta di Pantano,B,Early Imperial Period,8,-30,100,130,0.72715223
3007,tenuta di Pantano,B,Mid-Imperial Period,9,100,300,200,0.72715223
3007,tenuta di Pantano,B,Late Imperial Period,10,300,500,200,0.72715223
3008,,A,Late Iron Age,5,-600,-580,20,0.76439202
3008,,A,Archaic Period,6,-580,-400,180,0.76439202
3008,,B,Early Imperial Period,8,-30,100,130,0.76439202
3008,,B,Mid-Imperial Period,9,100,300,200,0.76439202
3008,,B,Late Imperial Period,10,300,500,200,0.76439202
3009,fattoria di Pratolungo,A,Early Imperial Period,8,-30,100,130,0.70663959
3009,fattoria di Pratolungo,A,Mid-Imperial Period,9,100,300,200,0.70663959
3009,fattoria di Pratolungo,A,Late Imperial Period,10,300,500,200,0.70663959
3010,fattoria di Pratolungo,A,Archaic Period,6,-400,-350,50,0.12383876
3010,fattoria di Pratolungo,A,Republican Period,7,-350,-200,150,0.12383876
3010,fattoria di Pratolungo,B,Early Imperial Period,8,-30,100,130,1.2740648
3010,fattoria di Pratolungo,B,Mid-Imperial Period,9,100,300,200,1.2740648
3010,fattoria di Pratolungo,B,Late Imperial Period,10,300,500,200,1.2740648
3011,,A,Archaic Period,6,-400,-350,50,0.37074211
3011,,A,Republican Period,7,-350,-200,150,0.37074211
3011,,B,Early Imperial Period,8,-30,100,130,0.37074211
3011,,B,Mid-Imperial Period,9,100,300,200,0.37074211
3011,,B,Late Imperial Period,10,300,500,200,0.37074211
3012,,A,Late Iron Age,5,-600,-580,20,0.34046578
3012,,A,Archaic Period,6,-580,-500,80,0.34046578
3012,,B,Early Imperial Period,8,-30,100,130,0.34046578
3012,,B,Mid-Imperial Period,9,100,300,200,0.34046578
3012,,B,Late Imperial Period,10,300,500,200,0.34046578
3013,,A,Archaic Period,6,-400,-350,50,0.39894235
3013,,A,Republican Period,7,-350,-200,150,0.39894235
3013,,B,Early Imperial Period,8,-30,100,130,0.39894235
3013,,B,Mid-Imperial Period,9,100,300,200,0.39894235
3013,,B,Late Imperial Period,10,300,500,200,0.39894235
3014,,A,Early Imperial Period,8,-30,100,130,0.38849226
3014,,A,Mid-Imperial Period,9,100,300,200,0.38849226
3014,,A,Late Imperial Period,10,300,500,200,0.38849226
3015,Quarto di Tor Carbone,A,Archaic Period,6,-400,-350,50,0.78776425
3015,Quarto di Tor Carbone,A,Republican Period,7,-350,-200,150,0.78776425
3015,Quarto di Tor Carbone,B,Early Imperial Period,8,-30,100,130,0.78776425
3015,Quarto di Tor Carbone,B,Mid-Imperial Period,9,100,300,200,0.78776425
3015,Quarto di Tor Carbone,B,Late Imperial Period,10,300,500,200,0.78776425
3016,,A,Archaic Period,6,-400,-350,50,0.76928848
3016,,A,Republican Period,7,-350,-30,320,0.76928848
3016,,A,Early Imperial Period,8,-30,100,130,1.967778
3016,,A,Mid-Imperial Period,9,100,300,200,1.967778
3016,,A,Late Imperial Period,10,300,500,200,1.967778
3017,,A,Early Imperial Period,8,-30,100,130,0.92105293
3017,,A,Mid-Imperial Period,9,100,300,200,0.92105293
3017,,A,Late Imperial Period,10,300,500,200,0.92105293
3018,,A,Late Iron Age,5,-600,-580,20,0.45840016
3018,,A,Archaic Period,6,-580,-500,80,0.45840016
3018,,B,Early Imperial Period,8,-30,100,130,1.3250797
3018,,B,Mid-Imperial Period,9,100,300,200,1.3250797
3018,,B,Late Imperial Period,10,300,500,200,1.3250797
3019,,A,Early Imperial Period,8,-30,100,130,1.3448694
3019,,A,Mid-Imperial Period,9,100,300,200,1.3448694
3019,,A,Late Imperial Period,10,300,500,200,1.3448694
3020,,A,Early Imperial Period,8,-30,100,130,1.3240203
3020,,A,Mid-Imperial Period,9,100,300,200,1.3240203
3020,,A,Late Imperial Period,10,300,500,200,1.3240203
3021,Tor Angela,A,Republican Period,7,-100,-30,70,0.96801448
3021,Tor Angela,A,Early Imperial Period,8,-30,100,130,0.96801448
3021,Tor Angela,A,Mid-Imperial Period,9,100,300,200,0.96801448
3021,Tor Angela,A,Late Imperial Period,10,300,500,200,0.96801448
3022,Tor Angela,A,Archaic Period,6,-400,-350,50,0.67948115
3022,Tor Angela,A,Republican Period,7,-350,-200,150,0.67948115
3023,Tor Angela,A,Early Imperial Period,8,-30,100,130,0.7637037
3023,Tor Angela,A,Mid-Imperial Period,9,100,300,200,0.7637037
3023,Tor Angela,A,Late Imperial Period,10,300,500,200,0.7637037
3024,Tor Angela,A,Archaic Period,6,-500,-350,150,0.50540507
3024,Tor Angela,A,Republican Period,7,-350,-100,250,0.50540507
3025,Palazzetto Lanza,A,Early Imperial Period,8,-30,100,130,0.97319406
3025,Palazzetto Lanza,A,Mid-Imperial Period,9,100,300,200,0.97319406
3025,Palazzetto Lanza,A,Late Imperial Period,10,300,500,200,0.97319406
3026,,A,Late Iron Age,5,-600,-580,20,0.54400361
3026,,A,Archaic Period,6,-580,-500,80,0.54400361
3026,,B,Early Imperial Period,8,-30,100,130,0.54400361
3026,,B,Mid-Imperial Period,9,100,300,200,0.54400361
3026,,B,Late Imperial Period,10,300,500,200,0.54400361
3027,,A,Archaic Period,6,-400,-350,50,1.3612533
3027,,A,Republican Period,7,-350,-200,150,1.3612533
3027,,B,Early Imperial Period,8,-30,100,130,1.3612533
3027,,B,Mid-Imperial Period,9,100,300,200,1.3612533
3027,,B,Late Imperial Period,10,300,500,200,1.3612533
3028,Tor Angela,A,Archaic Period,6,-400,-350,50,1.5047662
3028,Tor Angela,A,Republican Period,7,-350,-30,320,1.5047662
3029,,A,Archaic Period,6,-500,-350,150,0.83440179
3029,,A,Republican Period,7,-350,-300,50,0.83440179
3029,,B,Early Imperial Period,8,-30,100,130,1.5093679
3029,,B,Mid-Imperial Period,9,100,300,200,1.5093679
3029,,B,Late Imperial Period,10,300,500,200,1.5093679
3030,,A,Archaic Period,6,-500,-350,150,0.86817431
3030,,A,Republican Period,7,-350,-200,150,0.86817431
3030,,B,Early Imperial Period,8,-30,100,130,0.86817431
3030,,B,Mid-Imperial Period,9,100,300,200,0.86817431
3030,,B,Late Imperial Period,10,300,500,200,0.86817431
3031,,A,Late Iron Age,5,-600,-580,20,0.15977946
3031,,A,Archaic Period,6,-580,-500,80,0.15977946
3031,,B,Early Imperial Period,8,-30,100,130,2.1860898
3031,,B,Mid-Imperial Period,9,100,300,200,2.1860898
3031,,B,Late Imperial Period,10,300,500,200,2.1860898
3032,,A,Late Iron Age,5,-600,-580,20,0.31537113
3032,,A,Archaic Period,6,-580,-500,80,0.31537113
3033,,A,Early Imperial Period,8,-30,100,130,0.29099914
3033,,A,Mid-Imperial Period,9,100,300,200,0.29099914
3033,,A,Late Imperial Period,10,300,500,200,0.29099914
3034,,A,Archaic Period,6,-400,-350,50,1.4915535
3034,,A,Republican Period,7,-350,-200,150,1.4915535
3034,,B,Early Imperial Period,8,-30,100,130,1.4915535
3034,,B,Mid-Imperial Period,9,100,300,200,1.4915535
3034,,B,Late Imperial Period,10,300,500,200,1.4915535
3035,,A,Early Imperial Period,8,-30,100,130,0.38844225
3035,,A,Mid-Imperial Period,9,100,300,200,0.38844225
3035,,A,Late Imperial Period,10,300,500,200,0.38844225
3036,Tenuta di Tor Angela,A,Archaic Period,6,-500,-400,100,0.6975376
3036,Tenuta di Tor Angela,B,Early Imperial Period,8,-30,100,130,0.6975376
3036,Tenuta di Tor Angela,B,Mid-Imperial Period,9,100,300,200,0.6975376
3036,Tenuta di Tor Angela,B,Late Imperial Period,10,300,500,200,0.6975376
3037,Tor Angela vecchia,A,Early Imperial Period,8,-30,100,130,1.4465969
3037,Tor Angela vecchia,A,Mid-Imperial Period,9,100,300,200,1.4465969
3037,Tor Angela vecchia,A,Late Imperial Period,10,300,500,200,1.4465969
3038,,A,Early Imperial Period,8,-30,100,130,0.33326685
3038,,A,Mid-Imperial Period,9,100,300,200,0.33326685
3038,,A,Late Imperial Period,10,300,500,200,0.33326685
3039,,A,Archaic Period,6,-400,-350,50,0.84596199
3039,,A,Republican Period,7,-350,-200,150,0.84596199
3039,,B,Early Imperial Period,8,-30,100,130,0.84596199
3039,,B,Mid-Imperial Period,9,100,300,200,0.84596199
3039,,B,Late Imperial Period,10,300,500,200,0.84596199
3040,,A,Republican Period,7,-100,-30,70,0.77793264
3040,,A,Early Imperial Period,8,-30,100,130,0.77793264
3040,,A,Mid-Imperial Period,9,100,300,200,0.77793264
3040,,A,Late Imperial Period,10,300,500,200,0.77793264
3041,,A,Early Imperial Period,8,-30,100,130,0.82686043
3041,,A,Mid-Imperial Period,9,100,300,200,0.82686043
3041,,A,Late Imperial Period,10,300,500,200,0.82686043
3042,,A,Early Imperial Period,8,-30,100,130,0.47297269
3042,,A,Mid-Imperial Period,9,100,300,200,0.47297269
3042,,A,Late Imperial Period,10,300,500,200,0.47297269
3043,,A,Early Imperial Period,8,-30,100,130,0.44113868
3043,,A,Mid-Imperial Period,9,100,300,200,0.44113868
3043,,A,Late Imperial Period,10,300,500,200,0.44113868
3044,,A,Early Imperial Period,8,-30,100,130,0.65834504
3044,,A,Mid-Imperial Period,9,100,300,200,0.65834504
3044,,A,Late Imperial Period,10,300,500,200,0.65834504
3045,,A,Republican Period,7,-300,-100,200,1.3214462
3046,casale Passerella,A,Archaic Period,6,-400,-350,50,0.89821643
3046,casale Passerella,A,Republican Period,7,-350,-30,320,0.89821643
3047,casale Passerella,A,Early Imperial Period,8,-30,100,130,0.62239391
3047,casale Passerella,A,Mid-Imperial Period,9,100,300,200,0.62239391
3047,casale Passerella,A,Late Imperial Period,10,300,500,200,0.62239391
3048,,A,Early Imperial Period,8,-30,100,130,1.3472261
3048,,A,Mid-Imperial Period,9,100,300,200,1.3472261
3048,,A,Late Imperial Period,10,300,500,200,1.3472261
3049,,A,Early Imperial Period,8,-30,100,130,0.59435332
3049,,A,Mid-Imperial Period,9,100,300,200,0.59435332
3049,,A,Late Imperial Period,10,300,500,200,0.59435332
3050,,A,Early Imperial Period,8,-30,100,130,0.99683011
3050,,A,Mid-Imperial Period,9,100,300,200,0.99683011
3050,,A,Late Imperial Period,10,300,500,200,0.99683011
3051,Tor Tre Teste,A,Republican Period,7,-100,-30,70,0.45259455
3052,Tor Tre Teste,A,Early Imperial Period,8,-30,100,130,0.90614867
3052,Tor Tre Teste,A,Mid-Imperial Period,9,100,300,200,0.90614867
3052,Tor Tre Teste,A,Late Imperial Period,10,300,500,200,0.90614867
3053,Tor Tre Teste,A,Early Imperial Period,8,-30,100,130,0.76880401
3053,Tor Tre Teste,A,Mid-Imperial Period,9,100,300,200,0.76880401
3053,Tor Tre Teste,A,Late Imperial Period,10,300,500,200,0.76880401
3054,Tor Tre Teste,A,Archaic Period,6,-400,-350,50,1.0230634
3054,Tor Tre Teste,A,Republican Period,7,-350,-200,150,1.0230634
3054,Tor Tre Teste,B,Early Imperial Period,8,-30,100,130,1.0230634
3054,Tor Tre Teste,B,Mid-Imperial Period,9,100,300,200,1.0230634
3054,Tor Tre Teste,B,Late Imperial Period,10,300,500,200,1.0230634
3055,Tor Tre Teste,A,Late Iron Age,5,-600,-580,20,0.90993524
3055,Tor Tre Teste,A,Archaic Period,6,-580,-500,80,0.90993524
3055,Tor Tre Teste,B,Early Imperial Period,8,-30,100,130,0.90993524
3055,Tor Tre Teste,B,Mid-Imperial Period,9,100,300,200,0.90993524
3055,Tor Tre Teste,B,Late Imperial Period,10,300,500,200,0.90993524
3056,vacchareccia del Quarticciolo,A,Early Imperial Period,8,-30,100,130,1.387792
3056,vacchareccia del Quarticciolo,A,Mid-Imperial Period,9,100,300,200,1.387792
3056,vacchareccia del Quarticciolo,A,Late Imperial Period,10,300,500,200,1.387792
3057,,A,Early Imperial Period,8,-30,100,130,0.87933338
3057,,A,Mid-Imperial Period,9,100,300,200,0.87933338
3057,,A,Late Imperial Period,10,300,500,200,0.87933338
3058,Quarticciolo,A,Early Imperial Period,8,-30,100,130,1.0320115
3058,Quarticciolo,A,Mid-Imperial Period,9,100,300,200,1.0320115
3058,Quarticciolo,A,Late Imperial Period,10,300,500,200,1.0320115
3059,Borgata Alessandrina,A,Early Imperial Period,8,-30,100,130,0.68458635
3059,Borgata Alessandrina,A,Mid-Imperial Period,9,100,300,200,0.68458635
3059,Borgata Alessandrina,A,Late Imperial Period,10,300,500,200,0.68458635
3060,Borgata Alessandrina,A,Early Imperial Period,8,-30,100,130,0.71231318
3060,Borgata Alessandrina,A,Mid-Imperial Period,9,100,300,200,0.71231318
3060,Borgata Alessandrina,A,Late Imperial Period,10,300,500,200,0.71231318
3061,Borgata Alessandrina,A,Early Imperial Period,8,-30,100,130,1.2569779
3061,Borgata Alessandrina,A,Mid-Imperial Period,9,100,300,200,1.2569779
3061,Borgata Alessandrina,A,Late Imperial Period,10,300,500,200,1.2569779
3062,,A,Early Imperial Period,8,-30,100,130,1.4648923
3062,,A,Mid-Imperial Period,9,100,300,200,1.4648923
3062,,A,Late Imperial Period,10,300,500,200,1.4648923
3063,,A,Early Imperial Period,8,-30,100,130,1.6309918
3063,,A,Mid-Imperial Period,9,100,300,200,1.6309918
3063,,A,Late Imperial Period,10,300,500,200,1.6309918
3064,,A,Early Imperial Period,8,-30,100,130,0.68668085
3064,,A,Mid-Imperial Period,9,100,300,200,0.68668085
3064,,A,Late Imperial Period,10,300,500,200,0.68668085
3065,,A,Early Imperial Period,8,-30,100,130,0.44560438
3065,,A,Mid-Imperial Period,9,100,300,200,0.44560438
3065,,A,Late Imperial Period,10,300,500,200,0.44560438
3066,Casa Calda,A,Archaic Period,6,-400,-350,50,1.2290026
3066,Casa Calda,A,Republican Period,7,-350,-200,150,1.2290026
3066,Casa Calda,B,Early Imperial Period,8,-30,100,130,1.2290026
3066,Casa Calda,B,Mid-Imperial Period,9,100,300,200,1.2290026
3066,Casa Calda,B,Late Imperial Period,10,300,500,200,1.2290026
3067,Casa Calda,A,Early Imperial Period,8,-30,100,130,0.32803452
3067,Casa Calda,A,Mid-Imperial Period,9,100,300,200,0.32803452
3067,Casa Calda,A,Late Imperial Period,10,300,500,200,0.32803452
3068,,A,Early Imperial Period,8,-30,100,130,0.80227822
3068,,A,Mid-Imperial Period,9,100,300,200,0.80227822
3068,,A,Late Imperial Period,10,300,500,200,0.80227822
3069,,A,Early Imperial Period,8,-30,100,130,0.50225514
3069,,A,Mid-Imperial Period,9,100,300,200,0.50225514
3069,,A,Late Imperial Period,10,300,500,200,0.50225514
3070,,A,Early Imperial Period,8,-30,100,130,0.58773965
3070,,A,Mid-Imperial Period,9,100,300,200,0.58773965
3070,,A,Late Imperial Period,10,300,500,200,0.58773965
3071,S. Maria,A,Early Imperial Period,8,-30,100,130,1.6597682
3071,S. Maria,A,Mid-Imperial Period,9,100,300,200,1.6597682
3071,S. Maria,A,Late Imperial Period,10,300,500,200,1.6597682
3072,S. Maria,A,Early Imperial Period,8,-30,100,130,0.52526122
3072,S. Maria,A,Mid-Imperial Period,9,100,300,200,0.52526122
3072,S. Maria,A,Late Imperial Period,10,300,500,200,0.52526122
3073,fattoria Due Torri,A,Early Imperial Period,8,-30,100,130,1.1590514
3073,fattoria Due Torri,A,Mid-Imperial Period,9,100,300,200,1.1590514
3073,fattoria Due Torri,A,Late Imperial Period,10,300,500,200,1.1590514
3074,,A,Early Imperial Period,8,-30,100,130,0.28060022
3074,,A,Mid-Imperial Period,9,100,300,200,0.28060022
3074,,A,Late Imperial Period,10,300,500,200,0.28060022
3075,Le Due Torri,A,Early Imperial Period,8,-30,100,130,0.65671813
3075,Le Due Torri,A,Mid-Imperial Period,9,100,300,200,0.65671813
3075,Le Due Torri,A,Late Imperial Period,10,300,500,200,0.65671813
3076,Le Due Torri,A,Early Imperial Period,8,-30,100,130,0.91872746
3076,Le Due Torri,A,Mid-Imperial Period,9,100,300,200,0.91872746
3076,Le Due Torri,A,Late Imperial Period,10,300,500,200,0.91872746
3077,,A,Late Iron Age,5,-600,-580,20,0.39995855
3077,,A,Archaic Period,6,-580,-500,80,0.39995855
3077,,B,Early Imperial Period,8,-30,100,130,0.39995855
3077,,B,Mid-Imperial Period,9,100,300,200,0.39995855
3077,,B,Late Imperial Period,10,300,500,200,0.39995855
3078,Case Calde,A,Late Iron Age,5,-600,-580,20,0.59387153
3078,Case Calde,B,Archaic Period,6,-580,-350,230,0.59387153
3078,Case Calde,B,Republican Period,7,-350,-200,150,0.59387153
3078,Case Calde,C,Early Imperial Period,8,-30,100,130,0.59387153
3078,Case Calde,C,Mid-Imperial Period,9,100,300,200,0.59387153
3078,Case Calde,C,Late Imperial Period,10,300,500,200,0.59387153
3079,Case Calde,A,Early Imperial Period,8,-30,100,130,1.76536
3079,Case Calde,A,Mid-Imperial Period,9,100,300,200,1.76536
3079,Case Calde,A,Late Imperial Period,10,300,500,200,1.76536
3080,,A,Archaic Period,6,-500,-350,150,0.59417576
3080,,A,Republican Period,7,-350,-100,250,0.59417576
3081,,A,Archaic Period,6,-500,-400,100,0.47419831
3082,Casale La Mistica,A,Republican Period,7,-100,-30,70,1.6273519
3082,Casale La Mistica,A,Early Imperial Period,8,-30,100,130,1.6273519
3083,,A,Early Imperial Period,8,-30,100,130,0.56880879
3083,,A,Mid-Imperial Period,9,100,300,200,0.56880879
3083,,A,Late Imperial Period,10,300,500,200,0.56880879
3084,,A,Republican Period,7,-100,-30,70,2.2523317
3084,,A,Early Imperial Period,8,-30,100,130,2.2523317
3084,,A,Mid-Imperial Period,9,100,300,200,2.2523317
3084,,A,Late Imperial Period,10,300,500,200,2.2523317
3085,,A,Early Imperial Period,8,-30,100,130,0.28324452
3085,,A,Mid-Imperial Period,9,100,300,200,0.28324452
3085,,A,Late Imperial Period,10,300,500,200,0.28324452
3086,,A,Early Imperial Period,8,-30,100,130,0.5222972
3086,,A,Mid-Imperial Period,9,100,300,200,0.5222972
3086,,A,Late Imperial Period,10,300,500,200,0.5222972
3087,Fattoria Due Torri,A,Early Imperial Period,8,-30,100,130,2.2505968
3087,Fattoria Due Torri,A,Mid-Imperial Period,9,100,300,200,2.2505968
3087,Fattoria Due Torri,A,Late Imperial Period,10,300,500,200,2.2505968
3088,Fattoria Due Torri,A,Early Imperial Period,8,-30,100,130,0.78171533
3088,Fattoria Due Torri,A,Mid-Imperial Period,9,100,300,200,0.78171533
3088,Fattoria Due Torri,A,Late Imperial Period,10,300,500,200,0.78171533
3089,il Torraccio,A,Early Imperial Period,8,-30,100,130,0.56302321
3089,il Torraccio,A,Mid-Imperial Period,9,100,300,200,0.56302321
3089,il Torraccio,A,Late Imperial Period,10,300,500,200,0.56302321
3090,il Torraccio,A,Archaic Period,6,-500,-400,100,0.65085822
3090,il Torraccio,B,Early Imperial Period,8,-30,100,130,0.65085822
3090,il Torraccio,B,Mid-Imperial Period,9,100,300,200,0.65085822
3090,il Torraccio,B,Late Imperial Period,10,300,500,200,0.65085822
3091,il Torraccio,A,Early Imperial Period,8,-30,100,130,0.76259333
3091,il Torraccio,A,Mid-Imperial Period,9,100,300,200,0.76259333
3091,il Torraccio,A,Late Imperial Period,10,300,500,200,0.76259333
3092,il Torraccio,A,Mid-Imperial Period,9,100,300,200,0.84606284
3092,il Torraccio,A,Late Imperial Period,10,300,500,200,0.84606284
3093,il Torraccio,A,Republican Period,7,-100,-30,70,0.55888224
3094,Torraccio di Torrenova,A,Early Imperial Period,8,-30,100,130,4.2575002
3094,Torraccio di Torrenova,A,Mid-Imperial Period,9,100,300,200,4.2575002
3094,Torraccio di Torrenova,A,Late Imperial Period,10,300,500,200,4.2575002
3095,,A,Archaic Period,6,-400,-350,50,0.4934105
3095,,A,Republican Period,7,-350,-200,150,0.4934105
3095,,B,Early Imperial Period,8,-30,100,130,0.4934105
3095,,B,Mid-Imperial Period,9,100,300,200,0.4934105
3095,,B,Late Imperial Period,10,300,500,200,0.4934105
3096,Casette,A,Early Imperial Period,8,-30,100,130,0.83063143
3096,Casette,A,Mid-Imperial Period,9,100,300,200,0.83063143
3096,Casette,A,Late Imperial Period,10,300,500,200,0.83063143
3097,,A,Late Iron Age,5,-600,-580,20,1.1496265
3097,,A,Archaic Period,6,-580,-500,80,1.1496265
3098,,A,Early Imperial Period,8,-30,100,130,1.2457552
3098,,A,Mid-Imperial Period,9,100,300,200,1.2457552
3098,,A,Late Imperial Period,10,300,500,200,1.2457552
3099,,A,Late Iron Age,5,-600,-580,20,0.49553013
3099,,A,Archaic Period,6,-580,-500,80,0.49553013
3099,,B,Early Imperial Period,8,-30,100,130,0.49553013
3099,,B,Mid-Imperial Period,9,100,300,200,0.49553013
3099,,B,Late Imperial Period,10,300,500,200,0.49553013
3100,,A,Late Iron Age,5,-600,-580,20,0.93181831
3100,,A,Archaic Period,6,-580,-500,80,0.93181831
3101,,A,Early Imperial Period,8,-30,100,130,0.87693685
3101,,A,Mid-Imperial Period,9,100,300,200,0.87693685
3101,,A,Late Imperial Period,10,300,500,200,0.87693685
3102,Tor Bella Monaca,A,Early Imperial Period,8,-30,100,130,2.9941289
3102,Tor Bella Monaca,A,Mid-Imperial Period,9,100,300,200,2.9941289
3102,Tor Bella Monaca,A,Late Imperial Period,10,300,500,200,2.9941289
3103,Tor Bella Monaca,A,Early Imperial Period,8,-30,100,130,0.47189012
3103,Tor Bella Monaca,A,Mid-Imperial Period,9,100,300,200,0.47189012
3103,Tor Bella Monaca,A,Late Imperial Period,10,300,500,200,0.47189012
3104,,A,Early Imperial Period,8,-30,100,130,0.72327614
3104,,A,Mid-Imperial Period,9,100,300,200,0.72327614
3104,,A,Late Imperial Period,10,300,500,200,0.72327614
3105,,A,Early Imperial Period,8,-30,100,130,1.0106512
3105,,A,Mid-Imperial Period,9,100,300,200,1.0106512
3105,,A,Late Imperial Period,10,300,500,200,1.0106512
3106,Grotte di Pompeo,A,Late Iron Age,5,-600,-580,20,1.3420284
3106,Grotte di Pompeo,A,Archaic Period,6,-580,-500,80,1.3420284
3106,Grotte di Pompeo,B,Early Imperial Period,8,-30,100,130,3.6432321
3106,Grotte di Pompeo,B,Mid-Imperial Period,9,100,300,200,3.6432321
3106,Grotte di Pompeo,B,Late Imperial Period,10,300,500,200,3.6432321
3107,,A,Early Imperial Period,8,-30,100,130,0.60869664
3107,,A,Mid-Imperial Period,9,100,300,200,0.60869664
3107,,A,Late Imperial Period,10,300,500,200,0.60869664
3108,,A,Early Imperial Period,8,-30,100,130,0.52265406
3108,,A,Mid-Imperial Period,9,100,300,200,0.52265406
3108,,A,Late Imperial Period,10,300,500,200,0.52265406
3109,Stazione Borghesiana,A,Early Imperial Period,8,-30,100,130,1.0385695
3109,Stazione Borghesiana,A,Mid-Imperial Period,9,100,300,200,1.0385695
3109,Stazione Borghesiana,A,Late Imperial Period,10,300,500,200,1.0385695
3110,,A,Early Imperial Period,8,-30,100,130,0.85074389
3110,,A,Mid-Imperial Period,9,100,300,200,0.85074389
3110,,A,Late Imperial Period,10,300,500,200,0.85074389
3111,,A,Late Iron Age,5,-600,-580,20,0.7286697
3111,,A,Archaic Period,6,-580,-500,80,0.7286697
3111,,B,Early Imperial Period,8,-30,100,130,0.7286697
3111,,B,Mid-Imperial Period,9,100,300,200,0.7286697
3111,,B,Late Imperial Period,10,300,500,200,0.7286697
3112,Capanna Murata,A,Late Iron Age,5,-600,-580,20,1.1480827
3112,Capanna Murata,A,Archaic Period,6,-580,-500,80,1.1480827
3112,Capanna Murata,B,Early Imperial Period,8,-30,100,130,1.1480827
3112,Capanna Murata,B,Mid-Imperial Period,9,100,300,200,1.1480827
3112,Capanna Murata,B,Late Imperial Period,10,300,500,200,1.1480827
3113,Fattoria di Capanna Murata,A,Late Iron Age,5,-600,-580,20,3.8040719
3113,Fattoria di Capanna Murata,B,Archaic Period,6,-580,-350,230,3.8040719
3113,Fattoria di Capanna Murata,B,Republican Period,7,-350,-200,150,3.8040719
3113,Fattoria di Capanna Murata,C,Early Imperial Period,8,-30,100,130,3.8040719
3113,Fattoria di Capanna Murata,C,Mid-Imperial Period,9,100,300,200,3.8040719
3113,Fattoria di Capanna Murata,C,Late Imperial Period,10,300,500,200,3.8040719
3114,Quarto di Tor Carbone,A,Early Imperial Period,8,-30,100,130,1.833627
3114,Quarto di Tor Carbone,A,Mid-Imperial Period,9,100,300,200,1.833627
3114,Quarto di Tor Carbone,A,Late Imperial Period,10,300,500,200,1.833627
3115,Fattoria di Tor Carbone,A,Late Iron Age,5,-600,-580,20,0.80862314
3115,Fattoria di Tor Carbone,A,Archaic Period,6,-580,-500,80,0.80862314
3115,Fattoria di Tor Carbone,B,Early Imperial Period,8,-30,100,130,0.80862314
3115,Fattoria di Tor Carbone,B,Mid-Imperial Period,9,100,300,200,0.80862314
3115,Fattoria di Tor Carbone,B,Late Imperial Period,10,300,500,200,0.80862314
3116,,A,Early Imperial Period,8,-30,100,130,0.32808259
3116,,A,Mid-Imperial Period,9,100,300,200,0.32808259
3116,,A,Late Imperial Period,10,300,500,200,0.32808259
3117,Tor Carbone,A,Early Imperial Period,8,-30,100,130,4.1648965
3117,Tor Carbone,A,Mid-Imperial Period,9,100,300,200,4.1648965
3117,Tor Carbone,A,Late Imperial Period,10,300,500,200,4.1648965
3118,,A,Early Imperial Period,8,-30,100,130,1.5698024
3118,,A,Mid-Imperial Period,9,100,300,200,1.5698024
3118,,A,Late Imperial Period,10,300,500,200,1.5698024
3119,,A,Early Imperial Period,8,-30,100,130,0.84192979
3119,,A,Mid-Imperial Period,9,100,300,200,0.84192979
3119,,A,Late Imperial Period,10,300,500,200,0.84192979
3120,,A,Early Imperial Period,8,-30,100,130,0.92905903
3120,,A,Mid-Imperial Period,9,100,300,200,0.92905903
3120,,A,Late Imperial Period,10,300,500,200,0.92905903
3121,Torraccio di S. Antonio,A,Late Iron Age,5,-600,-580,20,2.419421
3121,Torraccio di S. Antonio,B,Archaic Period,6,-580,-350,230,2.419421
3121,Torraccio di S. Antonio,B,Republican Period,7,-350,-200,150,2.419421
3121,Torraccio di S. Antonio,C,Early Imperial Period,8,-30,100,130,2.419421
3121,Torraccio di S. Antonio,C,Mid-Imperial Period,9,100,300,200,2.419421
3121,Torraccio di S. Antonio,C,Late Imperial Period,10,300,500,200,2.419421
3122,Torraccio di S. Antonio,A,Late Iron Age,5,-600,-580,20,1.7459514
3122,Torraccio di S. Antonio,B,Archaic Period,6,-580,-350,230,1.7459514
3122,Torraccio di S. Antonio,B,Republican Period,7,-350,-30,320,1.7459514
3123,,A,Republican Period,7,-100,-30,70,1.2010697
3123,,A,Early Imperial Period,8,-30,100,130,1.2010697
3124,,A,Archaic Period,6,-400,-350,50,0.4879218
3124,,A,Republican Period,7,-350,-200,150,0.4879218
3125,,A,Archaic Period,6,-400,-350,50,1.8714116
3125,,A,Republican Period,7,-350,-30,320,1.8714116
3126,,A,Early Imperial Period,8,-30,100,130,1.7522389
3126,,A,Mid-Imperial Period,9,100,300,200,1.7522389
3126,,A,Late Imperial Period,10,300,500,200,1.7522389
3127,,A,Late Iron Age,5,-600,-580,20,2.2601449
3127,,A,Archaic Period,6,-580,-350,230,2.2601449
3127,,A,Republican Period,7,-350,-30,320,2.2601449
3127,,A,Early Imperial Period,8,-30,100,130,2.2601449
3127,,A,Mid-Imperial Period,9,100,300,200,2.2601449
3127,,A,Late Imperial Period,10,300,500,200,2.2601449
3128,,A,Late Iron Age,5,-600,-580,20,0.94195342
3128,,A,Archaic Period,6,-580,-350,230,0.94195342
3128,,A,Republican Period,7,-350,-30,320,0.94195342
3128,,A,Early Imperial Period,8,-30,100,130,0.94195342
3128,,A,Mid-Imperial Period,9,100,300,200,0.94195342
3128,,A,Late Imperial Period,10,300,500,200,0.94195342
3129,,A,Early Imperial Period,8,-30,100,130,0.89631718
3129,,A,Mid-Imperial Period,9,100,300,200,0.89631718
3129,,A,Late Imperial Period,10,300,500,200,0.89631718
3130,,A,Late Iron Age,5,-600,-580,20,2.7565229
3130,,A,Archaic Period,6,-580,-350,230,2.7565229
3130,,A,Republican Period,7,-350,-200,150,2.7565229
3131,Quarto Grande,A,Early Imperial Period,8,-30,100,130,1.0501651
3131,Quarto Grande,A,Mid-Imperial Period,9,100,300,200,1.0501651
3131,Quarto Grande,A,Late Imperial Period,10,300,500,200,1.0501651
3132,,A,Early Imperial Period,8,-30,100,130,0.23102696
3132,,A,Mid-Imperial Period,9,100,300,200,0.23102696
3132,,A,Late Imperial Period,10,300,500,200,0.23102696
3133,,A,Early Imperial Period,8,-30,100,130,0.24962009
3133,,A,Mid-Imperial Period,9,100,300,200,0.24962009
3133,,A,Late Imperial Period,10,300,500,200,0.24962009
3134,casale Corvio,A,Late Iron Age,5,-600,-580,20,0.16824818
3134,casale Corvio,A,Archaic Period,6,-580,-500,80,0.16824818
3134,casale Corvio,B,Early Imperial Period,8,-30,100,130,2.4975343
3134,casale Corvio,B,Mid-Imperial Period,9,100,300,200,2.4975343
3134,casale Corvio,B,Late Imperial Period,10,300,500,200,2.4975343
3135,,A,Early Imperial Period,8,-30,100,130,4.409276
3135,,A,Mid-Imperial Period,9,100,300,200,4.409276
3135,,A,Late Imperial Period,10,300,500,200,4.409276
3136,,A,Archaic Period,6,-500,-400,100,0.40665025
3137,Finocchio,A,Early Imperial Period,8,-30,100,130,1.1687706
3137,Finocchio,A,Mid-Imperial Period,9,100,300,200,1.1687706
3137,Finocchio,A,Late Imperial Period,10,300,500,200,1.1687706
3138,Finocchio,A,Early Imperial Period,8,-30,100,130,2.992408
3138,Finocchio,A,Mid-Imperial Period,9,100,300,200,2.992408
3138,Finocchio,A,Late Imperial Period,10,300,500,200,2.992408
3139,,A,Early Imperial Period,8,-30,100,130,2.0869825
3139,,A,Mid-Imperial Period,9,100,300,200,2.0869825
3139,,A,Late Imperial Period,10,300,500,200,2.0869825
3140,,A,Early Imperial Period,8,-30,100,130,0.66262263
3140,,A,Mid-Imperial Period,9,100,300,200,0.66262263
3140,,A,Late Imperial Period,10,300,500,200,0.66262263
3141,,A,Early Imperial Period,8,-30,100,130,0.87834877
3141,,A,Mid-Imperial Period,9,100,300,200,0.87834877
3141,,A,Late Imperial Period,10,300,500,200,0.87834877
3142,,A,Early Imperial Period,8,-30,100,130,1.7579745
3142,,A,Mid-Imperial Period,9,100,300,200,1.7579745
3142,,A,Late Imperial Period,10,300,500,200,1.7579745
3143,,A,Early Imperial Period,8,-30,100,130,1.9879676
3143,,A,Mid-Imperial Period,9,100,300,200,1.9879676
3143,,A,Late Imperial Period,10,300,500,200,1.9879676
3144,,A,Early Imperial Period,8,-30,100,130,0.86557686
3144,,A,Mid-Imperial Period,9,100,300,200,0.86557686
3144,,A,Late Imperial Period,10,300,500,200,0.86557686
3145,,A,Republican Period,7,-200,-30,170,2.3471057
3145,,A,Early Imperial Period,8,-30,100,130,2.3471057
3145,,A,Mid-Imperial Period,9,100,300,200,2.3471057
3145,,A,Late Imperial Period,10,300,500,200,2.3471057
3146,,A,Early Imperial Period,8,-30,100,130,1.4238434
3146,,A,Mid-Imperial Period,9,100,300,200,1.4238434
3146,,A,Late Imperial Period,10,300,500,200,1.4238434
3147,,A,Archaic Period,6,-400,-350,50,4.3150826
3147,,A,Republican Period,7,-350,-200,150,4.3150826
3148,,A,Early Imperial Period,8,-30,100,130,0.13421573
3148,,A,Mid-Imperial Period,9,100,300,200,0.13421573
3148,,A,Late Imperial Period,10,300,500,200,0.13421573
3149,,A,Early Imperial Period,8,-30,100,130,1.5593899
3149,,A,Mid-Imperial Period,9,100,300,200,1.5593899
3149,,A,Late Imperial Period,10,300,500,200,1.5593899
3150,,A,Early Imperial Period,8,-30,100,130,0.52732807
3150,,A,Mid-Imperial Period,9,100,300,200,0.52732807
3150,,A,Late Imperial Period,10,300,500,200,0.52732807
3151,,A,Early Imperial Period,8,-30,100,130,1.0821247
3151,,A,Mid-Imperial Period,9,100,300,200,1.0821247
3151,,A,Late Imperial Period,10,300,500,200,1.0821247
3152,,A,Archaic Period,6,-500,-350,150,1.4013246
3152,,A,Republican Period,7,-350,-200,150,1.4013246
3153,,A,Archaic Period,6,-400,-350,50,0.7007634
3153,,A,Republican Period,7,-350,-200,150,0.7007634
3154,,A,Early Imperial Period,8,-30,100,130,0.59102964
3154,,A,Mid-Imperial Period,9,100,300,200,0.59102964
3154,,A,Late Imperial Period,10,300,500,200,0.59102964
3155,,A,Archaic Period,6,-400,-350,50,0.85554463
3155,,A,Republican Period,7,-350,-30,320,0.85554463
3155,,A,Early Imperial Period,8,-30,100,130,0.85554463
3155,,A,Mid-Imperial Period,9,100,300,200,0.85554463
3155,,A,Late Imperial Period,10,300,500,200,0.85554463
3156,fattoria Selvotta,A,Republican Period,7,-100,-30,70,0.58980411
3157,,A,Archaic Period,6,-500,-400,100,0.3050563
3157,,B,Early Imperial Period,8,-30,100,130,0.3050563
3157,,B,Mid-Imperial Period,9,100,300,200,0.3050563
3157,,B,Late Imperial Period,10,300,500,200,0.3050563
3158,,A,Early Imperial Period,8,-30,100,130,2.7512155
3158,,A,Mid-Imperial Period,9,100,300,200,2.7512155
3158,,A,Late Imperial Period,10,300,500,200,2.7512155
3159,fattoria Selvotta,A,Early Imperial Period,8,-30,100,130,2.9758563
3159,fattoria Selvotta,A,Mid-Imperial Period,9,100,300,200,2.9758563
3159,fattoria Selvotta,A,Late Imperial Period,10,300,500,200,2.9758563
3160,,A,Early Imperial Period,8,-30,100,130,3.2999136
3160,,A,Mid-Imperial Period,9,100,300,200,3.2999136
3160,,A,Late Imperial Period,10,300,500,200,3.2999136
3161,ponte della Catena,A,Early Imperial Period,8,-30,100,130,2.5529094
3161,ponte della Catena,A,Mid-Imperial Period,9,100,300,200,2.5529094
3161,ponte della Catena,A,Late Imperial Period,10,300,500,200,2.5529094
3162,,A,Early Imperial Period,8,-30,100,130,0.62624353
3162,,A,Mid-Imperial Period,9,100,300,200,0.62624353
3162,,A,Late Imperial Period,10,300,500,200,0.62624353
3163,,A,Early Imperial Period,8,-30,100,130,3.0675721
3163,,A,Mid-Imperial Period,9,100,300,200,3.0675721
3163,,A,Late Imperial Period,10,300,500,200,3.0675721
3164,,A,Republican Period,7,-200,-30,170,0.50173783
3164,,A,Early Imperial Period,8,-30,100,130,0.50173783
3164,,A,Mid-Imperial Period,9,100,300,200,0.50173783
3164,,A,Late Imperial Period,10,300,500,200,0.50173783
3165,,A,Early Imperial Period,8,-30,100,130,0.48162666
3165,,A,Mid-Imperial Period,9,100,300,200,0.48162666
3165,,A,Late Imperial Period,10,300,500,200,0.48162666
3166,,A,Early Imperial Period,8,-30,100,130,0.5946061
3166,,A,Mid-Imperial Period,9,100,300,200,0.5946061
3166,,A,Late Imperial Period,10,300,500,200,0.5946061
3167,,A,Early Imperial Period,8,-30,100,130,1.9827287
3167,,A,Mid-Imperial Period,9,100,300,200,1.9827287
3167,,A,Late Imperial Period,10,300,500,200,1.9827287
3168,,A,Early Imperial Period,8,-30,100,130,1.234383
3168,,A,Mid-Imperial Period,9,100,300,200,1.234383
3168,,A,Late Imperial Period,10,300,500,200,1.234383
3169,,A,Early Imperial Period,8,-30,100,130,0.51360172
3169,,A,Mid-Imperial Period,9,100,300,200,0.51360172
3169,,A,Late Imperial Period,10,300,500,200,0.51360172
3170,,A,Early Imperial Period,8,1,100,99,1.021412
3170,,A,Mid-Imperial Period,9,100,300,200,1.021412
3171,,A,Early Imperial Period,8,-30,100,130,0.80494374
3171,,A,Mid-Imperial Period,9,100,300,200,0.80494374
3171,,A,Late Imperial Period,10,300,500,200,0.80494374
3172,,A,Early Imperial Period,8,-30,100,130,1.1584462
3172,,A,Mid-Imperial Period,9,100,300,200,1.1584462
3172,,A,Late Imperial Period,10,300,500,200,1.1584462
3173,,A,Early Imperial Period,8,-30,100,130,0.98726416
3173,,A,Mid-Imperial Period,9,100,300,200,0.98726416
3173,,A,Late Imperial Period,10,300,500,200,0.98726416
3174,,A,Early Imperial Period,8,-30,100,130,1.4899067
3174,,A,Mid-Imperial Period,9,100,300,200,1.4899067
3174,,A,Late Imperial Period,10,300,500,200,1.4899067
3175,,A,Late Iron Age,5,-600,-580,20,0.35777315
3175,,A,Archaic Period,6,-580,-400,180,0.35777315
3175,,B,Early Imperial Period,8,-30,100,130,3.674722
3175,,B,Mid-Imperial Period,9,100,300,200,3.674722
3175,,B,Late Imperial Period,10,300,500,200,3.674722
3176,I Caminetti,A,Early Imperial Period,8,-30,100,130,2.730206
3176,I Caminetti,A,Mid-Imperial Period,9,100,300,200,2.730206
3176,I Caminetti,A,Late Imperial Period,10,300,500,200,2.730206
3177,fattoria Montesanto,A,Early Imperial Period,8,-30,100,130,5.1366987
3177,fattoria Montesanto,A,Mid-Imperial Period,9,100,300,200,5.1366987
3177,fattoria Montesanto,A,Late Imperial Period,10,300,500,200,5.1366987
3178,I Caminetti,A,Early Imperial Period,8,-30,100,130,0.17336708
3178,I Caminetti,A,Mid-Imperial Period,9,100,300,200,0.17336708
3178,I Caminetti,A,Late Imperial Period,10,300,500,200,0.17336708
3179,Tenuta Torre Nova,A,Early Imperial Period,8,-30,100,130,1.27706
3179,Tenuta Torre Nova,A,Mid-Imperial Period,9,100,300,200,1.27706
3179,Tenuta Torre Nova,A,Late Imperial Period,10,300,500,200,1.27706
3180,,A,Early Imperial Period,8,-30,100,130,0.72934604
3180,,A,Mid-Imperial Period,9,100,300,200,0.72934604
3180,,A,Late Imperial Period,10,300,500,200,0.72934604
3181,,A,Early Imperial Period,8,-30,100,130,1.0978621
3181,,A,Mid-Imperial Period,9,100,300,200,1.0978621
3181,,A,Late Imperial Period,10,300,500,200,1.0978621
3182,,A,Republican Period,7,-300,-200,100,1.1469778
3183,,A,Archaic Period,6,-400,-350,50,1.2425146
3183,,A,Republican Period,7,-350,-30,320,1.2425146
3183,,A,Early Imperial Period,8,-30,100,130,1.2425146
3183,,A,Mid-Imperial Period,9,100,300,200,1.2425146
3183,,A,Late Imperial Period,10,300,500,200,1.2425146
3184,,A,Archaic Period,6,-400,-350,50,0.25388256
3184,,A,Republican Period,7,-350,-200,150,0.25388256
3184,,B,Early Imperial Period,8,-30,100,130,0.25388256
3184,,B,Mid-Imperial Period,9,100,300,200,0.25388256
3184,,B,Late Imperial Period,10,300,500,200,0.25388256
3185,,A,Republican Period,7,-100,-30,70,1.8627498
3185,,A,Early Imperial Period,8,-30,100,130,1.8627498
3185,,A,Mid-Imperial Period,9,100,300,200,1.8627498
3185,,A,Late Imperial Period,10,300,500,200,1.8627498
3186,Tenuta Torre Nova,A,Early Imperial Period,8,-30,100,130,0.7321884
3186,Tenuta Torre Nova,A,Mid-Imperial Period,9,100,300,200,0.7321884
3186,Tenuta Torre Nova,A,Late Imperial Period,10,300,500,200,0.7321884
3187,Torre Nova,A,Republican Period,7,-200,-30,170,2.9143465
3187,Torre Nova,A,Early Imperial Period,8,-30,100,130,1.2593331
3187,Torre Nova,A,Mid-Imperial Period,9,100,300,200,1.2593331
3187,Torre Nova,A,Late Imperial Period,10,300,500,200,1.2593331
3188,Giardinetti,A,Republican Period,7,-200,-30,170,1.9919225
3188,Giardinetti,A,Early Imperial Period,8,-30,100,130,3.8140843
3188,Giardinetti,A,Mid-Imperial Period,9,100,300,200,3.8140843
3188,Giardinetti,A,Late Imperial Period,10,300,500,200,3.8140843
3189,Giardinetti,A,Republican Period,7,-100,-30,70,0.81442177
3189,Giardinetti,A,Early Imperial Period,8,-30,100,130,7.2650175
3189,Giardinetti,A,Mid-Imperial Period,9,100,300,200,7.2650175
3189,Giardinetti,A,Late Imperial Period,10,300,500,200,7.2650175
3190,,A,Early Imperial Period,8,-30,100,130,1.136481
3190,,A,Mid-Imperial Period,9,100,300,200,1.136481
3190,,A,Late Imperial Period,10,300,500,200,1.136481
3191,,A,Early Imperial Period,8,-30,100,130,0.44285923
3191,,A,Mid-Imperial Period,9,100,300,200,0.44285923
3191,,A,Late Imperial Period,10,300,500,200,0.44285923
3192,,A,Early Imperial Period,8,-30,100,130,0.7230835
3192,,A,Mid-Imperial Period,9,100,300,200,0.7230835
3192,,A,Late Imperial Period,10,300,500,200,0.7230835
3193,,A,Early Imperial Period,8,-30,100,130,1.157473
3193,,A,Mid-Imperial Period,9,100,300,200,1.157473
3193,,A,Late Imperial Period,10,300,500,200,1.157473
3194,Orti Poli,A,Early Imperial Period,8,-30,100,130,2.0488408
3194,Orti Poli,A,Mid-Imperial Period,9,100,300,200,2.0488408
3194,Orti Poli,A,Late Imperial Period,10,300,500,200,2.0488408
3195,,A,Early Imperial Period,8,-30,100,130,0.24857943
3195,,A,Mid-Imperial Period,9,100,300,200,0.24857943
3195,,A,Late Imperial Period,10,300,500,200,0.24857943
3196,,A,Late Iron Age,5,-600,-580,20,0.34700403
3196,,A,Archaic Period,6,-580,-500,80,0.34700403
3196,,B,Republican Period,7,-100,-30,70,0.34700403
3196,,B,Early Imperial Period,8,-30,100,130,0.34700403
3197,,A,Early Imperial Period,8,-30,100,130,0.37152177
3197,,A,Mid-Imperial Period,9,100,300,200,0.37152177
3197,,A,Late Imperial Period,10,300,500,200,0.37152177
3198,,A,Early Imperial Period,8,-30,100,130,0.49119321
3198,,A,Mid-Imperial Period,9,100,300,200,0.49119321
3198,,A,Late Imperial Period,10,300,500,200,0.49119321
3199,Casale Carcaricola,A,Early Imperial Period,8,-30,100,130,0.86469144
3199,Casale Carcaricola,A,Mid-Imperial Period,9,100,300,200,0.86469144
3199,Casale Carcaricola,A,Late Imperial Period,10,300,500,200,0.86469144
3200,Casale Carcaricola,A,Early Imperial Period,8,-30,100,130,0.28588584
3200,Casale Carcaricola,A,Mid-Imperial Period,9,100,300,200,0.28588584
3200,Casale Carcaricola,A,Late Imperial Period,10,300,500,200,0.28588584
3201,,A,Early Imperial Period,8,-30,100,130,1.1510385
3201,,A,Mid-Imperial Period,9,100,300,200,1.1510385
3201,,A,Late Imperial Period,10,300,500,200,1.1510385
3202,,A,Early Imperial Period,8,-30,100,130,0.93608737
3202,,A,Mid-Imperial Period,9,100,300,200,0.93608737
3202,,A,Late Imperial Period,10,300,500,200,0.93608737
3203,,A,Republican Period,7,-200,-30,170,0.40076745
3204,Muraccio dell'Archetto,A,Early Imperial Period,8,-30,100,130,2.2477188
3204,Muraccio dell'Archetto,A,Mid-Imperial Period,9,100,300,200,2.2477188
3204,Muraccio dell'Archetto,A,Late Imperial Period,10,300,500,200,2.2477188
3205,,A,Early Imperial Period,8,-30,100,130,0.40689015
3205,,A,Mid-Imperial Period,9,100,300,200,0.40689015
3205,,A,Late Imperial Period,10,300,500,200,0.40689015
3206,vaccheria Bardella,A,Early Imperial Period,8,1,100,99,0.55628312
3207,vaccheria Bardella,A,Late Iron Age,5,-600,-580,20,0.8441394
3207,vaccheria Bardella,A,Archaic Period,6,-580,-400,180,0.8441394
3208,,A,Archaic Period,6,-400,-350,50,1.6339525
3208,,A,Republican Period,7,-350,-30,320,1.6339525
3208,,A,Early Imperial Period,8,-30,100,130,0.57707441
3208,,A,Mid-Imperial Period,9,100,300,200,0.57707441
3208,,A,Late Imperial Period,10,300,500,200,0.57707441
3209,S. Maura,A,Archaic Period,6,-400,-350,50,1.1562902
3209,S. Maura,A,Republican Period,7,-350,-30,320,1.1562902
3209,S. Maura,A,Early Imperial Period,8,-30,100,130,5.9567194
3209,S. Maura,A,Mid-Imperial Period,9,100,300,200,5.9567194
3209,S. Maura,A,Late Imperial Period,10,300,500,200,5.9567194
3210,,A,Early Imperial Period,8,-30,100,130,0.6431185
3210,,A,Mid-Imperial Period,9,100,300,200,0.6431185
3210,,A,Late Imperial Period,10,300,500,200,0.6431185
3211,,A,Early Imperial Period,8,-30,100,130,1.8310909
3211,,A,Mid-Imperial Period,9,100,300,200,1.8310909
3211,,A,Late Imperial Period,10,300,500,200,1.8310909
3212,S. Maura,A,Republican Period,7,-200,-30,170,0.28091902
3213,S. Maura,A,Late Iron Age,5,-600,-580,20,0.30414695
3213,S. Maura,A,Archaic Period,6,-580,-500,80,0.30414695
3214,S. Maura,A,Late Iron Age,5,-600,-580,20,0.76171106
3214,S. Maura,B,Archaic Period,6,-580,-350,230,7.1491375
3214,S. Maura,B,Republican Period,7,-350,-30,320,7.1491375
3214,S. Maura,B,Early Imperial Period,8,-30,100,130,3.6193054
3214,S. Maura,B,Mid-Imperial Period,9,100,300,200,3.6193054
3214,S. Maura,B,Late Imperial Period,10,300,500,200,3.6193054
3215,casale De Luca,A,Early Imperial Period,8,-30,100,130,1.8735112
3215,casale De Luca,A,Mid-Imperial Period,9,100,300,200,1.8735112
3215,casale De Luca,A,Late Imperial Period,10,300,500,200,1.8735112
3216,Torre Spaccata,A,Early Imperial Period,8,-30,100,130,0.66083449
3216,Torre Spaccata,A,Mid-Imperial Period,9,100,300,200,0.66083449
3216,Torre Spaccata,A,Late Imperial Period,10,300,500,200,0.66083449
3217,Torre Spaccata,A,Early Imperial Period,8,-30,100,130,0.46514416
3217,Torre Spaccata,A,Mid-Imperial Period,9,100,300,200,0.46514416
3217,Torre Spaccata,A,Late Imperial Period,10,300,500,200,0.46514416
3218,Torre Spaccata,A,Early Imperial Period,8,-30,100,130,1.3362609
3218,Torre Spaccata,A,Mid-Imperial Period,9,100,300,200,1.3362609
3218,Torre Spaccata,A,Late Imperial Period,10,300,500,200,1.3362609
3219,Torre Spaccata,A,Early Imperial Period,8,-30,100,130,0.77249223
3219,Torre Spaccata,A,Mid-Imperial Period,9,100,300,200,0.77249223
3219,Torre Spaccata,A,Late Imperial Period,10,300,500,200,0.77249223
3220,,A,Early Imperial Period,8,-30,100,130,1.1138928
3220,,A,Mid-Imperial Period,9,100,300,200,1.1138928
3220,,A,Late Imperial Period,10,300,500,200,1.1138928
3221,,A,Early Imperial Period,8,-30,100,130,0.33499381
3221,,A,Mid-Imperial Period,9,100,300,200,0.33499381
3221,,A,Late Imperial Period,10,300,500,200,0.33499381
3222,villa dei Settebassi,A,Republican Period,7,-200,-30,170,3.34254
3223,villa dei Settebassi,A,Mid-Imperial Period,9,150,300,150,8.0364656
3223,villa dei Settebassi,A,Late Imperial Period,10,300,400,100,8.0364656
3224,,A,Early Imperial Period,8,-30,100,130,0.51910514
3224,,A,Mid-Imperial Period,9,100,300,200,0.51910514
3224,,A,Late Imperial Period,10,300,500,200,0.51910514
3225,,A,Early Imperial Period,8,-30,100,130,0.22453785
3225,,A,Mid-Imperial Period,9,100,300,200,0.22453785
3225,,A,Late Imperial Period,10,300,500,200,0.22453785
3226,,A,Early Imperial Period,8,-30,100,130,1.1307007
3226,,A,Mid-Imperial Period,9,100,300,200,1.1307007
3226,,A,Late Imperial Period,10,300,500,200,1.1307007
3227,,A,Early Imperial Period,8,-30,100,130,0.37144947
3227,,A,Mid-Imperial Period,9,100,300,200,0.37144947
3227,,A,Late Imperial Period,10,300,500,200,0.37144947
3228,,A,Early Imperial Period,8,-30,100,130,0.58555996
3228,,A,Mid-Imperial Period,9,100,300,200,0.58555996
3228,,A,Late Imperial Period,10,300,500,200,0.58555996
3229,,A,Republican Period,7,-200,-30,170,5.3561091
3229,,A,Early Imperial Period,8,-30,100,130,5.3561091
3229,,A,Mid-Imperial Period,9,100,300,200,5.3561091
3229,,A,Late Imperial Period,10,300,500,200,5.3561091
3230,,A,Early Imperial Period,8,-30,100,130,1.0634483
3230,,A,Mid-Imperial Period,9,100,300,200,1.0634483
3230,,A,Late Imperial Period,10,300,500,200,1.0634483
3231,,A,Early Imperial Period,8,-30,100,130,0.55976951
3231,,A,Mid-Imperial Period,9,100,300,200,0.55976951
3231,,A,Late Imperial Period,10,300,500,200,0.55976951
3232,,A,Early Imperial Period,8,-30,100,130,0.64372277
3232,,A,Mid-Imperial Period,9,100,300,200,0.64372277
3232,,A,Late Imperial Period,10,300,500,200,0.64372277
3234,fosso di Torre Spaccata,A,Archaic Period,6,-400,-350,50,0.34300596
3234,fosso di Torre Spaccata,A,Republican Period,7,-350,-200,150,0.34300596
3234,fosso di Torre Spaccata,B,Early Imperial Period,8,-30,100,130,0.34300596
3234,fosso di Torre Spaccata,B,Mid-Imperial Period,9,100,300,200,0.34300596
3234,fosso di Torre Spaccata,B,Late Imperial Period,10,300,500,200,0.34300596
3235,,A,Archaic Period,6,-400,-350,50,0.5369994
3235,,A,Republican Period,7,-350,-30,320,0.5369994
3235,,A,Early Imperial Period,8,-30,100,130,0.5369994
3235,,A,Mid-Imperial Period,9,100,300,200,0.5369994
3235,,A,Late Imperial Period,10,300,500,200,0.5369994
3236,,A,Early Imperial Period,8,-30,100,130,0.74782962
3236,,A,Mid-Imperial Period,9,100,300,200,0.74782962
3236,,A,Late Imperial Period,10,300,500,200,0.74782962
3237,,A,Early Imperial Period,8,-30,100,130,0.69598424
3237,,A,Mid-Imperial Period,9,100,300,200,0.69598424
3237,,A,Late Imperial Period,10,300,500,200,0.69598424
3238,,A,Early Imperial Period,8,-30,100,130,0.68503422
3238,,A,Mid-Imperial Period,9,100,300,200,0.68503422
3238,,A,Late Imperial Period,10,300,500,200,0.68503422
3239,,A,Republican Period,7,-300,-30,270,0.48164105
3240,,A,Archaic Period,6,-400,-350,50,1.2742018
3240,,A,Republican Period,7,-350,-30,320,1.2742018
3240,,A,Early Imperial Period,8,-30,100,130,1.2742018
3240,,A,Mid-Imperial Period,9,100,300,200,1.2742018
3240,,A,Late Imperial Period,10,300,500,200,1.2742018
3241,,A,Early Imperial Period,8,-30,100,130,1.1066275
3241,,A,Mid-Imperial Period,9,100,300,200,1.1066275
3241,,A,Late Imperial Period,10,300,500,200,1.1066275
3242,,A,Archaic Period,6,-400,-350,50,0.37066731
3242,,A,Republican Period,7,-350,-30,320,0.37066731
3243,,A,Early Imperial Period,8,-30,100,130,0.58466041
3243,,A,Mid-Imperial Period,9,100,300,200,0.58466041
3243,,A,Late Imperial Period,10,300,500,200,0.58466041
3244,Torre di S. S. Quattro,A,Archaic Period,6,-400,-350,50,1.7139821
3244,Torre di S. S. Quattro,A,Republican Period,7,-350,-30,320,1.7139821
3244,Torre di S. S. Quattro,A,Early Imperial Period,8,-30,100,130,0.30140412
3244,Torre di S. S. Quattro,A,Mid-Imperial Period,9,100,300,200,0.30140412
3244,Torre di S. S. Quattro,A,Late Imperial Period,10,300,500,200,0.30140412
3245,,A,Early Imperial Period,8,-30,100,130,0.76716393
3245,,A,Mid-Imperial Period,9,100,300,200,0.76716393
3245,,A,Late Imperial Period,10,300,500,200,0.76716393
3246,,A,Early Imperial Period,8,-30,100,130,0.5977329
3246,,A,Mid-Imperial Period,9,100,300,200,0.5977329
3246,,A,Late Imperial Period,10,300,500,200,0.5977329
3247,,A,Early Imperial Period,8,-30,100,130,1.3370718
3247,,A,Mid-Imperial Period,9,100,300,200,1.3370718
3247,,A,Late Imperial Period,10,300,500,200,1.3370718
3248,,A,Early Imperial Period,8,-30,100,130,1.0055923
3248,,A,Mid-Imperial Period,9,100,300,200,1.0055923
3248,,A,Late Imperial Period,10,300,500,200,1.0055923
3249,,A,Early Imperial Period,8,-30,100,130,0.40181899
3249,,A,Mid-Imperial Period,9,100,300,200,0.40181899
3249,,A,Late Imperial Period,10,300,500,200,0.40181899
3250,,A,Early Imperial Period,8,-30,100,130,0.29144037
3250,,A,Mid-Imperial Period,9,100,300,200,0.29144037
3250,,A,Late Imperial Period,10,300,500,200,0.29144037
3251,,A,Early Imperial Period,8,-30,100,130,0.37192124
3251,,A,Mid-Imperial Period,9,100,300,200,0.37192124
3251,,A,Late Imperial Period,10,300,500,200,0.37192124
3252,,A,Archaic Period,6,-400,-350,50,1.1084542
3252,,A,Republican Period,7,-350,-30,320,1.1084542
3252,,A,Early Imperial Period,8,-30,100,130,1.1084542
3252,,A,Mid-Imperial Period,9,100,300,200,1.1084542
3252,,A,Late Imperial Period,10,300,500,200,1.1084542
3253,casale Carcaricola,A,Early Imperial Period,8,-30,100,130,0.74542892
3253,casale Carcaricola,A,Mid-Imperial Period,9,100,300,200,0.74542892
3253,casale Carcaricola,A,Late Imperial Period,10,300,500,200,0.74542892
3254,,A,Early Imperial Period,8,-30,100,130,0.45366564
3254,,A,Mid-Imperial Period,9,100,300,200,0.45366564
3254,,A,Late Imperial Period,10,300,500,200,0.45366564
3255,,A,Early Imperial Period,8,-30,100,130,0.84986258
3255,,A,Mid-Imperial Period,9,100,300,200,0.84986258
3255,,A,Late Imperial Period,10,300,500,200,0.84986258
3256,casale di Unita' Anagnina,A,Early Imperial Period,8,-30,100,130,2.7133188
3256,casale di Unita' Anagnina,A,Mid-Imperial Period,9,100,300,200,2.7133188
3256,casale di Unita' Anagnina,A,Late Imperial Period,10,300,500,200,2.7133188
3257,,A,Archaic Period,6,-400,-350,50,2.5155308
3257,,A,Republican Period,7,-350,-30,320,2.5155308
3258,,A,Early Imperial Period,8,-30,100,130,0.9312973
3258,,A,Mid-Imperial Period,9,100,300,200,0.9312973
3258,,A,Late Imperial Period,10,300,500,200,0.9312973
3259,casale La Barcaccia,A,Early Imperial Period,8,-30,100,130,1.4575474
3259,casale La Barcaccia,A,Mid-Imperial Period,9,100,300,200,1.4575474
3259,casale La Barcaccia,A,Late Imperial Period,10,300,500,200,1.4575474
3260,La Botte di Luciano,A,Early Imperial Period,8,-30,100,130,1.075655
3260,La Botte di Luciano,A,Mid-Imperial Period,9,100,300,200,1.075655
3260,La Botte di Luciano,A,Late Imperial Period,10,300,500,200,1.075655
3261,La Botte di Luciano,A,Early Imperial Period,8,-30,100,130,0.58470464
3261,La Botte di Luciano,A,Mid-Imperial Period,9,100,300,200,0.58470464
3261,La Botte di Luciano,A,Late Imperial Period,10,300,500,200,0.58470464
3262,,A,Early Imperial Period,8,-30,100,130,0.81565773
3262,,A,Mid-Imperial Period,9,100,300,200,0.81565773
3262,,A,Late Imperial Period,10,300,500,200,0.81565773
3263,Passo Lombardo,A,Republican Period,7,-100,-30,70,1.5575124
3263,Passo Lombardo,A,Early Imperial Period,8,-30,100,130,1.5575124
3263,Passo Lombardo,A,Mid-Imperial Period,9,100,300,200,1.5575124
3263,Passo Lombardo,A,Late Imperial Period,10,300,500,200,1.5575124
3264,Passo Lombardo,A,Early Imperial Period,8,-30,100,130,0.23610938
3264,Passo Lombardo,A,Mid-Imperial Period,9,100,300,200,0.23610938
3264,Passo Lombardo,A,Late Imperial Period,10,300,500,200,0.23610938
3265,Passo Lombardo,A,Early Imperial Period,8,-30,100,130,1.4585491
3265,Passo Lombardo,A,Mid-Imperial Period,9,100,300,200,1.4585491
3265,Passo Lombardo,A,Late Imperial Period,10,300,500,200,1.4585491
3266,Passo Lombardo,A,Archaic Period,6,-400,-350,50,0.31244925
3266,Passo Lombardo,A,Republican Period,7,-350,-30,320,0.31244925
3266,Passo Lombardo,A,Early Imperial Period,8,-30,100,130,0.31244925
3266,Passo Lombardo,A,Mid-Imperial Period,9,100,300,200,0.31244925
3266,Passo Lombardo,A,Late Imperial Period,10,300,500,200,0.31244925
3267,Passo Lombardo,A,Early Imperial Period,8,-30,100,130,0.3767364
3267,Passo Lombardo,A,Mid-Imperial Period,9,100,300,200,0.3767364
3267,Passo Lombardo,A,Late Imperial Period,10,300,500,200,0.3767364
3268,Passo Lombardo,A,Early Imperial Period,8,-30,100,130,1.4888214
3268,Passo Lombardo,A,Mid-Imperial Period,9,100,300,200,1.4888214
3268,Passo Lombardo,A,Late Imperial Period,10,300,500,200,1.4888214
3269,,A,Archaic Period,6,-400,-350,50,1.3184445
3269,,A,Republican Period,7,-350,-30,320,1.3184445
3269,,A,Early Imperial Period,8,-30,100,130,1.3184445
3269,,A,Mid-Imperial Period,9,100,300,200,1.3184445
3269,,A,Late Imperial Period,10,300,500,200,1.3184445
3270,Tenuta di Passo Lombardo,A,Early Imperial Period,8,-30,100,130,0.29647574
3270,Tenuta di Passo Lombardo,A,Mid-Imperial Period,9,100,300,200,0.29647574
3270,Tenuta di Passo Lombardo,A,Late Imperial Period,10,300,500,200,0.29647574
3271,Tenuta di Passo Lombardo,A,Early Imperial Period,8,-30,100,130,1.2671076
3271,Tenuta di Passo Lombardo,A,Mid-Imperial Period,9,100,300,200,1.2671076
3271,Tenuta di Passo Lombardo,A,Late Imperial Period,10,300,500,200,1.2671076
3272,Tenuta di Passo Lombardo,A,Republican Period,7,-300,-30,270,0.33853361
3273,,A,Republican Period,7,-300,-30,270,0.68761593
3273,,A,Early Imperial Period,8,-30,100,130,0.68761593
3273,,A,Mid-Imperial Period,9,100,300,200,0.68761593
3273,,A,Late Imperial Period,10,300,500,200,0.68761593
3274,,A,Early Imperial Period,8,-30,100,130,0.44399837
3274,,A,Mid-Imperial Period,9,100,300,200,0.44399837
3274,,A,Late Imperial Period,10,300,500,200,0.44399837
3275,,A,Archaic Period,6,-400,-350,50,0.79673433
3275,,A,Republican Period,7,-350,-30,320,0.79673433
3275,,A,Early Imperial Period,8,-30,100,130,0.79673433
3275,,A,Mid-Imperial Period,9,100,300,200,0.79673433
3275,,A,Late Imperial Period,10,300,500,200,0.79673433
3276,,A,Archaic Period,6,-400,-350,50,0.66832989
3276,,A,Republican Period,7,-350,-30,320,0.66832989
3276,,A,Early Imperial Period,8,-30,100,130,0.66832989
3276,,A,Mid-Imperial Period,9,100,300,200,0.66832989
3276,,A,Late Imperial Period,10,300,500,200,0.66832989
3277,,A,Archaic Period,6,-400,-350,50,0.56022394
3277,,A,Republican Period,7,-350,-30,320,0.56022394
3277,,A,Early Imperial Period,8,-30,100,130,0.56022394
3277,,A,Mid-Imperial Period,9,100,300,200,0.56022394
3277,,A,Late Imperial Period,10,300,500,200,0.56022394
3278,,A,Early Imperial Period,8,-30,100,130,1.0871164
3278,,A,Mid-Imperial Period,9,100,300,200,1.0871164
3278,,A,Late Imperial Period,10,300,500,200,1.0871164
3279,,A,Early Imperial Period,8,-30,100,130,3.5046182
3279,,A,Mid-Imperial Period,9,100,300,200,3.5046182
3279,,A,Late Imperial Period,10,300,500,200,3.5046182
3280,,A,Early Imperial Period,8,-30,100,130,0.84583169
3280,,A,Mid-Imperial Period,9,100,300,200,0.84583169
3280,,A,Late Imperial Period,10,300,500,200,0.84583169
3281,,A,Early Imperial Period,8,-30,100,130,1.1822541
3281,,A,Mid-Imperial Period,9,100,300,200,1.1822541
3281,,A,Late Imperial Period,10,300,500,200,1.1822541
3282,,A,Early Imperial Period,8,-30,100,130,0.64009327
3282,,A,Mid-Imperial Period,9,100,300,200,0.64009327
3282,,A,Late Imperial Period,10,300,500,200,0.64009327
3283,,A,Early Imperial Period,8,-30,100,130,0.32348683
3283,,A,Mid-Imperial Period,9,100,300,200,0.32348683
3283,,A,Late Imperial Period,10,300,500,200,0.32348683
3284,,A,Early Imperial Period,8,-30,100,130,0.9406696
3284,,A,Mid-Imperial Period,9,100,300,200,0.9406696
3284,,A,Late Imperial Period,10,300,500,200,0.9406696
3285,casale Cesaroni,A,Archaic Period,6,-400,-350,50,4.2001944
3285,casale Cesaroni,A,Republican Period,7,-350,-30,320,4.2001944
3285,casale Cesaroni,A,Early Imperial Period,8,-30,100,130,0.94471955
3285,casale Cesaroni,A,Mid-Imperial Period,9,100,300,200,0.94471955
3285,casale Cesaroni,A,Late Imperial Period,10,300,500,200,0.94471955
3286,Sterparoni,A,Early Imperial Period,8,-30,100,130,1.3942848
3286,Sterparoni,A,Mid-Imperial Period,9,100,200,100,1.3942848
3287,Sterparoni,A,Early Imperial Period,8,-30,100,130,0.724805
3287,Sterparoni,A,Mid-Imperial Period,9,100,300,200,0.724805
3287,Sterparoni,A,Late Imperial Period,10,300,500,200,0.724805
3288,Grotte Dama,A,Early Imperial Period,8,-30,100,130,2.6538444
3288,Grotte Dama,A,Mid-Imperial Period,9,100,300,200,2.6538444
3288,Grotte Dama,A,Late Imperial Period,10,300,500,200,2.6538444
3289,Grotte Dama,A,Early Imperial Period,8,-30,100,130,0.71619076
3289,Grotte Dama,A,Mid-Imperial Period,9,100,300,200,0.71619076
3289,Grotte Dama,A,Late Imperial Period,10,300,500,200,0.71619076
3290,casale Esposito,A,Republican Period,7,-100,-30,70,0.82142967
3290,casale Esposito,A,Early Imperial Period,8,-30,100,130,0.82142967
3290,casale Esposito,A,Mid-Imperial Period,9,100,300,200,0.82142967
3290,casale Esposito,A,Late Imperial Period,10,300,500,200,0.82142967
3291,casale del Marchese,A,Early Imperial Period,8,-30,100,130,1.1918116
3291,casale del Marchese,A,Mid-Imperial Period,9,100,300,200,1.1918116
3291,casale del Marchese,A,Late Imperial Period,10,300,500,200,1.1918116
3292,Pantano Secco,A,Archaic Period,6,-400,-350,50,2.6267083
3292,Pantano Secco,A,Republican Period,7,-350,-30,320,2.6267083
3293,Pantano Secco,A,Early Imperial Period,8,-30,100,130,4.1746197
3293,Pantano Secco,A,Mid-Imperial Period,9,100,300,200,4.1746197
3293,Pantano Secco,A,Late Imperial Period,10,300,500,200,4.1746197
3294,Pantano Secco,A,Late Iron Age,5,-600,-580,20,0.1392743
3294,Pantano Secco,A,Archaic Period,6,-580,-500,80,0.1392743
3294,Pantano Secco,B,Early Imperial Period,8,-30,100,130,1.9546064
3294,Pantano Secco,B,Mid-Imperial Period,9,100,300,200,1.9546064
3294,Pantano Secco,B,Late Imperial Period,10,300,500,200,1.9546064
3295,,A,Republican Period,7,-100,-30,70,0.39934942
3295,,A,Early Imperial Period,8,-30,100,130,0.39934942
3295,,A,Mid-Imperial Period,9,100,300,200,0.39934942
3295,,A,Late Imperial Period,10,300,500,200,0.39934942
3296,vigna Benedetti,A,Late Iron Age,5,-600,-580,20,0.4700276
3296,vigna Benedetti,A,Archaic Period,6,-580,-500,80,0.4700276
3296,,B,Early Imperial Period,8,-30,100,130,1.4540337
3296,,B,Mid-Imperial Period,9,100,300,200,1.4540337
3296,,B,Late Imperial Period,10,300,500,200,1.4540337
3297,vigna Benedetti,A,Early Imperial Period,8,-30,100,130,0.61782867
3297,vigna Benedetti,A,Mid-Imperial Period,9,100,300,200,0.61782867
3297,vigna Benedetti,A,Late Imperial Period,10,300,500,200,0.61782867
3298,S. S.Apostoli,A,Archaic Period,6,-400,-350,50,0.71774739
3298,S. S.Apostoli,A,Republican Period,7,-350,-30,320,0.71774739
3299,S. S.Apostoli,A,Early Imperial Period,8,-30,100,130,0.46761161
3299,S. S.Apostoli,A,Mid-Imperial Period,9,100,300,200,0.46761161
3299,S. S.Apostoli,A,Late Imperial Period,10,300,500,200,0.46761161
3300,S. S.Apostoli,A,Early Imperial Period,8,-30,100,130,1.0648694
3300,S. S.Apostoli,A,Mid-Imperial Period,9,100,300,200,1.0648694
3300,S. S.Apostoli,A,Late Imperial Period,10,300,500,200,1.0648694
3301,S. S.Apostoli,A,Early Imperial Period,8,-30,100,130,0.89059722
3301,S. S.Apostoli,A,Mid-Imperial Period,9,100,300,200,0.89059722
3301,S. S.Apostoli,A,Late Imperial Period,10,300,500,200,0.89059722
3302,S. S.Apostoli,A,Early Imperial Period,8,-30,100,130,0.76203859
3302,S. S.Apostoli,A,Mid-Imperial Period,9,100,300,200,0.76203859
3302,S. S.Apostoli,A,Late Imperial Period,10,300,500,200,0.76203859
3303,,A,Archaic Period,6,-400,-350,50,0.653925
3303,,A,Republican Period,7,-350,-30,320,0.653925
3303,,A,Early Imperial Period,8,-30,100,130,0.653925
3303,,A,Mid-Imperial Period,9,100,300,200,0.653925
3303,,A,Late Imperial Period,10,300,500,200,0.653925
3304,,A,Early Imperial Period,8,-30,100,130,0.43767688
3304,,A,Mid-Imperial Period,9,100,300,200,0.43767688
3304,,A,Late Imperial Period,10,300,500,200,0.43767688
3305,Colle Reti,A,Early Imperial Period,8,-30,100,130,3.6390924
3305,Colle Reti,A,Mid-Imperial Period,9,100,300,200,3.6390924
3305,Colle Reti,A,Late Imperial Period,10,300,500,200,3.6390924
3306,,A,Early Imperial Period,8,-30,100,130,0.43644589
3306,,A,Mid-Imperial Period,9,100,300,200,0.43644589
3306,,A,Late Imperial Period,10,300,500,200,0.43644589
3307,cratere Prataporci,A,Early Imperial Period,8,-30,100,130,2.5722346
3307,cratere Prataporci,A,Mid-Imperial Period,9,100,300,200,2.5722346
3307,cratere Prataporci,A,Late Imperial Period,10,300,500,200,2.5722346
3308,,A,Early Imperial Period,8,-30,100,130,1.4587281
3308,,A,Mid-Imperial Period,9,100,300,200,1.4587281
3308,,A,Late Imperial Period,10,300,500,200,1.4587281
3309,S. Teresa,A,Republican Period,7,-200,-30,170,0.82777029
3309,S. Teresa,A,Early Imperial Period,8,-30,100,130,0.69565159
3309,S. Teresa,A,Mid-Imperial Period,9,100,300,200,0.69565159
3309,S. Teresa,A,Late Imperial Period,10,300,500,200,0.69565159
3310,,A,Archaic Period,6,-400,-350,50,0.46559751
3310,,A,Republican Period,7,-350,-200,150,0.46559751
3310,,B,Early Imperial Period,8,-30,100,130,0.46559751
3310,,B,Mid-Imperial Period,9,100,300,200,0.46559751
3310,,B,Late Imperial Period,10,300,500,200,0.46559751
3311,,A,Early Imperial Period,8,-30,100,130,1.4133285
3311,,A,Mid-Imperial Period,9,100,300,200,1.4133285
3311,,A,Late Imperial Period,10,300,500,200,1.4133285
3312,,A,Late Iron Age,5,-600,-580,20,1.1728063
3312,,A,Archaic Period,6,-580,-500,80,1.1728063
3312,,B,Early Imperial Period,8,-30,100,130,1.1728063
3312,,B,Mid-Imperial Period,9,100,300,200,1.1728063
3312,,B,Late Imperial Period,10,300,500,200,1.1728063
3313,,A,Archaic Period,6,-500,-400,100,0.85402036
3313,,B,Early Imperial Period,8,-30,100,130,1.4392006
3313,,B,Mid-Imperial Period,9,100,300,200,1.4392006
3313,,B,Late Imperial Period,10,300,500,200,1.4392006
3314,,A,Early Imperial Period,8,-30,100,130,0.85965502
3314,,A,Mid-Imperial Period,9,100,300,200,0.85965502
3314,,A,Late Imperial Period,10,300,500,200,0.85965502
3315,,A,Early Imperial Period,8,-30,100,130,0.21537551
3315,,A,Mid-Imperial Period,9,100,300,200,0.21537551
3315,,A,Late Imperial Period,10,300,500,200,0.21537551
3316,Colle S. Isidoro,A,Early Imperial Period,8,-30,100,130,2.0539753
3316,Colle S. Isidoro,A,Mid-Imperial Period,9,100,300,200,2.0539753
3316,Colle S. Isidoro,A,Late Imperial Period,10,300,500,200,2.0539753
3317,Colle Pisano,A,Early Imperial Period,8,-30,100,130,1.2583946
3317,Colle Pisano,A,Mid-Imperial Period,9,100,300,200,1.2583946
3317,Colle Pisano,A,Late Imperial Period,10,300,500,200,1.2583946
3318,,A,Early Imperial Period,8,-30,100,130,0.7499215
3318,,A,Mid-Imperial Period,9,100,300,200,0.7499215
3318,,A,Late Imperial Period,10,300,500,200,0.7499215
3319,,A,Late Iron Age,5,-600,-580,20,0.7280758
3319,,A,Archaic Period,6,-580,-350,230,0.7280758
3319,,A,Republican Period,7,-350,-30,320,0.7280758
3319,,A,Early Imperial Period,8,-30,100,130,1.2289498
3319,,A,Mid-Imperial Period,9,100,300,200,1.2289498
3319,,A,Late Imperial Period,10,300,500,200,1.2289498
3320,,A,Archaic Period,6,-400,-350,50,0.80044079
3320,,A,Republican Period,7,-350,-200,150,0.80044079
3320,,B,Early Imperial Period,8,-30,100,130,0.80044079
3320,,B,Mid-Imperial Period,9,100,300,200,0.80044079
3320,,B,Late Imperial Period,10,300,500,200,0.80044079
3321,Castell'Arcione,A,Early Imperial Period,8,1,100,99,0.37049374
3321,Castell'Arcione,A,Mid-Imperial Period,9,100,300,200,0.37049374
3322,Castell'Arcione,A,Republican Period,7,-200,-30,170,0.92480361
3322,Castell'Arcione,A,Early Imperial Period,8,-30,100,130,0.92480361
3322,Castell'Arcione,A,Mid-Imperial Period,9,100,300,200,0.92480361
3323,,A,Late Iron Age,5,-600,-580,20,0.29960385
3323,,A,Archaic Period,6,-580,-350,230,0.29960385
3323,,A,Republican Period,7,-350,-30,320,0.29960385
3324,,A,Late Iron Age,5,-600,-580,20,0.51088089
3324,,A,Archaic Period,6,-580,-350,230,0.51088089
3324,,A,Republican Period,7,-350,-30,320,0.51088089
3325,,A,Early Iron Age,4,-800,-750,50,0.42299485
3325,,B,Late Iron Age,5,-750,-580,170,0.42299485
3325,,B,Archaic Period,6,-580,-500,80,0.42299485
3326,,A,Republican Period,7,-200,-30,170,0.48425126
3326,,A,Early Imperial Period,8,-30,100,130,0.48425126
3326,,A,Mid-Imperial Period,9,100,300,200,0.48425126
3327,fosso delle Tavernucole,A,Late Bronze Age,3,-1200,-1020,180,0.31287766
3327,fosso delle Tavernucole,B,Early Iron Age,4,-1020,-750,270,0.31287766
3327,fosso delle Tavernucole,B,Late Iron Age,5,-750,-580,170,0.31287766
3327,fosso delle Tavernucole,B,Archaic Period,6,-580,-500,80,0.31287766
3328,,A,Republican Period,7,-100,-30,70,0.74226832
3328,,A,Early Imperial Period,8,-30,100,130,0.74226832
3328,,A,Mid-Imperial Period,9,100,200,100,0.74226832
3329,,A,Early Imperial Period,8,1,100,99,0.70327097
3329,,A,Mid-Imperial Period,9,100,300,200,0.70327097
3330,Torraccia dell'Inviolata,A,Republican Period,7,-200,-30,170,0.63980389
3330,Torraccia dell'Inviolata,A,Early Imperial Period,8,-30,100,130,0.63980389
3330,Torraccia dell'Inviolata,A,Mid-Imperial Period,9,100,300,200,0.63980389
3330,Torraccia dell'Inviolata,A,Late Imperial Period,10,300,500,200,0.63980389
3331,Torraccia dell'Inviolata,A,Early Imperial Period,8,1,100,99,0.65099657
3331,Torraccia dell'Inviolata,A,Mid-Imperial Period,9,100,300,200,0.65099657
3332,,A,Middle Bronze Age,2,-1700,-1300,400,0.39824262
3332,,A,Late Bronze Age,3,-1300,-1020,280,0.39824262
3332,,A,Early Iron Age,4,-1020,-1000,20,0.39824262
3333,fosso dell'Inviolata,A,Republican Period,7,-100,-30,70,0.90636253
3333,fosso dell'Inviolata,A,Early Imperial Period,8,-30,100,130,0.90636253
3333,fosso dell'Inviolata,A,Mid-Imperial Period,9,100,300,200,0.90636253
3333,fosso dell'Inviolata,A,Late Imperial Period,10,300,500,200,0.90636253
3334,Quarto dell'Inviolatella,A,Early Imperial Period,8,-30,100,130,0.9047389
3334,Quarto dell'Inviolatella,A,Mid-Imperial Period,9,100,300,200,0.9047389
3334,Quarto dell'Inviolatella,A,Late Imperial Period,10,300,500,200,0.9047389
3335,Quarto dell'Inviolatella,A,Republican Period,7,-100,-30,70,0.72368133
3335,Quarto dell'Inviolatella,A,Early Imperial Period,8,-30,100,130,0.72368133
3335,Quarto dell'Inviolatella,A,Mid-Imperial Period,9,100,300,200,0.72368133
3335,Quarto dell'Inviolatella,A,Late Imperial Period,10,300,500,200,0.72368133
3336,fosso del Capaldo,A,Early Iron Age,4,-800,-750,50,0.28755629
3336,fosso del Capaldo,A,Late Iron Age,5,-750,-580,170,0.28755629
3336,fosso del Capaldo,A,Archaic Period,6,-580,-500,80,0.28755629
3337,Quarto dell'Inviolatella,A,Middle Bronze Age,2,-1700,-1300,400,0.73627239
3337,Quarto dell'Inviolatella,A,Late Bronze Age,3,-1300,-1020,280,0.73627239
3337,Quarto dell'Inviolatella,A,Early Iron Age,4,-1020,-1000,20,0.73627239
3337,Quarto dell'Inviolatella,B,Archaic Period,6,-500,-350,150,0.73627239
3337,Quarto dell'Inviolatella,B,Republican Period,7,-350,-30,320,0.73627239
3337,Quarto dell'Inviolatella,B,Early Imperial Period,8,-30,100,130,0.73627239
3337,Quarto dell'Inviolatella,B,Mid-Imperial Period,9,100,200,100,0.73627239
3338,Torre Tomao,A,Republican Period,7,-100,-30,70,0.55106217
3338,Torre Tomao,A,Early Imperial Period,8,-30,100,130,0.55106217
3338,Torre Tomao,A,Mid-Imperial Period,9,100,300,200,0.55106217
3339,,A,Early Imperial Period,8,1,100,99,0.38697264
3339,,A,Mid-Imperial Period,9,100,300,200,0.38697264
3339,,A,Late Imperial Period,10,300,500,200,0.38697264
3340,,A,Late Iron Age,5,-700,-580,120,0.33581808
3340,,A,Archaic Period,6,-580,-350,230,0.33581808
3340,,A,Republican Period,7,-350,-30,320,0.33581808
3341,,A,Republican Period,7,-200,-30,170,0.54879469
3341,,A,Early Imperial Period,8,-30,100,130,0.54879469
3341,,A,Mid-Imperial Period,9,100,300,200,0.54879469
3341,,A,Late Imperial Period,10,300,400,100,0.54879469
3342,Ovile di Castell'Arcione,A,Archaic Period,6,-500,-350,150,0.31112909
3342,Ovile di Castell'Arcione,A,Republican Period,7,-350,-30,320,0.31112909
3342,Ovile di Castell'Arcione,A,Early Imperial Period,8,-30,100,130,0.31112909
3342,Ovile di Castell'Arcione,A,Mid-Imperial Period,9,100,300,200,0.31112909
3342,Ovile di Castell'Arcione,A,Late Imperial Period,10,300,500,200,0.31112909
3343,Ovile di Castell'Arcione,A,Early Imperial Period,8,1,100,99,0.30700195
3343,Ovile di Castell'Arcione,A,Mid-Imperial Period,9,100,300,200,0.30700195
3343,Ovile di Castell'Arcione,A,Late Imperial Period,10,300,500,200,0.30700195
3344,Ovile di Castell'Arcione,A,Mid-Imperial Period,9,100,300,200,0.2936905
3345,Ovile di Castell'Arcione,A,Late Iron Age,5,-600,-580,20,0.18281533
3345,Ovile di Castell'Arcione,A,Archaic Period,6,-580,-500,80,0.18281533
3346,,A,Early Imperial Period,8,1,100,99,0.40121371
3346,,A,Mid-Imperial Period,9,100,300,200,0.40121371
3347,,A,Republican Period,7,-300,-30,270,0.62140465
3347,,A,Early Imperial Period,8,-30,100,130,0.62140465
3347,,A,Mid-Imperial Period,9,100,200,100,0.62140465
3348,,A,Early Imperial Period,8,1,100,99,0.56530124
3348,,A,Mid-Imperial Period,9,100,300,200,0.56530124
3349,,A,Early Imperial Period,8,1,100,99,0.41361627
3349,,A,Mid-Imperial Period,9,100,300,200,0.41361627
3350,,A,Early Imperial Period,8,1,100,99,0.42179123
3350,,A,Mid-Imperial Period,9,100,300,200,0.42179123
3351,,A,Late Iron Age,5,-600,-580,20,0.47378698
3351,,A,Archaic Period,6,-580,-500,80,0.47378698
3352,Tor dei Sordi,A,Early Imperial Period,8,1,100,99,0.35268521
3352,Tor dei Sordi,A,Mid-Imperial Period,9,100,300,200,0.35268521
3353,Tor dei Sordi,A,Archaic Period,6,-500,-350,150,0.50581497
3353,Tor dei Sordi,A,Republican Period,7,-350,-30,320,0.50581497
3353,Tor dei Sordi,A,Early Imperial Period,8,-30,100,130,0.50581497
3353,Tor dei Sordi,A,Mid-Imperial Period,9,100,300,200,0.50581497
3354,,A,Early Imperial Period,8,1,100,99,0.50972855
3354,,A,Mid-Imperial Period,9,100,300,200,0.50972855
3355,colle Lepre,A,Republican Period,7,-100,-30,70,0.58393782
3355,colle Lepre,A,Early Imperial Period,8,-30,100,130,0.58393782
3355,colle Lepre,A,Mid-Imperial Period,9,100,300,200,0.58393782
3355,colle Lepre,A,Late Imperial Period,10,300,400,100,0.58393782
3356,,A,Archaic Period,6,-400,-350,50,0.37661636
3356,,A,Republican Period,7,-350,-30,320,0.37661636
3356,,A,Early Imperial Period,8,-30,100,130,0.37661636
3356,,A,Mid-Imperial Period,9,100,300,200,0.37661636
3356,,A,Late Imperial Period,10,300,500,200,0.37661636
3357,Tor dei Sordi,A,Early Imperial Period,8,1,100,99,0.72507918
3357,Tor dei Sordi,A,Mid-Imperial Period,9,100,300,200,0.72507918
3358,,A,Early Imperial Period,8,1,100,99,0.54618549
3358,,A,Mid-Imperial Period,9,100,300,200,0.54618549
3359,,A,Early Imperial Period,8,1,100,99,0.55889571
3359,,A,Mid-Imperial Period,9,100,300,200,0.55889571
3360,,A,Early Iron Age,4,-1000,-750,250,0.5669359
3360,,A,Late Iron Age,5,-750,-580,170,0.5669359
3360,,A,Archaic Period,6,-580,-500,80,0.5669359
3361,,A,Early Iron Age,4,-800,-750,50,0.57228088
3361,,A,Late Iron Age,5,-750,-580,170,0.57228088
3361,,A,Archaic Period,6,-580,-350,230,0.57228088
3361,,A,Republican Period,7,-350,-30,320,0.57228088
3362,,A,Republican Period,7,-100,-30,70,0.54099768
3362,,A,Early Imperial Period,8,-30,100,130,0.54099768
3362,,A,Mid-Imperial Period,9,100,300,200,0.54099768
3363,,A,Middle Bronze Age,2,-1700,-1300,400,0.2322744
3364,Tor dei Sordi,A,Early Iron Age,4,-800,-750,50,0.59254748
3364,Tor dei Sordi,A,Late Iron Age,5,-750,-580,170,0.59254748
3364,Tor dei Sordi,A,Archaic Period,6,-580,-350,230,0.59254748
3364,Tor dei Sordi,A,Republican Period,7,-350,-30,320,0.59254748
3365,,A,Early Iron Age,4,-1000,-800,200,0.42114693
3365,,B,Archaic Period,6,-500,-350,150,0.42114693
3365,,B,Republican Period,7,-350,-30,320,0.42114693
3366,,A,Mid-Imperial Period,9,100,300,200,0.31865513
3366,,A,Late Imperial Period,10,300,400,100,0.31865513
3367,,A,Middle Bronze Age,2,-1700,-1300,400,0.40661043
3367,,A,Late Bronze Age,3,-1300,-1020,280,0.40661043
3367,,A,Early Iron Age,4,-1020,-1000,20,0.40661043
3367,,B,Early Imperial Period,8,-30,100,130,0.40661043
3367,,B,Mid-Imperial Period,9,100,200,100,0.40661043
3368,,A,Early Imperial Period,8,-30,100,130,0.32156184
3368,,A,Mid-Imperial Period,9,100,300,200,0.32156184
3368,,A,Late Imperial Period,10,300,500,200,0.32156184
3369,,A,Early Imperial Period,8,1,100,99,0.47479451
3369,,A,Mid-Imperial Period,9,100,300,200,0.47479451
3370,,A,Early Imperial Period,8,1,100,99,0.76177239
3370,,A,Mid-Imperial Period,9,100,300,200,0.76177239
3371,Prato del Pidocchio,A,Early Imperial Period,8,1,100,99,0.60982507
3371,Prato del Pidocchio,A,Mid-Imperial Period,9,100,300,200,0.60982507
3372,,A,Early Imperial Period,8,1,100,99,0.2659094
3372,,A,Mid-Imperial Period,9,100,300,200,0.2659094
3373,,A,Early Imperial Period,8,1,100,99,0.44316688
3373,,A,Mid-Imperial Period,9,100,300,200,0.44316688
3374,,A,Republican Period,7,-250,-30,220,0.70264339
3374,,A,Early Imperial Period,8,-30,100,130,0.70264339
3374,,A,Mid-Imperial Period,9,100,300,200,0.70264339
3375,fosso di Tor Mastorta,A,Late Iron Age,5,-600,-580,20,0.6244148
3375,fosso di Tor Mastorta,A,Archaic Period,6,-580,-350,230,0.6244148
3375,fosso di Tor Mastorta,A,Republican Period,7,-350,-30,320,0.6244148
3375,fosso di Tor Mastorta,A,Early Imperial Period,8,-30,100,130,0.6244148
3376,,A,Early Imperial Period,8,1,100,99,0.2295455
3376,,A,Mid-Imperial Period,9,100,300,200,0.2295455
3377,,A,Early Imperial Period,8,1,100,99,0.28552544
3377,,A,Mid-Imperial Period,9,100,300,200,0.28552544
3378,vaccheria di Tor Mastorta,A,Early Imperial Period,8,-30,100,130,0.63876647
3378,vaccheria di Tor Mastorta,A,Mid-Imperial Period,9,100,200,100,0.63876647
3379,Tenuta di Tor Mastorta,A,Late Iron Age,5,-600,-580,20,0.52878481
3379,Tenuta di Tor Mastorta,A,Archaic Period,6,-580,-400,180,0.52878481
3380,Tenuta di Tor Mastorta,A,Early Imperial Period,8,1,100,99,0.55022728
3380,Tenuta di Tor Mastorta,A,Mid-Imperial Period,9,100,300,200,0.55022728
3381,Tenuta di Tor Mastorta,A,Archaic Period,6,-500,-350,150,0.30942672
3381,Tenuta di Tor Mastorta,A,Republican Period,7,-350,-200,150,0.30942672
3382,vaccheria di Tor Mastorta,A,Mid-Imperial Period,9,100,300,200,0.56288701
3382,vaccheria di Tor Mastorta,A,Late Imperial Period,10,300,400,100,0.56288701
3383,Tenuta di Tor Mastorta,A,Archaic Period,6,-500,-350,150,0.41260371
3383,Tenuta di Tor Mastorta,A,Republican Period,7,-350,-30,320,0.41260371
3383,Tenuta di Tor Mastorta,A,Early Imperial Period,8,-30,100,130,0.41260371
3383,Tenuta di Tor Mastorta,A,Mid-Imperial Period,9,100,300,200,0.41260371
3384,Tenuta di Tor Mastorta,A,Archaic Period,6,-500,-350,150,0.32409418
3384,Tenuta di Tor Mastorta,A,Republican Period,7,-350,-30,320,0.32409418
3384,Tenuta di Tor Mastorta,A,Early Imperial Period,8,-30,100,130,0.32409418
3384,Tenuta di Tor Mastorta,A,Mid-Imperial Period,9,100,300,200,0.32409418
3385,,A,Republican Period,7,-300,-30,270,0.76263505
3385,,A,Early Imperial Period,8,-30,100,130,0.76263505
3385,,A,Mid-Imperial Period,9,100,300,200,0.76263505
3385,,A,Late Imperial Period,10,300,500,200,0.76263505
3386,,A,Archaic Period,6,-500,-350,150,0.62626654
3386,,A,Republican Period,7,-350,-30,320,0.62626654
3386,,A,Early Imperial Period,8,-30,100,130,0.62626654
3386,,A,Mid-Imperial Period,9,100,300,200,0.62626654
3387,,A,Early Iron Age,4,-1000,-750,250,0.80774367
3387,,A,Late Iron Age,5,-750,-580,170,0.80774367
3387,,A,Archaic Period,6,-580,-500,80,0.80774367
3388,,A,Archaic Period,6,-500,-350,150,0.65259928
3388,,A,Republican Period,7,-350,-30,320,0.65259928
3388,,A,Early Imperial Period,8,-30,100,130,0.65259928
3388,,A,Mid-Imperial Period,9,100,300,200,0.65259928
3389,,A,Late Iron Age,5,-600,-580,20,0.49794164
3389,,A,Archaic Period,6,-580,-400,180,0.49794164
3390,,A,Late Iron Age,5,-600,-580,20,0.43345585
3390,,A,Archaic Period,6,-580,-500,80,0.43345585
3391,,A,Early Iron Age,4,-1000,-750,250,0.4609465
3391,,A,Late Iron Age,5,-750,-600,150,0.4609465
3391,,B,Mid-Imperial Period,9,100,300,200,0.4129014
3392,,A,Republican Period,7,-200,-30,170,0.80459929
3392,,A,Early Imperial Period,8,-30,100,130,0.80459929
3392,,A,Mid-Imperial Period,9,100,300,200,0.80459929
3393,Caprine,A,Early Bronze Age,1,-2300,-1700,600,0.50501198
3393,Caprine,A,Middle Bronze Age,2,-1700,-1300,400,0.50501198
3394,Finestroni,A,Early Imperial Period,8,1,100,99,0.5292418
3394,Finestroni,A,Mid-Imperial Period,9,100,300,200,0.5292418
3395,,A,Early Imperial Period,8,1,100,99,0.35206193
3395,,A,Mid-Imperial Period,9,100,300,200,0.35206193
3396,,A,Early Imperial Period,8,1,100,99,0.35206315
3396,,A,Mid-Imperial Period,9,100,300,200,0.35206315
3397,La Pietrara,A,Republican Period,7,-200,-30,170,0.49601796
3397,La Pietrara,A,Early Imperial Period,8,-30,100,130,0.49601796
3397,La Pietrara,A,Mid-Imperial Period,9,100,300,200,0.49601796
3398,Condotto,A,Early Imperial Period,8,1,100,99,0.92661577
3398,Condotto,A,Mid-Imperial Period,9,100,300,200,0.92661577
3399,Condotto,A,Early Imperial Period,8,1,100,99,0.38994405
3399,Condotto,A,Mid-Imperial Period,9,100,300,200,0.38994405
3400,Casale Capaldo,A,Early Imperial Period,8,1,100,99,0.51093757
3400,Casale Capaldo,A,Mid-Imperial Period,9,100,300,200,0.51093757
3400,Casale Capaldo,A,Late Imperial Period,10,300,500,200,0.51093757
3401,Capaldino,A,Early Iron Age,4,-800,-750,50,0.46591866
3401,Capaldino,B,Late Iron Age,5,-750,-580,170,0.46591866
3401,Capaldino,B,Archaic Period,6,-580,-500,80,0.46591866
3402,Capaldino,A,Archaic Period,6,-500,-350,150,0.45040217
3402,Capaldino,A,Republican Period,7,-350,-30,320,0.45040217
3403,Capaldino,A,Archaic Period,6,-500,-350,150,0.45262018
3403,Capaldino,A,Republican Period,7,-350,-30,320,0.45262018
3404,Monte Capaldo,A,Archaic Period,6,-500,-350,150,0.58020306
3404,Monte Capaldo,A,Republican Period,7,-350,-30,320,0.58020306
3405,,A,Early Iron Age,4,-900,-750,150,0.42774284
3405,,A,Late Iron Age,5,-750,-700,50,0.42774284
3406,,A,Early Iron Age,4,-1000,-750,250,0.67091417
3406,,A,Late Iron Age,5,-750,-580,170,0.67091417
3406,,A,Archaic Period,6,-580,-500,80,0.67091417
3407,,A,Early Iron Age,4,-1000,-750,250,0.36709249
3407,,A,Late Iron Age,5,-750,-580,170,0.36709249
3407,,A,Archaic Period,6,-580,-500,80,0.36709249
3408,,A,Early Imperial Period,8,1,100,99,0.48540929
3408,,A,Mid-Imperial Period,9,100,300,200,0.48540929
3408,,A,Late Imperial Period,10,300,500,200,0.48540929
3409,,A,Republican Period,7,-100,-30,70,0.6146192
3409,,A,Early Imperial Period,8,-30,100,130,0.6146192
3409,,A,Mid-Imperial Period,9,100,300,200,0.6146192
3410,,A,Archaic Period,6,-500,-350,150,0.23064516
3410,,A,Republican Period,7,-350,-30,320,0.23064516
3411,Pilo Rotto,A,Republican Period,7,-200,-30,170,0.73658848
3411,Pilo Rotto,A,Early Imperial Period,8,-30,100,130,0.73658848
3411,Pilo Rotto,A,Mid-Imperial Period,9,100,300,200,0.73658848
3411,Pilo Rotto,A,Late Imperial Period,10,300,500,200,0.73658848
3412,,A,Archaic Period,6,-500,-350,150,0.29387873
3412,,A,Republican Period,7,-350,-30,320,0.29387873
3412,,A,Early Imperial Period,8,-30,100,130,0.29387873
3412,,A,Mid-Imperial Period,9,100,300,200,0.29387873
3412,,A,Late Imperial Period,10,300,500,200,0.29387873
3413,,A,Republican Period,7,-300,-30,270,0.74340141
3413,,A,Early Imperial Period,8,-30,100,130,0.74340141
3413,,A,Mid-Imperial Period,9,100,300,200,0.74340141
3413,,A,Late Imperial Period,10,300,500,200,0.74340141
3414,,A,Early Imperial Period,8,-30,100,130,0.23353703
3414,,A,Mid-Imperial Period,9,100,300,200,0.23353703
3414,,A,Late Imperial Period,10,300,500,200,0.23353703
3415,,A,Late Iron Age,5,-600,-580,20,0.81384867
3415,,A,Archaic Period,6,-580,-350,230,0.81384867
3415,,A,Republican Period,7,-350,-30,320,0.81384867
3415,,A,Early Imperial Period,8,-30,100,130,0.81384867
3415,,A,Mid-Imperial Period,9,100,300,200,0.81384867
3416,,A,Archaic Period,6,-500,-350,150,0.69991684
3416,,A,Republican Period,7,-350,-300,50,0.69991684
3416,,B,Early Imperial Period,8,1,100,99,0.69991684
3416,,B,Mid-Imperial Period,9,100,300,200,0.69991684
3417,,A,Early Imperial Period,8,1,100,99,0.42767981
3417,,A,Mid-Imperial Period,9,100,300,200,0.42767981
3418,Pichini,A,Early Imperial Period,8,1,100,99,0.57818609
3418,Pichini,A,Mid-Imperial Period,9,100,300,200,0.57818609
3419,,A,Early Imperial Period,8,-30,100,130,0.66539782
3419,,A,Mid-Imperial Period,9,100,300,200,0.66539782
3419,,A,Late Imperial Period,10,300,500,200,0.66539782
3420,,A,Archaic Period,6,-500,-350,150,0.91578078
3420,,A,Republican Period,7,-350,-30,320,0.91578078
3420,,A,Early Imperial Period,8,-30,100,130,0.91578078
3420,,A,Mid-Imperial Period,9,100,300,200,0.91578078
3421,,A,Early Imperial Period,8,1,100,99,0.4766514
3421,,A,Mid-Imperial Period,9,100,300,200,0.4766514
3422,,A,Republican Period,7,-200,-30,170,0.40949297
3422,,A,Early Imperial Period,8,-30,100,130,0.40949297
3422,,A,Mid-Imperial Period,9,100,300,200,0.40949297
3423,,A,Republican Period,7,-100,-30,70,0.57099092
3423,,A,Early Imperial Period,8,-30,100,130,0.57099092
3423,,A,Mid-Imperial Period,9,100,300,200,0.57099092
3424,colle Milone,A,Republican Period,7,-200,-30,170,0.79736096
3424,colle Milone,A,Early Imperial Period,8,-30,100,130,0.79736096
3424,colle Milone,A,Mid-Imperial Period,9,100,300,200,0.79736096
3425,,A,Early Imperial Period,8,1,100,99,0.29799917
3425,,A,Mid-Imperial Period,9,100,300,200,0.29799917
3426,,A,Mid-Imperial Period,9,100,300,200,0.55246168
3427,,A,Early Bronze Age,1,-2300,-1700,600,0.42798024
3428,,A,Archaic Period,6,-500,-400,100,0.44218227
3429,,A,Republican Period,7,-200,-30,170,0.54078537
3430,,A,Archaic Period,6,-400,-350,50,0.53096479
3430,,A,Republican Period,7,-350,-30,320,0.53096479
3430,,A,Early Imperial Period,8,-30,100,130,0.53096479
3430,,A,Mid-Imperial Period,9,100,300,200,0.53096479
3431,,A,Archaic Period,6,-400,-350,50,0.51177466
3431,,A,Republican Period,7,-350,-30,320,0.51177466
3431,,A,Early Imperial Period,8,-30,100,130,0.51177466
3431,,A,Mid-Imperial Period,9,100,300,200,0.51177466
3431,,A,Late Imperial Period,10,300,500,200,0.51177466
3432,,A,Republican Period,7,-200,-30,170,0.27124855
3432,,A,Early Imperial Period,8,-30,100,130,0.27124855
3432,,A,Mid-Imperial Period,9,100,200,100,0.27124855
3433,,A,Archaic Period,6,-400,-350,50,0.49953726
3433,,A,Republican Period,7,-350,-30,320,0.49953726
3433,,A,Early Imperial Period,8,-30,100,130,0.49953726
3433,,A,Mid-Imperial Period,9,100,200,100,0.49953726
3434,,A,Archaic Period,6,-400,-350,50,0.459122
3434,,A,Republican Period,7,-350,-30,320,0.459122
3434,,A,Early Imperial Period,8,-30,100,130,0.459122
3434,,A,Mid-Imperial Period,9,100,300,200,0.459122
3435,,A,Early Bronze Age,1,-2300,-1700,600,0.25941262
3435,,B,Archaic Period,6,-500,-350,150,0.25941262
3435,,B,Republican Period,7,-350,-30,320,0.25941262
3435,,B,Early Imperial Period,8,-30,100,130,0.25941262
3435,,B,Mid-Imperial Period,9,100,200,100,0.25941262
3436,Riserva delle Tavernucole,A,Republican Period,7,-100,-30,70,0.3240535
3436,Riserva delle Tavernucole,A,Early Imperial Period,8,-30,100,130,0.3240535
3436,Riserva delle Tavernucole,A,Mid-Imperial Period,9,100,300,200,0.3240535
3437,Riserva delle Tavernucole,A,Archaic Period,6,-400,-350,50,0.72551358
3437,Riserva delle Tavernucole,A,Republican Period,7,-350,-30,320,0.72551358
3437,Riserva delle Tavernucole,A,Early Imperial Period,8,-30,100,130,0.72551358
3437,Riserva delle Tavernucole,A,Mid-Imperial Period,9,100,300,200,0.72551358
3437,Riserva delle Tavernucole,A,Late Imperial Period,10,300,500,200,0.72551358
3438,,A,Republican Period,7,-200,-30,170,0.52988356
3438,,A,Early Imperial Period,8,-30,100,130,0.52988356
3438,,A,Mid-Imperial Period,9,100,300,200,0.52988356
3439,vaccheria delle Tavernucole,A,Early Imperial Period,8,1,100,99,0.26668265
3439,vaccheria delle Tavernucole,A,Mid-Imperial Period,9,100,300,200,0.26668265
3440,vaccheria delle Tavernucole,A,Early Imperial Period,8,1,100,99,0.26668477
3440,vaccheria delle Tavernucole,A,Mid-Imperial Period,9,100,300,200,0.26668477
3441,Castell'Arcione,A,Early Imperial Period,8,1,100,99,1.2144089
3441,Castell'Arcione,A,Mid-Imperial Period,9,100,300,200,1.2144089
3442,Castell'Arcione,A,Early Imperial Period,8,1,100,99,0.62310869
3442,Castell'Arcione,A,Mid-Imperial Period,9,100,300,200,0.62310869
3443,,A,Republican Period,7,-200,-30,170,0.47740018
3443,,A,Early Imperial Period,8,-30,100,130,0.47740018
3443,,A,Mid-Imperial Period,9,100,300,200,0.47740018
3444,,A,Early Imperial Period,8,1,100,99,0.45950443
3444,,A,Mid-Imperial Period,9,100,300,200,0.45950443
3445,,A,Early Iron Age,4,-1000,-750,250,0.062615849
3445,,A,Late Iron Age,5,-750,-600,150,0.062615849
3445,,B,Early Imperial Period,8,-30,100,130,0.88869202
3445,,B,Mid-Imperial Period,9,100,300,200,0.88869202
3445,,B,Late Imperial Period,10,300,500,200,0.88869202
3446,col Virginia,A,Republican Period,7,-200,-30,170,0.70702648
3446,col Virginia,A,Early Imperial Period,8,-30,100,130,0.70702648
3446,col Virginia,A,Mid-Imperial Period,9,100,300,200,0.70702648
3447,col Virginia,A,Republican Period,7,-200,-30,170,0.63278931
3447,col Virginia,A,Early Imperial Period,8,-30,100,130,0.63278931
3447,col Virginia,A,Mid-Imperial Period,9,100,300,200,0.63278931
3447,col Virginia,A,Late Imperial Period,10,300,400,100,0.63278931
3448,,A,Early Imperial Period,8,1,100,99,0.41769633
3448,,A,Mid-Imperial Period,9,100,300,200,0.41769633
3449,,A,Early Imperial Period,8,1,100,99,0.43907386
3449,,A,Mid-Imperial Period,9,100,300,200,0.43907386
3450,,A,Early Imperial Period,8,1,100,99,0.78749967
3450,,A,Mid-Imperial Period,9,100,300,200,0.78749967
3451,,A,Early Imperial Period,8,1,100,99,0.37966117
3451,,A,Mid-Imperial Period,9,100,300,200,0.37966117
3452,,A,Early Imperial Period,8,1,100,99,0.34635359
3452,,A,Mid-Imperial Period,9,100,300,200,0.34635359
3453,,A,Archaic Period,6,-500,-350,150,0.46616045
3453,,A,Republican Period,7,-350,-30,320,0.46616045
3454,,A,Early Imperial Period,8,1,100,99,0.25478157
3454,,A,Mid-Imperial Period,9,100,300,200,0.25478157
3455,,A,Archaic Period,6,-400,-350,50,0.9900462
3455,,A,Republican Period,7,-350,-30,320,0.9900462
3455,,A,Early Imperial Period,8,-30,100,130,0.9900462
3455,,A,Mid-Imperial Period,9,100,300,200,0.9900462
3455,,A,Late Imperial Period,10,300,500,200,0.9900462
3456,,A,Early Imperial Period,8,1,100,99,0.70999408
3456,,A,Mid-Imperial Period,9,100,300,200,0.70999408
3457,,A,Republican Period,7,-200,-30,170,0.60874856
3457,,A,Early Imperial Period,8,-30,100,130,0.60874856
3457,,A,Mid-Imperial Period,9,100,300,200,0.60874856
3458,,A,Republican Period,7,-200,-30,170,0.58322942
3458,,A,Early Imperial Period,8,-30,100,130,0.58322942
3458,,A,Mid-Imperial Period,9,100,200,100,0.58322942
3459,,A,Republican Period,7,-200,-30,170,1.2697307
3459,,A,Early Imperial Period,8,-30,100,130,1.2697307
3459,,A,Mid-Imperial Period,9,100,300,200,1.2697307
3460,,A,Early Imperial Period,8,1,100,99,0.79298365
3460,,A,Mid-Imperial Period,9,100,300,200,0.79298365
3461,,A,Early Imperial Period,8,1,100,99,0.60274023
3461,,A,Mid-Imperial Period,9,100,300,200,0.60274023
3462,,A,Early Imperial Period,8,1,100,99,0.60271454
3462,,A,Mid-Imperial Period,9,100,300,200,0.60271454
3463,,A,Early Imperial Period,8,1,100,99,0.2650722
3463,,A,Mid-Imperial Period,9,100,300,200,0.2650722
3464,fosso dell'Acquacetosa,A,Early Imperial Period,8,1,100,99,0.7056092
3464,fosso dell'Acquacetosa,A,Mid-Imperial Period,9,100,300,200,0.7056092
3465,lago delle Colonnelle,A,Republican Period,7,-300,-30,270,0.73019183
3465,lago delle Colonnelle,A,Early Imperial Period,8,-30,100,130,0.73019183
3465,lago delle Colonnelle,A,Mid-Imperial Period,9,100,300,200,0.73019183
3465,lago delle Colonnelle,A,Late Imperial Period,10,300,500,200,0.73019183
3466,,A,Early Bronze Age,1,-2300,-1700,600,0.75255072
3466,,A,Middle Bronze Age,2,-1700,-1300,400,0.75255072
3466,,A,Late Bronze Age,3,-1300,-1020,280,0.75255072
3466,,A,Early Iron Age,4,-1020,-1000,20,0.75255072
3467,,A,Republican Period,7,-200,-30,170,0.75876492
3467,,A,Early Imperial Period,8,-30,100,130,0.75876492
3467,,A,Mid-Imperial Period,9,100,300,200,0.75876492
3468,,A,Early Imperial Period,8,1,100,99,0.51420379
3468,,A,Mid-Imperial Period,9,100,300,200,0.51420379
3469,,A,Early Imperial Period,8,1,100,99,0.65548342
3469,,A,Mid-Imperial Period,9,100,300,200,0.65548342
3470,,A,Late Iron Age,5,-600,-580,20,0.52221358
3470,,A,Archaic Period,6,-580,-500,80,0.52221358
3471,,A,Republican Period,7,-200,-30,170,0.81234878
3471,,A,Early Imperial Period,8,-30,100,130,0.81234878
3471,,A,Mid-Imperial Period,9,100,300,200,0.81234878
3472,,A,Republican Period,7,-100,-30,70,0.79578269
3472,,A,Early Imperial Period,8,-30,100,130,0.79578269
3472,,A,Mid-Imperial Period,9,100,300,200,0.79578269
3473,,A,Republican Period,7,-200,-30,170,0.70587653
3473,,A,Early Imperial Period,8,-30,100,130,0.70587653
3473,,A,Mid-Imperial Period,9,100,300,200,0.70587653
3474,,A,Early Imperial Period,8,1,100,99,0.64730555
3474,,A,Mid-Imperial Period,9,100,300,200,0.64730555
3475,,A,Early Imperial Period,8,1,100,99,0.73388064
3475,,A,Mid-Imperial Period,9,100,300,200,0.73388064
3476,,A,Republican Period,7,-200,-30,170,0.92270219
3476,,A,Early Imperial Period,8,-30,100,130,0.92270219
3476,,A,Mid-Imperial Period,9,100,300,200,0.92270219
3477,,A,Early Imperial Period,8,1,100,99,0.38088349
3477,,A,Mid-Imperial Period,9,100,300,200,0.38088349
3478,,A,Republican Period,7,-200,-30,170,0.82697952
3478,,A,Early Imperial Period,8,-30,100,130,0.82697952
3478,,A,Mid-Imperial Period,9,100,300,200,0.82697952
3479,,A,Republican Period,7,-100,-30,70,0.74152642
3479,,A,Early Imperial Period,8,-30,100,130,0.74152642
3479,,A,Mid-Imperial Period,9,100,300,200,0.74152642
3480,,A,Early Imperial Period,8,1,100,99,0.71463811
3480,,A,Mid-Imperial Period,9,100,300,200,0.71463811
3481,,A,Republican Period,7,-200,-30,170,0.7312336
3481,,A,Early Imperial Period,8,-30,100,130,0.7312336
3481,,A,Mid-Imperial Period,9,100,300,200,0.7312336
3482,,A,Archaic Period,6,-400,-350,50,0.70734239
3482,,A,Republican Period,7,-350,-30,320,0.70734239
3482,,A,Early Imperial Period,8,-30,100,130,0.70734239
3482,,A,Mid-Imperial Period,9,100,300,200,0.70734239
3483,,A,Republican Period,7,-200,-30,170,0.94501197
3483,,A,Early Imperial Period,8,-30,100,130,0.94501197
3483,,A,Mid-Imperial Period,9,100,300,200,0.94501197
3484,,A,Early Imperial Period,8,1,100,99,0.65730691
3484,,A,Mid-Imperial Period,9,100,300,200,0.65730691
3485,,A,Early Imperial Period,8,1,100,99,0.46758223
3485,,A,Mid-Imperial Period,9,100,300,200,0.46758223
3486,,A,Republican Period,7,-200,-30,170,0.40640098
3486,,A,Early Imperial Period,8,-30,100,130,0.40640098
3486,,A,Mid-Imperial Period,9,100,200,100,0.40640098
3487,,A,Republican Period,7,-100,-30,70,0.83295768
3487,,A,Early Imperial Period,8,-30,100,130,0.83295768
3487,,A,Mid-Imperial Period,9,100,300,200,0.83295768
3488,,A,Early Imperial Period,8,1,100,99,0.50828701
3488,,A,Mid-Imperial Period,9,100,300,200,0.50828701
3489,Sprete,A,Early Imperial Period,8,1,100,99,0.6604076
3489,Sprete,A,Mid-Imperial Period,9,100,300,200,0.6604076
3490,,A,Mid-Imperial Period,9,100,200,100,0.81900126
3491,,A,Republican Period,7,-100,-30,70,0.6275174
3492,,A,Early Imperial Period,8,1,100,99,0.66087317
3492,,A,Mid-Imperial Period,9,100,300,200,0.66087317
3493,,A,Early Imperial Period,8,1,100,99,0.66083968
3493,,A,Mid-Imperial Period,9,100,300,200,0.66083968
3494,,A,Republican Period,7,-100,-30,70,0.656793
3494,,A,Early Imperial Period,8,-30,100,130,0.656793
3494,,A,Mid-Imperial Period,9,100,300,200,0.656793
3495,,A,Early Imperial Period,8,1,100,99,0.66032642
3495,,A,Mid-Imperial Period,9,100,300,200,0.66032642
3496,,A,Republican Period,7,-200,-30,170,0.49457991
3496,,A,Early Imperial Period,8,-30,100,130,0.49457991
3496,,A,Mid-Imperial Period,9,100,300,200,0.49457991
3497,,A,Late Iron Age,5,-600,-580,20,0.61244935
3497,,A,Archaic Period,6,-580,-500,80,0.61244935
3498,,A,Republican Period,7,-200,-30,170,0.56595963
3498,,A,Early Imperial Period,8,-30,100,130,0.56595963
3498,,A,Mid-Imperial Period,9,100,200,100,0.56595963
3499,,A,Early Imperial Period,8,1,100,99,0.68940151
3499,,A,Mid-Imperial Period,9,100,300,200,0.68940151
3500,,A,Republican Period,7,-300,-30,270,1.2060722
3500,,A,Early Imperial Period,8,-30,100,130,1.2060722
3500,,A,Mid-Imperial Period,9,100,300,200,1.2060722
3500,,A,Late Imperial Period,10,300,500,200,1.2060722
3501,,A,Early Imperial Period,8,1,100,99,1.0486901
3501,,A,Mid-Imperial Period,9,100,300,200,1.0486901
3502,,A,Republican Period,7,-200,-30,170,0.67818743
3502,,A,Early Imperial Period,8,-30,100,130,0.67818743
3502,,A,Mid-Imperial Period,9,100,200,100,0.67818743
3503,,A,Early Imperial Period,8,1,100,99,0.6176331
3503,,A,Mid-Imperial Period,9,100,300,200,0.6176331
3504,,A,Archaic Period,6,-400,-350,50,0.66086841
3504,,A,Republican Period,7,-350,-30,320,0.66086841
3505,,A,Early Imperial Period,8,1,100,99,0.61823183
3505,,A,Mid-Imperial Period,9,100,300,200,0.61823183
3506,,A,Republican Period,7,-200,-30,170,0.6262511
3506,,A,Early Imperial Period,8,-30,100,130,0.6262511
3506,,A,Mid-Imperial Period,9,100,300,200,0.6262511
3507,,A,Republican Period,7,-200,-30,170,0.79506838
3507,,A,Early Imperial Period,8,-30,100,130,0.79506838
3507,,A,Mid-Imperial Period,9,100,300,200,0.79506838
3508,Grottelle,A,Early Imperial Period,8,1,100,99,1.1247737
3508,Grottelle,A,Mid-Imperial Period,9,100,300,200,1.1247737
3509,,A,Republican Period,7,-200,-30,170,0.63336772
3509,,A,Early Imperial Period,8,-30,100,130,0.63336772
3509,,A,Mid-Imperial Period,9,100,300,200,0.63336772
3510,,A,Republican Period,7,-300,-30,270,0.89168566
3510,,A,Early Imperial Period,8,-30,100,130,0.89168566
3510,,A,Mid-Imperial Period,9,100,300,200,0.89168566
3511,Tivoli (Tibur),A,Early Iron Age,4,-800,-750,50,15.153062
3511,Tivoli (Tibur),A,Late Iron Age,5,-750,-580,170,15.153062
3511,Tivoli (Tibur),A,Archaic Period,6,-580,-350,230,15.153062
3511,Tivoli (Tibur),A,Republican Period,7,-350,-30,320,15.153062
3511,Tivoli (Tibur),A,Early Imperial Period,8,-30,100,130,40.553047
3511,Tivoli (Tibur),A,Mid-Imperial Period,9,100,300,200,40.553047
3511,Tivoli (Tibur),A,Late Imperial Period,10,300,500,200,40.553047
3512,,A,Republican Period,7,-300,-30,270,0.31038186
3512,,A,Early Imperial Period,8,-30,100,130,0.31038186
3512,,A,Mid-Imperial Period,9,100,300,200,0.31038186
3512,,A,Late Imperial Period,10,300,500,200,0.31038186
3513,,A,Republican Period,7,-300,-30,270,0.3345598
3513,,A,Early Imperial Period,8,-30,100,130,0.3345598
3513,,A,Mid-Imperial Period,9,100,300,200,0.3345598
3513,,A,Late Imperial Period,10,300,500,200,0.3345598
3514,,A,Republican Period,7,-300,-30,270,0.20352554
3514,,A,Early Imperial Period,8,-30,100,130,0.20352554
3514,,A,Mid-Imperial Period,9,100,300,200,0.20352554
3514,,A,Late Imperial Period,10,300,500,200,0.20352554
3515,,A,Republican Period,7,-300,-30,270,0.18875866
3515,,A,Early Imperial Period,8,-30,100,130,0.18875866
3515,,A,Mid-Imperial Period,9,100,300,200,0.18875866
3515,,A,Late Imperial Period,10,300,500,200,0.18875866
3516,,A,Republican Period,7,-300,-30,270,0.46020168
3516,,A,Early Imperial Period,8,-30,100,130,0.46020168
3516,,A,Mid-Imperial Period,9,100,300,200,0.46020168
3516,,A,Late Imperial Period,10,300,500,200,0.46020168
3517,,A,Republican Period,7,-300,-30,270,0.27637547
3517,,A,Early Imperial Period,8,-30,100,130,0.27637547
3517,,A,Mid-Imperial Period,9,100,300,200,0.27637547
3517,,A,Late Imperial Period,10,300,500,200,0.27637547
3518,,A,Republican Period,7,-300,-30,270,0.19762726
3518,,A,Early Imperial Period,8,-30,100,130,0.19762726
3518,,A,Mid-Imperial Period,9,100,300,200,0.19762726
3518,,A,Late Imperial Period,10,300,500,200,0.19762726
3519,,A,Republican Period,7,-300,-30,270,0.18344189
3519,,A,Early Imperial Period,8,-30,100,130,0.18344189
3519,,A,Mid-Imperial Period,9,100,300,200,0.18344189
3519,,A,Late Imperial Period,10,300,500,200,0.18344189
3520,,A,Republican Period,7,-100,-30,70,0.316414
3521,,A,Republican Period,7,-300,-30,270,0.32950771
3521,,A,Early Imperial Period,8,-30,100,130,0.32950771
3521,,A,Mid-Imperial Period,9,100,300,200,0.32950771
3521,,A,Late Imperial Period,10,300,500,200,0.32950771
3522,,A,Republican Period,7,-300,-30,270,0.62996334
3522,,A,Early Imperial Period,8,-30,100,130,0.62996334
3522,,A,Mid-Imperial Period,9,100,300,200,0.62996334
3522,,A,Late Imperial Period,10,300,500,200,0.62996334
3523,,A,Republican Period,7,-300,-30,270,0.19669202
3523,,A,Early Imperial Period,8,-30,100,130,0.19669202
3523,,A,Mid-Imperial Period,9,100,300,200,0.19669202
3523,,A,Late Imperial Period,10,300,500,200,0.19669202
3524,,A,Late Iron Age,5,-600,-580,20,0.59317523
3524,,A,Archaic Period,6,-580,-500,80,0.59317523
3525,,A,Republican Period,7,-300,-30,270,0.2775903
3525,,A,Early Imperial Period,8,-30,100,130,0.2775903
3525,,A,Mid-Imperial Period,9,100,300,200,0.2775903
3525,,A,Late Imperial Period,10,300,500,200,0.2775903
3526,,A,Republican Period,7,-300,-30,270,0.28451675
3526,,A,Early Imperial Period,8,-30,100,130,0.28451675
3526,,A,Mid-Imperial Period,9,100,300,200,0.28451675
3526,,A,Late Imperial Period,10,300,500,200,0.28451675
3527,,A,Republican Period,7,-300,-30,270,0.25255671
3527,,A,Early Imperial Period,8,-30,100,130,0.25255671
3527,,A,Mid-Imperial Period,9,100,300,200,0.25255671
3527,,A,Late Imperial Period,10,300,500,200,0.25255671
3528,,A,Republican Period,7,-300,-30,270,0.30126789
3528,,A,Early Imperial Period,8,-30,100,130,0.30126789
3528,,A,Mid-Imperial Period,9,100,300,200,0.30126789
3528,,A,Late Imperial Period,10,300,500,200,0.30126789
3529,,A,Republican Period,7,-300,-30,270,0.24046735
3529,,A,Early Imperial Period,8,-30,100,130,0.24046735
3529,,A,Mid-Imperial Period,9,100,300,200,0.24046735
3529,,A,Late Imperial Period,10,300,500,200,0.24046735
3530,,A,Republican Period,7,-300,-30,270,0.14481732
3530,,A,Early Imperial Period,8,-30,100,130,0.14481732
3530,,A,Mid-Imperial Period,9,100,300,200,0.14481732
3530,,A,Late Imperial Period,10,300,500,200,0.14481732
3531,Vicovaro (Varia),A,Republican Period,7,-300,-30,270,5.518095
3531,Vicovaro (Varia),A,Early Imperial Period,8,-30,100,130,5.518095
3531,Vicovaro (Varia),A,Mid-Imperial Period,9,100,300,200,5.518095
3531,Vicovaro (Varia),A,Late Imperial Period,10,300,500,200,5.518095
3532,,A,Republican Period,7,-300,-30,270,0.31283775
3532,,A,Early Imperial Period,8,-30,100,130,0.31283775
3532,,A,Mid-Imperial Period,9,100,300,200,0.31283775
3532,,A,Late Imperial Period,10,300,500,200,0.31283775
3533,Mandela (Pagus Mandelae),A,Republican Period,7,-100,-30,70,1.2511209
3533,Mandela (Pagus Mandelae),A,Early Imperial Period,8,-30,100,130,1.2511209
3533,Mandela (Pagus Mandelae),A,Mid-Imperial Period,9,100,300,200,1.2511209
3533,Mandela (Pagus Mandelae),A,Late Imperial Period,10,300,500,200,1.2511209
3534,,A,Republican Period,7,-300,-30,270,0.227862
3534,,A,Early Imperial Period,8,-30,100,130,0.227862
3534,,A,Mid-Imperial Period,9,100,300,200,0.227862
3534,,A,Late Imperial Period,10,300,500,200,0.227862
3535,,A,Republican Period,7,-300,-30,270,0.85254979
3535,,A,Early Imperial Period,8,-30,100,130,0.85254979
3535,,A,Mid-Imperial Period,9,100,300,200,0.85254979
3535,,A,Late Imperial Period,10,300,500,200,0.85254979
3536,,A,Republican Period,7,-300,-30,270,0.11114829
3536,,A,Early Imperial Period,8,-30,100,130,0.11114829
3536,,A,Mid-Imperial Period,9,100,300,200,0.11114829
3536,,A,Late Imperial Period,10,300,500,200,0.11114829
3537,,A,Republican Period,7,-300,-30,270,0.11115257
3537,,A,Early Imperial Period,8,-30,100,130,0.11115257
3537,,A,Mid-Imperial Period,9,100,300,200,0.11115257
3537,,A,Late Imperial Period,10,300,500,200,0.11115257
3538,,A,Republican Period,7,-300,-30,270,0.2025167
3538,,A,Early Imperial Period,8,-30,100,130,0.2025167
3538,,A,Mid-Imperial Period,9,100,300,200,0.2025167
3538,,A,Late Imperial Period,10,300,500,200,0.2025167
3539,,A,Republican Period,7,-300,-30,270,0.16684277
3539,,A,Early Imperial Period,8,-30,100,130,0.16684277
3539,,A,Mid-Imperial Period,9,100,300,200,0.16684277
3539,,A,Late Imperial Period,10,300,500,200,0.16684277
3540,,A,Republican Period,7,-300,-30,270,0.16684631
3540,,A,Early Imperial Period,8,-30,100,130,0.16684631
3540,,A,Mid-Imperial Period,9,100,300,200,0.16684631
3540,,A,Late Imperial Period,10,300,500,200,0.16684631
3541,Castelmadama,A,Republican Period,7,-300,-30,270,1.1693408
3541,Castelmadama,A,Early Imperial Period,8,-30,100,130,1.1693408
3541,Castelmadama,A,Mid-Imperial Period,9,100,300,200,1.1693408
3541,Castelmadama,A,Late Imperial Period,10,300,500,200,1.1693408
3542,Colle Monitola,A,Early Imperial Period,8,-30,100,130,0.19858664
3542,Colle Monitola,A,Mid-Imperial Period,9,100,300,200,0.19858664
3542,Colle Monitola,A,Late Imperial Period,10,300,500,200,0.19858664
3543,,A,Republican Period,7,-300,-30,270,0.10039307
3543,,A,Early Imperial Period,8,-30,100,130,0.10039307
3543,,A,Mid-Imperial Period,9,100,300,200,0.10039307
3543,,A,Late Imperial Period,10,300,500,200,0.10039307
3544,,A,Republican Period,7,-300,-30,270,0.10038606
3544,,A,Early Imperial Period,8,-30,100,130,0.10038606
3544,,A,Mid-Imperial Period,9,100,300,200,0.10038606
3544,,A,Late Imperial Period,10,300,500,200,0.10038606
3545,Colle Scarano,A,Republican Period,7,-300,-30,270,0.19451939
3545,Colle Scarano,A,Early Imperial Period,8,-30,100,130,0.19451939
3545,Colle Scarano,A,Mid-Imperial Period,9,100,300,200,0.19451939
3545,Colle Scarano,A,Late Imperial Period,10,300,500,200,0.19451939
3546,S. Maria delle cave,A,Republican Period,7,-300,-30,270,0.3381443
3546,S. Maria delle cave,A,Early Imperial Period,8,-30,100,130,0.3381443
3546,S. Maria delle cave,A,Mid-Imperial Period,9,100,300,200,0.3381443
3546,S. Maria delle cave,A,Late Imperial Period,10,300,500,200,0.3381443
3547,,A,Republican Period,7,-300,-30,270,0.48261377
3547,,A,Early Imperial Period,8,-30,100,130,0.48261377
3547,,A,Mid-Imperial Period,9,100,300,200,0.48261377
3547,,A,Late Imperial Period,10,300,500,200,0.48261377
3548,,A,Republican Period,7,-300,-30,270,0.36676061
3548,,A,Early Imperial Period,8,-30,100,130,0.36676061
3548,,A,Mid-Imperial Period,9,100,300,200,0.36676061
3548,,A,Late Imperial Period,10,300,500,200,0.36676061
3549,,A,Republican Period,7,-300,-30,270,0.73114783
3549,,A,Early Imperial Period,8,-30,100,130,0.73114783
3549,,A,Mid-Imperial Period,9,100,300,200,0.73114783
3549,,A,Late Imperial Period,10,300,500,200,0.73114783
3550,,A,Republican Period,7,-300,-30,270,0.13794202
3550,,A,Early Imperial Period,8,-30,100,130,0.13794202
3550,,A,Mid-Imperial Period,9,100,300,200,0.13794202
3550,,A,Late Imperial Period,10,300,500,200,0.13794202
3551,,A,Republican Period,7,-300,-30,270,0.11604635
3551,,A,Early Imperial Period,8,-30,100,130,0.11604635
3551,,A,Mid-Imperial Period,9,100,300,200,0.11604635
3551,,A,Late Imperial Period,10,300,500,200,0.11604635
3552,,A,Republican Period,7,-300,-30,270,0.11605753
3552,,A,Early Imperial Period,8,-30,100,130,0.11605753
3552,,A,Mid-Imperial Period,9,100,300,200,0.11605753
3552,,A,Late Imperial Period,10,300,500,200,0.11605753
3553,,A,Republican Period,7,-300,-30,270,0.22895937
3553,,A,Early Imperial Period,8,-30,100,130,0.22895937
3553,,A,Mid-Imperial Period,9,100,300,200,0.22895937
3553,,A,Late Imperial Period,10,300,500,200,0.22895937
3554,,A,Republican Period,7,-300,-30,270,0.76309246
3554,,A,Early Imperial Period,8,-30,100,130,0.76309246
3554,,A,Mid-Imperial Period,9,100,300,200,0.76309246
3554,,A,Late Imperial Period,10,300,500,200,0.76309246
3555,,A,Republican Period,7,-300,-30,270,0.32224816
3555,,A,Early Imperial Period,8,-30,100,130,0.32224816
3555,,A,Mid-Imperial Period,9,100,300,200,0.32224816
3555,,A,Late Imperial Period,10,300,500,200,0.32224816
3556,,A,Republican Period,7,-300,-30,270,0.17853092
3556,,A,Early Imperial Period,8,-30,100,130,0.17853092
3556,,A,Mid-Imperial Period,9,100,300,200,0.17853092
3556,,A,Late Imperial Period,10,300,500,200,0.17853092
3557,,A,Republican Period,7,-300,-30,270,0.17853388
3557,,A,Early Imperial Period,8,-30,100,130,0.17853388
3557,,A,Mid-Imperial Period,9,100,300,200,0.17853388
3557,,A,Late Imperial Period,10,300,500,200,0.17853388
3558,,A,Republican Period,7,-300,-30,270,0.17852573
3558,,A,Early Imperial Period,8,-30,100,130,0.17852573
3558,,A,Mid-Imperial Period,9,100,300,200,0.17852573
3558,,A,Late Imperial Period,10,300,500,200,0.17852573
3559,,A,Republican Period,7,-300,-30,270,0.17852244
3559,,A,Early Imperial Period,8,-30,100,130,0.17852244
3559,,A,Mid-Imperial Period,9,100,300,200,0.17852244
3559,,A,Late Imperial Period,10,300,500,200,0.17852244
3560,Ciciliano (Trebula Suffenas),A,Archaic Period,6,-400,-350,50,1.3318914
3560,Ciciliano (Trebula Suffenas),A,Republican Period,7,-350,-30,320,1.3318914
3560,Ciciliano (Trebula Suffenas),A,Early Imperial Period,8,-30,100,130,1.3318914
3560,Ciciliano (Trebula Suffenas),A,Mid-Imperial Period,9,100,200,100,1.3318914
3561,,A,Republican Period,7,-300,-30,270,0.16750309
3561,,A,Early Imperial Period,8,-30,100,130,0.16750309
3561,,A,Mid-Imperial Period,9,100,300,200,0.16750309
3561,,A,Late Imperial Period,10,300,500,200,0.16750309
3562,,A,Republican Period,7,-300,-30,270,0.23889731
3562,,A,Early Imperial Period,8,-30,100,130,0.23889731
3562,,A,Mid-Imperial Period,9,100,300,200,0.23889731
3562,,A,Late Imperial Period,10,300,500,200,0.23889731
3563,,A,Republican Period,7,-300,-30,270,1.2088679
3563,,A,Early Imperial Period,8,-30,100,130,1.2088679
3563,,A,Mid-Imperial Period,9,100,300,200,1.2088679
3563,,A,Late Imperial Period,10,300,500,200,1.2088679
3564,Colle Zingarello,A,Republican Period,7,-300,-30,270,0.25283358
3564,Colle Zingarello,A,Early Imperial Period,8,-30,100,130,0.25283358
3564,Colle Zingarello,A,Mid-Imperial Period,9,100,300,200,0.25283358
3564,Colle Zingarello,A,Late Imperial Period,10,300,500,200,0.25283358
3565,,A,Republican Period,7,-300,-30,270,0.27446634
3565,,A,Early Imperial Period,8,-30,100,130,0.27446634
3565,,A,Mid-Imperial Period,9,100,300,200,0.27446634
3565,,A,Late Imperial Period,10,300,500,200,0.27446634
3566,,A,Republican Period,7,-300,-30,270,0.1881004
3566,,A,Early Imperial Period,8,-30,100,130,0.1881004
3566,,A,Mid-Imperial Period,9,100,300,200,0.1881004
3566,,A,Late Imperial Period,10,300,500,200,0.1881004
3567,,A,Republican Period,7,-300,-30,270,0.21156751
3567,,A,Early Imperial Period,8,-30,100,130,0.21156751
3567,,A,Mid-Imperial Period,9,100,300,200,0.21156751
3567,,A,Late Imperial Period,10,300,500,200,0.21156751
3568,Monte S. Angelo (Aefula),A,Early Iron Age,4,-800,-750,50,2.6630464
3568,Monte S. Angelo (Aefula),A,Late Iron Age,5,-750,-580,170,2.6630464
3568,Monte S. Angelo (Aefula),A,Archaic Period,6,-580,-350,230,2.6630464
3568,Monte S. Angelo (Aefula),A,Republican Period,7,-350,-30,320,2.6630464
3569,,A,Republican Period,7,-100,-30,70,1.772943
3569,,A,Early Imperial Period,8,-30,100,130,1.772943
3569,,A,Mid-Imperial Period,9,100,200,100,1.772943
3570,,A,Republican Period,7,-100,-30,70,0.46475461
3570,,A,Early Imperial Period,8,-30,100,130,0.46475461
3570,,A,Mid-Imperial Period,9,100,300,200,0.46475461
3570,,A,Late Imperial Period,10,300,500,200,0.46475461
3571,,A,Republican Period,7,-300,-30,270,0.30614549
3571,,A,Early Imperial Period,8,-30,100,130,0.30614549
3571,,A,Mid-Imperial Period,9,100,300,200,0.30614549
3571,,A,Late Imperial Period,10,300,500,200,0.30614549
3572,,A,Republican Period,7,-300,-30,270,0.31381556
3572,,A,Early Imperial Period,8,-30,100,130,0.31381556
3572,,A,Mid-Imperial Period,9,100,300,200,0.31381556
3572,,A,Late Imperial Period,10,300,500,200,0.31381556
3573,,A,Republican Period,7,-300,-30,270,0.20372687
3573,,A,Early Imperial Period,8,-30,100,130,0.20372687
3573,,A,Mid-Imperial Period,9,100,300,200,0.20372687
3573,,A,Late Imperial Period,10,300,500,200,0.20372687
3574,,A,Republican Period,7,-300,-30,270,0.1796089
3574,,A,Early Imperial Period,8,-30,100,130,0.1796089
3574,,A,Mid-Imperial Period,9,100,300,200,0.1796089
3574,,A,Late Imperial Period,10,300,500,200,0.1796089
3575,,A,Republican Period,7,-300,-30,270,0.13898155
3575,,A,Early Imperial Period,8,-30,100,130,0.13898155
3575,,A,Mid-Imperial Period,9,100,300,200,0.13898155
3575,,A,Late Imperial Period,10,300,500,200,0.13898155
3576,,A,Republican Period,7,-300,-30,270,0.13897865
3576,,A,Early Imperial Period,8,-30,100,130,0.13897865
3576,,A,Mid-Imperial Period,9,100,300,200,0.13897865
3576,,A,Late Imperial Period,10,300,500,200,0.13897865
3577,,A,Republican Period,7,-300,-30,270,0.12183712
3577,,A,Early Imperial Period,8,-30,100,130,0.12183712
3577,,A,Mid-Imperial Period,9,100,300,200,0.12183712
3577,,A,Late Imperial Period,10,300,500,200,0.12183712
3578,,A,Republican Period,7,-300,-30,270,0.12182523
3578,,A,Early Imperial Period,8,-30,100,130,0.12182523
3578,,A,Mid-Imperial Period,9,100,300,200,0.12182523
3578,,A,Late Imperial Period,10,300,500,200,0.12182523
3579,,A,Republican Period,7,-300,-30,270,0.12181937
3579,,A,Early Imperial Period,8,-30,100,130,0.12181937
3579,,A,Mid-Imperial Period,9,100,300,200,0.12181937
3579,,A,Late Imperial Period,10,300,500,200,0.12181937
3580,Sutri (Sutrium),A,Late Bronze Age,3,-1100,-1020,80,8.5476732
3580,Sutri (Sutrium),A,Early Iron Age,4,-1020,-950,70,8.5476732
3580,Sutri (Sutrium),B,Late Iron Age,5,-700,-580,120,8.5476732
3580,Sutri (Sutrium),B,Archaic Period,6,-580,-350,230,8.5476732
3580,Sutri (Sutrium),B,Republican Period,7,-350,-30,320,8.5476732
3580,Sutri (Sutrium),B,Early Imperial Period,8,-30,100,130,8.5476732
3580,Sutri (Sutrium),B,Mid-Imperial Period,9,100,300,200,8.5476732
3580,Sutri (Sutrium),B,Late Imperial Period,10,300,500,200,8.5476732
3581,,A,Archaic Period,6,-400,-350,50,0.31293258
3581,,A,Republican Period,7,-350,-100,250,0.31293258
3582,,A,Early Imperial Period,8,-30,100,130,0.79892671
3582,,A,Mid-Imperial Period,9,100,300,200,0.79892671
3582,,A,Late Imperial Period,10,300,500,200,0.79892671
3583,,A,Early Iron Age,4,-1000,-750,250,0.9139697
3583,,A,Late Iron Age,5,-750,-600,150,0.9139697
3584,,A,Mid-Imperial Period,9,100,300,200,0.4600307
3585,,A,Early Imperial Period,8,-30,100,130,0.25990281
3585,,A,Mid-Imperial Period,9,100,300,200,0.25990281
3585,,A,Late Imperial Period,10,300,500,200,0.25990281
3586,,A,Early Imperial Period,8,-30,100,130,1.0971372
3586,,A,Mid-Imperial Period,9,100,300,200,1.0971372
3586,,A,Late Imperial Period,10,300,500,200,1.0971372
3587,,A,Early Imperial Period,8,-30,100,130,0.90709239
3587,,A,Mid-Imperial Period,9,100,300,200,0.90709239
3587,,A,Late Imperial Period,10,300,500,200,0.90709239
3588,,A,Archaic Period,6,-400,-350,50,0.37546182
3588,,A,Republican Period,7,-350,-30,320,0.37546182
3588,,A,Early Imperial Period,8,-30,100,130,0.37546182
3588,,A,Mid-Imperial Period,9,100,300,200,0.37546182
3588,,A,Late Imperial Period,10,300,500,200,0.37546182
3589,,A,Archaic Period,6,-400,-350,50,0.4901545
3589,,A,Republican Period,7,-350,-30,320,0.4901545
3589,,A,Early Imperial Period,8,-30,100,130,0.4901545
3589,,A,Mid-Imperial Period,9,100,300,200,0.4901545
3589,,A,Late Imperial Period,10,300,500,200,0.4901545
3590,,A,Early Imperial Period,8,-30,100,130,0.45042232
3590,,A,Mid-Imperial Period,9,100,300,200,0.45042232
3590,,A,Late Imperial Period,10,300,500,200,0.45042232
3591,,A,Early Imperial Period,8,-30,100,130,0.34309727
3591,,A,Mid-Imperial Period,9,100,300,200,0.34309727
3591,,A,Late Imperial Period,10,300,500,200,0.34309727
3592,,A,Archaic Period,6,-400,-350,50,0.36535078
3592,,A,Republican Period,7,-350,-100,250,0.36535078
3593,,A,Republican Period,7,-100,-30,70,1.0446769
3593,,A,Early Imperial Period,8,-30,100,130,1.0446769
3593,,A,Mid-Imperial Period,9,100,300,200,1.0446769
3594,,A,Archaic Period,6,-400,-350,50,0.22567908
3594,,A,Republican Period,7,-350,-30,320,0.22567908
3594,,A,Early Imperial Period,8,-30,100,130,0.22567908
3594,,A,Mid-Imperial Period,9,100,300,200,0.22567908
3594,,A,Late Imperial Period,10,300,500,200,0.22567908
3595,,A,Archaic Period,6,-400,-350,50,0.47761908
3595,,A,Republican Period,7,-350,-100,250,0.47761908
3596,,A,Archaic Period,6,-400,-350,50,0.35386318
3596,,A,Republican Period,7,-350,-100,250,0.35386318
3597,,A,Archaic Period,6,-400,-350,50,0.5040893
3597,,A,Republican Period,7,-350,-100,250,0.5040893
3598,Casale Castellaccio,A,Republican Period,7,-300,-30,270,0.844037
3598,Casale Castellaccio,A,Early Imperial Period,8,-30,100,130,0.844037
3598,Casale Castellaccio,A,Mid-Imperial Period,9,100,300,200,0.844037
3598,Casale Castellaccio,A,Late Imperial Period,10,300,500,200,0.844037
3599,,A,Archaic Period,6,-400,-350,50,0.20363781
3599,,A,Republican Period,7,-350,-100,250,0.20363781
3600,,A,Archaic Period,6,-400,-350,50,0.53476632
3600,,A,Republican Period,7,-350,-30,320,0.53476632
3600,,A,Early Imperial Period,8,-30,100,130,0.53476632
3600,,A,Mid-Imperial Period,9,100,300,200,0.53476632
3600,,A,Late Imperial Period,10,300,500,200,0.53476632
3601,,A,Republican Period,7,-300,-30,270,0.58766389
3601,,A,Early Imperial Period,8,-30,100,130,0.58766389
3601,,A,Mid-Imperial Period,9,100,300,200,0.58766389
3601,,A,Late Imperial Period,10,300,500,200,0.58766389
3602,,A,Mid-Imperial Period,9,100,300,200,0.63125914
3602,,A,Late Imperial Period,10,300,500,200,0.63125914
3603,,A,Early Imperial Period,8,-30,100,130,0.75497109
3603,,A,Mid-Imperial Period,9,100,300,200,0.75497109
3603,,A,Late Imperial Period,10,300,500,200,0.75497109
3604,,A,Early Imperial Period,8,-30,100,130,0.26144463
3604,,A,Mid-Imperial Period,9,100,300,200,0.26144463
3604,,A,Late Imperial Period,10,300,500,200,0.26144463
3605,,A,Early Imperial Period,8,-30,100,130,0.62957609
3605,,A,Mid-Imperial Period,9,100,300,200,0.62957609
3605,,A,Late Imperial Period,10,300,500,200,0.62957609
3606,,A,Early Imperial Period,8,-30,100,130,0.37410456
3606,,A,Mid-Imperial Period,9,100,300,200,0.37410456
3606,,A,Late Imperial Period,10,300,500,200,0.37410456
3607,,A,Early Imperial Period,8,-30,100,130,0.32190681
3607,,A,Mid-Imperial Period,9,100,300,200,0.32190681
3607,,A,Late Imperial Period,10,300,500,200,0.32190681
3608,,A,Archaic Period,6,-400,-350,50,0.16463266
3608,,A,Republican Period,7,-350,-100,250,0.16463266
3609,,A,Early Imperial Period,8,-30,100,130,0.28091747
3609,,A,Mid-Imperial Period,9,100,300,200,0.28091747
3609,,A,Late Imperial Period,10,300,500,200,0.28091747
3610,Poggio Picio,A,Early Imperial Period,8,-30,100,130,0.91902798
3610,Poggio Picio,A,Mid-Imperial Period,9,100,300,200,0.91902798
3610,Poggio Picio,A,Late Imperial Period,10,300,500,200,0.91902798
3611,,A,Early Imperial Period,8,-30,100,130,0.45593938
3611,,A,Mid-Imperial Period,9,100,300,200,0.45593938
3611,,A,Late Imperial Period,10,300,500,200,0.45593938
3612,,A,Archaic Period,6,-400,-350,50,0.43503043
3612,,A,Republican Period,7,-350,-100,250,0.43503043
3613,,A,Early Imperial Period,8,-30,100,130,0.87968725
3613,,A,Mid-Imperial Period,9,100,300,200,0.87968725
3613,,A,Late Imperial Period,10,300,500,200,0.87968725
3614,,A,Early Iron Age,4,-1000,-750,250,0.18129739
3614,,A,Late Iron Age,5,-750,-600,150,0.18129739
3615,,A,Early Iron Age,4,-1000,-750,250,0.18124597
3615,,A,Late Iron Age,5,-750,-600,150,0.18124597
3616,Le Rose,A,Early Imperial Period,8,-30,100,130,0.61257708
3616,Le Rose,A,Mid-Imperial Period,9,100,300,200,0.61257708
3616,Le Rose,A,Late Imperial Period,10,300,500,200,0.61257708
3617,,A,Early Imperial Period,8,-30,100,130,0.49115142
3617,,A,Mid-Imperial Period,9,100,300,200,0.49115142
3617,,A,Late Imperial Period,10,300,500,200,0.49115142
3618,,A,Early Imperial Period,8,-30,100,130,0.91323441
3618,,A,Mid-Imperial Period,9,100,300,200,0.91323441
3618,,A,Late Imperial Period,10,300,500,200,0.91323441
3619,,A,Archaic Period,6,-400,-350,50,0.59619892
3619,,A,Republican Period,7,-350,-100,250,0.59619892
3620,,A,Early Imperial Period,8,-30,100,130,0.63400847
3620,,A,Mid-Imperial Period,9,100,300,200,0.63400847
3620,,A,Late Imperial Period,10,300,500,200,0.63400847
3621,,A,Early Imperial Period,8,-30,100,130,0.44602945
3621,,A,Mid-Imperial Period,9,100,300,200,0.44602945
3621,,A,Late Imperial Period,10,300,500,200,0.44602945
3622,Pogg. lo Suligano,A,Early Imperial Period,8,-30,100,130,0.63977927
3622,Pogg. lo Suligano,A,Mid-Imperial Period,9,100,300,200,0.63977927
3622,Pogg. lo Suligano,A,Late Imperial Period,10,300,500,200,0.63977927
3623,,A,Early Imperial Period,8,-30,100,130,0.88550293
3623,,A,Mid-Imperial Period,9,100,300,200,0.88550293
3623,,A,Late Imperial Period,10,300,500,200,0.88550293
3624,Campidoglio,A,Archaic Period,6,-400,-350,50,1.2091258
3624,Campidoglio,A,Republican Period,7,-350,-30,320,1.2091258
3624,Campidoglio,A,Early Imperial Period,8,-30,100,130,1.2091258
3624,Campidoglio,A,Mid-Imperial Period,9,100,300,200,1.2091258
3624,Campidoglio,A,Late Imperial Period,10,300,500,200,1.2091258
3625,Poggio Togneca,A,Archaic Period,6,-400,-350,50,0.53074718
3625,Poggio Togneca,A,Republican Period,7,-350,-30,320,0.53074718
3625,Poggio Togneca,A,Early Imperial Period,8,-30,100,130,0.53074718
3625,Poggio Togneca,A,Mid-Imperial Period,9,100,300,200,0.53074718
3625,Poggio Togneca,A,Late Imperial Period,10,300,500,200,0.53074718
3626,,A,Early Imperial Period,8,-30,100,130,0.157563
3626,,A,Mid-Imperial Period,9,100,300,200,0.157563
3626,,A,Late Imperial Period,10,300,500,200,0.157563
3627,Sercione,A,Early Imperial Period,8,-30,100,130,1.1002867
3627,Sercione,A,Mid-Imperial Period,9,100,300,200,1.1002867
3627,Sercione,A,Late Imperial Period,10,300,500,200,1.1002867
3628,Contea Flacchia,A,Republican Period,7,-300,-30,270,1.0520154
3628,Contea Flacchia,A,Early Imperial Period,8,-30,100,130,1.0520154
3628,Contea Flacchia,A,Mid-Imperial Period,9,100,300,200,1.0520154
3628,Contea Flacchia,A,Late Imperial Period,10,300,500,200,1.0520154
3629,,A,Archaic Period,6,-400,-350,50,0.65543604
3629,,A,Republican Period,7,-350,-30,320,0.65543604
3629,,A,Early Imperial Period,8,-30,100,130,0.65543604
3629,,A,Mid-Imperial Period,9,100,300,200,0.65543604
3629,,A,Late Imperial Period,10,300,500,200,0.65543604
3630,,A,Early Imperial Period,8,-30,100,130,0.35904178
3630,,A,Mid-Imperial Period,9,100,300,200,0.35904178
3630,,A,Late Imperial Period,10,300,500,200,0.35904178
3631,,A,Early Imperial Period,8,-30,100,130,0.30313608
3631,,A,Mid-Imperial Period,9,100,300,200,0.30313608
3631,,A,Late Imperial Period,10,300,500,200,0.30313608
3632,,A,Early Imperial Period,8,-30,100,130,0.5106855
3632,,A,Mid-Imperial Period,9,100,300,200,0.5106855
3632,,A,Late Imperial Period,10,300,500,200,0.5106855
3633,,A,Archaic Period,6,-400,-350,50,0.71510422
3633,,A,Republican Period,7,-350,-100,250,0.71510422
3634,,A,Early Imperial Period,8,-30,100,130,0.7734651
3634,,A,Mid-Imperial Period,9,100,300,200,0.7734651
3634,,A,Late Imperial Period,10,300,500,200,0.7734651
3635,,A,Early Imperial Period,8,-30,100,130,0.44063097
3635,,A,Mid-Imperial Period,9,100,300,200,0.44063097
3635,,A,Late Imperial Period,10,300,500,200,0.44063097
3636,,A,Republican Period,7,-300,-30,270,0.90598953
3636,,A,Early Imperial Period,8,-30,100,130,0.90598953
3636,,A,Mid-Imperial Period,9,100,300,200,0.90598953
3636,,A,Late Imperial Period,10,300,500,200,0.90598953
3637,,A,Republican Period,7,-300,-30,270,1.5572128
3637,,A,Early Imperial Period,8,-30,100,130,1.5572128
3637,,A,Mid-Imperial Period,9,100,300,200,1.5572128
3637,,A,Late Imperial Period,10,300,500,200,1.5572128
3638,,A,Republican Period,7,-300,-30,270,1.2954206
3638,,A,Early Imperial Period,8,-30,100,130,1.2954206
3638,,A,Mid-Imperial Period,9,100,300,200,1.2954206
3638,,A,Late Imperial Period,10,300,500,200,1.2954206
3639,,A,Early Imperial Period,8,-30,100,130,0.94085521
3639,,A,Mid-Imperial Period,9,100,300,200,0.94085521
3639,,A,Late Imperial Period,10,300,500,200,0.94085521
3640,,A,Early Imperial Period,8,-30,100,130,0.58169127
3640,,A,Mid-Imperial Period,9,100,300,200,0.58169127
3640,,A,Late Imperial Period,10,300,500,200,0.58169127
3641,,A,Republican Period,7,-300,-30,270,0.99664611
3641,,A,Early Imperial Period,8,-30,100,130,0.99664611
3641,,A,Mid-Imperial Period,9,100,300,200,0.99664611
3641,,A,Late Imperial Period,10,300,500,200,0.99664611
3642,Monte Lucchetti,A,Early Iron Age,4,-1000,-750,250,0.1318277
3642,Monte Lucchetti,A,Late Iron Age,5,-750,-600,150,0.1318277
3642,Monte Lucchetti,B,Early Imperial Period,8,-30,100,130,0.1318277
3642,Monte Lucchetti,B,Mid-Imperial Period,9,100,300,200,0.1318277
3642,Monte Lucchetti,B,Late Imperial Period,10,300,500,200,0.1318277
3643,,A,Republican Period,7,-300,-30,270,1.12332
3643,,A,Early Imperial Period,8,-30,100,130,1.12332
3643,,A,Mid-Imperial Period,9,100,300,200,1.12332
3643,,A,Late Imperial Period,10,300,500,200,1.12332
3644,,A,Republican Period,7,-300,-30,270,0.74633712
3644,,A,Early Imperial Period,8,-30,100,130,0.74633712
3644,,A,Mid-Imperial Period,9,100,300,200,0.74633712
3644,,A,Late Imperial Period,10,300,500,200,0.74633712
3645,,A,Early Imperial Period,8,1,100,99,2.0165172
3645,,A,Mid-Imperial Period,9,100,300,200,2.0165172
3645,,A,Late Imperial Period,10,300,400,100,2.0165172
3646,,A,Republican Period,7,-300,-30,270,2.379741
3646,,A,Early Imperial Period,8,-30,100,130,2.379741
3646,,A,Mid-Imperial Period,9,100,300,200,2.379741
3646,,A,Late Imperial Period,10,300,500,200,2.379741
3647,,A,Early Imperial Period,8,-30,100,130,1.0752114
3647,,A,Mid-Imperial Period,9,100,300,200,1.0752114
3647,,A,Late Imperial Period,10,300,500,200,1.0752114
3648,,A,Early Imperial Period,8,-30,100,130,1.9945011
3648,,A,Mid-Imperial Period,9,100,300,200,1.9945011
3648,,A,Late Imperial Period,10,300,500,200,1.9945011
3649,,A,Republican Period,7,-300,-30,270,1.4850792
3649,,A,Early Imperial Period,8,-30,100,130,1.4850792
3649,,A,Mid-Imperial Period,9,100,300,200,1.4850792
3649,,A,Late Imperial Period,10,300,500,200,1.4850792
3650,,A,Republican Period,7,-300,-30,270,2.1733527
3650,,A,Early Imperial Period,8,-30,100,130,2.1733527
3650,,A,Mid-Imperial Period,9,100,300,200,2.1733527
3650,,A,Late Imperial Period,10,300,500,200,2.1733527
3651,,A,Republican Period,7,-300,-30,270,0.9371531
3651,,A,Early Imperial Period,8,-30,100,130,0.9371531
3651,,A,Mid-Imperial Period,9,100,300,200,0.9371531
3651,,A,Late Imperial Period,10,300,500,200,0.9371531
3652,Quartaccia,A,Republican Period,7,-300,-30,270,1.2311295
3652,Quartaccia,A,Early Imperial Period,8,-30,100,130,1.2311295
3652,Quartaccia,A,Mid-Imperial Period,9,100,300,200,1.2311295
3652,Quartaccia,A,Late Imperial Period,10,300,500,200,1.2311295
3653,,A,Early Imperial Period,8,-30,100,130,1.8062605
3653,,A,Mid-Imperial Period,9,100,300,200,1.8062605
3653,,A,Late Imperial Period,10,300,500,200,1.8062605
3654,,A,Republican Period,7,-300,-30,270,1.895545
3654,,A,Early Imperial Period,8,-30,100,130,1.895545
3654,,A,Mid-Imperial Period,9,100,300,200,1.895545
3654,,A,Late Imperial Period,10,300,500,200,1.895545
3655,,A,Early Imperial Period,8,-30,100,130,0.66877854
3655,,A,Mid-Imperial Period,9,100,300,200,0.66877854
3655,,A,Late Imperial Period,10,300,500,200,0.66877854
3656,,A,Republican Period,7,-300,-30,270,1.6925924
3656,,A,Early Imperial Period,8,-30,100,130,1.6925924
3656,,A,Mid-Imperial Period,9,100,300,200,1.6925924
3656,,A,Late Imperial Period,10,300,500,200,1.6925924
3657,,A,Archaic Period,6,-400,-350,50,1.2865388
3657,,A,Republican Period,7,-350,-100,250,1.2865388
3658,Monte Cupellaro,A,Early Imperial Period,8,-30,100,130,1.9661115
3658,Monte Cupellaro,A,Mid-Imperial Period,9,100,300,200,1.9661115
3658,Monte Cupellaro,A,Late Imperial Period,10,300,500,200,1.9661115
3659,Le Grottacce,A,Early Imperial Period,8,50,100,50,3.0978284
3659,Le Grottacce,A,Mid-Imperial Period,9,100,300,200,3.0978284
3670,Villa Maravigna,A,Republican Period,7,-300,-30,270,1.111703
3670,Villa Maravigna,A,Early Imperial Period,8,-30,100,130,1.111703
3670,Villa Maravigna,A,Mid-Imperial Period,9,100,300,200,1.111703
3670,Villa Maravigna,A,Late Imperial Period,10,300,500,200,1.111703
3671,Punton di Mare,A,Mid-Imperial Period,9,150,300,150,0.90022677
3672,Poggio Alto,A,Early Imperial Period,8,-30,100,130,1.2269282
3672,Poggio Alto,A,Mid-Imperial Period,9,100,300,200,1.2269282
3672,Poggio Alto,A,Late Imperial Period,10,300,500,200,1.2269282
3673,Fornacetta,A,Republican Period,7,-300,-30,270,1.642746
3673,Fornacetta,A,Early Imperial Period,8,-30,100,130,1.642746
3673,Fornacetta,A,Mid-Imperial Period,9,100,300,200,1.642746
3673,Fornacetta,A,Late Imperial Period,10,300,500,200,1.642746
3674,,A,Republican Period,7,-300,-30,270,0.69703615
3674,,A,Early Imperial Period,8,-30,100,130,0.69703615
3674,,A,Mid-Imperial Period,9,100,300,200,0.69703615
3674,,A,Late Imperial Period,10,300,500,200,0.69703615
3675,S. Marinella (Villa di Ulpiano),A,Early Imperial Period,8,1,100,99,7.2013097
3675,S. Marinella (Villa di Ulpiano),A,Mid-Imperial Period,9,100,300,200,7.2013097
3675,S. Marinella (Villa di Ulpiano),A,Late Imperial Period,10,300,500,200,7.2013097
3676,,A,Late Iron Age,5,-700,-580,120,1.6204841
3676,,A,Archaic Period,6,-580,-350,230,1.6204841
3676,,A,Republican Period,7,-350,-300,50,1.6204841
3677,,A,Republican Period,7,-300,-30,270,0.74662602
3677,,A,Early Imperial Period,8,-30,100,130,0.74662602
3677,,A,Mid-Imperial Period,9,100,300,200,0.74662602
3677,,A,Late Imperial Period,10,300,500,200,0.74662602
3678,S. Marinella (Castrum Novum),A,Republican Period,7,-264,-30,234,5.8885145
3678,S. Marinella (Castrum Novum),A,Early Imperial Period,8,-30,100,130,5.8885145
3678,S. Marinella (Castrum Novum),A,Mid-Imperial Period,9,100,300,200,5.8885145
3678,S. Marinella (Castrum Novum),A,Late Imperial Period,10,300,408,108,5.8885145
3679,,A,Republican Period,7,-300,-30,270,0.78889781
3679,,A,Early Imperial Period,8,-30,100,130,0.78889781
3679,,A,Mid-Imperial Period,9,100,300,200,0.78889781
3679,,A,Late Imperial Period,10,300,500,200,0.78889781
3680,,A,Early Imperial Period,8,-30,100,130,1.8959666
3680,,A,Mid-Imperial Period,9,100,200,100,1.8959666
3681,,A,Early Imperial Period,8,-30,100,130,0.54604328
3681,,A,Mid-Imperial Period,9,100,200,100,0.54604328
3682,,A,Republican Period,7,-300,-30,270,3.713273
3682,,A,Early Imperial Period,8,-30,100,130,3.713273
3682,,A,Mid-Imperial Period,9,100,300,200,3.713273
3682,,A,Late Imperial Period,10,300,500,200,3.713273
3683,,A,Archaic Period,6,-400,-350,50,0.848993
3683,,A,Republican Period,7,-350,-100,250,0.848993
3684,,A,Republican Period,7,-300,-30,270,1.9987252
3684,,A,Early Imperial Period,8,-30,100,130,1.9987252
3684,,A,Mid-Imperial Period,9,100,300,200,1.9987252
3684,,A,Late Imperial Period,10,300,500,200,1.9987252
3685,Punta della Vipera,A,Mid-Imperial Period,9,150,300,150,1.3170167
3686,,A,Early Imperial Period,8,-30,100,130,1.8391821
3686,,A,Mid-Imperial Period,9,100,300,200,1.8391821
3686,,A,Late Imperial Period,10,300,500,200,1.8391821
3687,Poggio della Castellina,A,Late Bronze Age,3,-1200,-1020,180,1.5969183
3687,Poggio della Castellina,B,Early Iron Age,4,-1020,-750,270,1.5969183
3687,Poggio della Castellina,B,Late Iron Age,5,-750,-580,170,1.5969183
3687,Poggio della Castellina,B,Archaic Period,6,-580,-350,230,1.5969183
3687,Poggio della Castellina,B,Republican Period,7,-350,-30,320,1.5969183
3687,Poggio della Castellina,B,Early Imperial Period,8,-30,100,130,1.5969183
3688,,A,Late Imperial Period,10,300,500,200,0.49917102
3689,Punta del Pecoraro,A,Early Imperial Period,8,-30,100,130,2.7043483
3689,Punta del Pecoraro,A,Mid-Imperial Period,9,100,300,200,2.7043483
3689,Punta del Pecoraro,A,Late Imperial Period,10,300,500,200,2.7043483
3690,,A,Republican Period,7,-300,-30,270,2.2315607
3690,,A,Early Imperial Period,8,-30,100,130,2.2315607
3690,,A,Mid-Imperial Period,9,100,300,200,2.2315607
3690,,A,Late Imperial Period,10,300,500,200,2.2315607
3691,Grottini,A,Early Bronze Age,1,-2300,-1700,600,0.6944806
3691,Grottini,A,Middle Bronze Age,2,-1700,-1300,400,0.6944806
3691,Grottini,A,Late Bronze Age,3,-1300,-1020,280,0.6944806
3691,Grottini,A,Early Iron Age,4,-1020,-750,270,0.6944806
3691,Grottini,A,Late Iron Age,5,-750,-600,150,0.6944806
3692,Quartaccia,A,Early Bronze Age,1,-2300,-1700,600,0.72557718
3692,Quartaccia,A,Middle Bronze Age,2,-1700,-1300,400,0.72557718
3692,Quartaccia,A,Late Bronze Age,3,-1300,-1020,280,0.72557718
3692,Quartaccia,A,Early Iron Age,4,-1020,-750,270,0.72557718
3692,Quartaccia,A,Late Iron Age,5,-750,-600,150,0.72557718
3693,Selciata,A,Early Bronze Age,1,-2300,-1700,600,0.65507728
3693,Selciata,A,Middle Bronze Age,2,-1700,-1300,400,0.65507728
3693,Selciata,A,Late Bronze Age,3,-1300,-1020,280,0.65507728
3693,Selciata,A,Early Iron Age,4,-1020,-750,270,0.65507728
3693,Selciata,A,Late Iron Age,5,-750,-600,150,0.65507728
3694,Torre Chiaruccia,A,Early Bronze Age,1,-2300,-1700,600,0.30443633
3694,Torre Chiaruccia,A,Middle Bronze Age,2,-1700,-1300,400,0.30443633
3694,Torre Chiaruccia,A,Late Bronze Age,3,-1300,-1020,280,0.30443633
3694,Torre Chiaruccia,A,Early Iron Age,4,-1020,-750,270,0.30443633
3694,Torre Chiaruccia,A,Late Iron Age,5,-750,-600,150,0.30443633
3695,Marangone,A,Early Bronze Age,1,-2300,-1700,600,0.43627512
3695,Marangone,A,Middle Bronze Age,2,-1700,-1300,400,0.43627512
3695,Marangone,A,Late Bronze Age,3,-1300,-1020,280,0.43627512
3695,Marangone,A,Early Iron Age,4,-1020,-750,270,0.43627512
3695,Marangone,A,Late Iron Age,5,-750,-600,150,0.43627512
3696,Malpasso,A,Early Bronze Age,1,-2300,-1700,600,0.43397748
3696,Malpasso,A,Middle Bronze Age,2,-1700,-1300,400,0.43397748
3696,Malpasso,A,Late Bronze Age,3,-1300,-1020,280,0.43397748
3696,Malpasso,A,Early Iron Age,4,-1020,-750,270,0.43397748
3696,Malpasso,A,Late Iron Age,5,-750,-600,150,0.43397748
3697,Punta del Pecoraro,A,Early Bronze Age,1,-2300,-1700,600,0.62422669
3697,Punta del Pecoraro,A,Middle Bronze Age,2,-1700,-1300,400,0.62422669
3697,Punta del Pecoraro,A,Late Bronze Age,3,-1300,-1020,280,0.62422669
3697,Punta del Pecoraro,A,Early Iron Age,4,-1020,-750,270,0.62422669
3697,Punta del Pecoraro,A,Late Iron Age,5,-750,-600,150,0.62422669
3698,Le Pantane,A,Republican Period,7,-300,-30,270,1.861496
3698,Le Pantane,A,Early Imperial Period,8,-30,100,130,1.861496
3698,Le Pantane,A,Mid-Imperial Period,9,100,300,200,1.861496
3698,Le Pantane,A,Late Imperial Period,10,300,500,200,1.861496
3699,,A,Republican Period,7,-300,-30,270,0.78495568
3699,,A,Early Imperial Period,8,-30,100,130,0.78495568
3699,,A,Mid-Imperial Period,9,100,300,200,0.78495568
3699,,A,Late Imperial Period,10,300,500,200,0.78495568
3700,Monte Stefano,A,Republican Period,7,-300,-30,270,0.57358164
3700,Monte Stefano,A,Early Imperial Period,8,-30,100,130,0.57358164
3700,Monte Stefano,A,Mid-Imperial Period,9,100,300,200,0.57358164
3700,Monte Stefano,A,Late Imperial Period,10,300,500,200,0.57358164
3701,,A,Republican Period,7,-300,-30,270,1.139369
3701,,A,Early Imperial Period,8,-30,100,130,1.139369
3701,,A,Mid-Imperial Period,9,100,300,200,1.139369
3701,,A,Late Imperial Period,10,300,500,200,1.139369
3702,Castellina,A,Republican Period,7,-300,-30,270,0.47295928
3702,Castellina,A,Early Imperial Period,8,-30,100,130,0.47295928
3702,Castellina,A,Mid-Imperial Period,9,100,300,200,0.47295928
3702,Castellina,A,Late Imperial Period,10,300,500,200,0.47295928
3703,,A,Republican Period,7,-200,-30,170,0.61119044
3704,Monte Raschio,A,Early Imperial Period,8,1,100,99,1.3532145
3704,Monte Raschio,A,Mid-Imperial Period,9,100,300,200,1.3532145
3704,Monte Raschio,A,Late Imperial Period,10,300,500,200,1.3532145
3705,La Crocetta,A,Republican Period,7,-100,-30,70,0.45785415
3706,,A,Mid-Imperial Period,9,100,300,200,0.66623598
3707,Pantane,A,Late Imperial Period,10,300,400,100,1.1155056
3708,,A,Republican Period,7,-300,-30,270,0.23421817
3708,,A,Early Imperial Period,8,-30,100,130,0.23421817
3708,,A,Mid-Imperial Period,9,100,300,200,0.23421817
3708,,A,Late Imperial Period,10,300,500,200,0.23421817
3709,Prato Casale,A,Republican Period,7,-300,-30,270,0.83929265
3709,Prato Casale,A,Early Imperial Period,8,-30,100,130,0.83929265
3709,Prato Casale,A,Mid-Imperial Period,9,100,300,200,0.83929265
3709,Prato Casale,A,Late Imperial Period,10,300,500,200,0.83929265
3710,Costa Campanella,A,Archaic Period,6,-400,-350,50,0.38599288
3710,Costa Campanella,A,Republican Period,7,-350,-30,320,0.38599288
3710,Costa Campanella,A,Early Imperial Period,8,-30,100,130,0.38599288
3710,Costa Campanella,A,Mid-Imperial Period,9,100,300,200,0.38599288
3710,Costa Campanella,A,Late Imperial Period,10,300,500,200,0.38599288
3711,Costa Campanella,A,Archaic Period,6,-500,-350,150,0.48703983
3711,Costa Campanella,A,Republican Period,7,-350,-30,320,0.48703983
3711,Costa Campanella,A,Early Imperial Period,8,-30,100,130,0.48703983
3711,Costa Campanella,A,Mid-Imperial Period,9,100,200,100,0.48703983
3712,S. Pietro,A,Republican Period,7,-300,-30,270,0.65390593
3712,S. Pietro,A,Early Imperial Period,8,-30,100,130,0.65390593
3712,S. Pietro,A,Mid-Imperial Period,9,100,300,200,0.65390593
3712,S. Pietro,A,Late Imperial Period,10,300,500,200,0.65390593
3713,Pianaccia,A,Early Imperial Period,8,-30,100,130,0.27727795
3713,Pianaccia,A,Mid-Imperial Period,9,100,300,200,0.27727795
3713,Pianaccia,A,Late Imperial Period,10,300,500,200,0.27727795
3714,Pianaccia,A,Early Imperial Period,8,-30,100,130,0.27728176
3714,Pianaccia,A,Mid-Imperial Period,9,100,300,200,0.27728176
3714,Pianaccia,A,Late Imperial Period,10,300,500,200,0.27728176
3715,Ponticiano,A,Republican Period,7,-300,-30,270,0.34849277
3715,Ponticiano,A,Early Imperial Period,8,-30,100,130,0.34849277
3715,Ponticiano,A,Mid-Imperial Period,9,100,300,200,0.34849277
3715,Ponticiano,A,Late Imperial Period,10,300,500,200,0.34849277
3716,Pecugliaro,A,Republican Period,7,-300,-30,270,0.29903123
3716,Pecugliaro,A,Early Imperial Period,8,-30,100,130,0.29903123
3716,Pecugliaro,A,Mid-Imperial Period,9,100,300,200,0.29903123
3716,Pecugliaro,A,Late Imperial Period,10,300,500,200,0.29903123
3717,,A,Republican Period,7,-300,-30,270,0.44136024
3717,,A,Early Imperial Period,8,-30,100,130,0.44136024
3717,,A,Mid-Imperial Period,9,100,300,200,0.44136024
3717,,A,Late Imperial Period,10,300,500,200,0.44136024
3718,Cerasolo,A,Republican Period,7,-300,-30,270,0.62639427
3718,Cerasolo,A,Early Imperial Period,8,-30,100,130,0.62639427
3718,Cerasolo,A,Mid-Imperial Period,9,100,300,200,0.62639427
3718,Cerasolo,A,Late Imperial Period,10,300,500,200,0.62639427
3719,Capo Ripa,A,Republican Period,7,-300,-30,270,0.24742661
3719,Capo Ripa,A,Early Imperial Period,8,-30,100,130,0.24742661
3719,Capo Ripa,A,Mid-Imperial Period,9,100,300,200,0.24742661
3719,Capo Ripa,A,Late Imperial Period,10,300,500,200,0.24742661
3720,Capo Ripa,A,Archaic Period,6,-500,-350,150,0.78583509
3720,Capo Ripa,A,Republican Period,7,-350,-30,320,0.78583509
3720,Capo Ripa,A,Early Imperial Period,8,-30,100,130,0.78583509
3720,Capo Ripa,A,Mid-Imperial Period,9,100,300,200,0.78583509
3720,Capo Ripa,A,Late Imperial Period,10,300,500,200,0.78583509
3721,,A,Archaic Period,6,-500,-350,150,0.35813153
3721,,A,Republican Period,7,-350,-30,320,0.35813153
3721,,A,Early Imperial Period,8,-30,100,130,0.35813153
3721,,A,Mid-Imperial Period,9,100,300,200,0.35813153
3721,,A,Late Imperial Period,10,300,500,200,0.35813153
3722,,A,Archaic Period,6,-500,-350,150,0.60667753
3722,,A,Republican Period,7,-350,-30,320,0.60667753
3722,,A,Early Imperial Period,8,-30,100,130,0.60667753
3722,,A,Mid-Imperial Period,9,100,300,200,0.60667753
3722,,A,Late Imperial Period,10,300,500,200,0.60667753
3723,,A,Archaic Period,6,-500,-350,150,0.50945079
3723,,A,Republican Period,7,-350,-30,320,0.50945079
3723,,A,Early Imperial Period,8,-30,100,130,0.50945079
3723,,A,Mid-Imperial Period,9,100,300,200,0.50945079
3723,,A,Late Imperial Period,10,300,500,200,0.50945079
3724,Corniano,A,Archaic Period,6,-500,-350,150,0.34436187
3724,Corniano,A,Republican Period,7,-350,-30,320,0.34436187
3724,Corniano,A,Early Imperial Period,8,-30,100,130,0.34436187
3724,Corniano,A,Mid-Imperial Period,9,100,300,200,0.34436187
3724,Corniano,A,Late Imperial Period,10,300,500,200,0.34436187
3725,,A,Archaic Period,6,-400,-350,50,0.33214101
3725,,A,Republican Period,7,-350,-30,320,0.33214101
3725,,A,Early Imperial Period,8,-30,100,130,0.33214101
3725,,A,Mid-Imperial Period,9,100,300,200,0.33214101
3725,,A,Late Imperial Period,10,300,500,200,0.33214101
3726,Vicus Matrini,A,Early Imperial Period,8,-30,100,130,2.8410048
3727,Muracciolo,A,Republican Period,7,-300,-30,270,0.30894431
3727,Muracciolo,A,Early Imperial Period,8,-30,100,130,0.30894431
3727,Muracciolo,A,Mid-Imperial Period,9,100,300,200,0.30894431
3727,Muracciolo,A,Late Imperial Period,10,300,500,200,0.30894431
3728,Grotte Fiorenza,A,Republican Period,7,-300,-30,270,0.58161885
3728,Grotte Fiorenza,A,Early Imperial Period,8,-30,100,130,0.58161885
3728,Grotte Fiorenza,A,Mid-Imperial Period,9,100,300,200,0.58161885
3728,Grotte Fiorenza,A,Late Imperial Period,10,300,500,200,0.58161885
3729,Poggio Spineto,A,Republican Period,7,-300,-30,270,0.44793838
3729,Poggio Spineto,A,Early Imperial Period,8,-30,100,130,0.44793838
3729,Poggio Spineto,A,Mid-Imperial Period,9,100,300,200,0.44793838
3729,Poggio Spineto,A,Late Imperial Period,10,300,500,200,0.44793838
3730,Poggio S. Benedetto,A,Republican Period,7,-300,-30,270,0.35367826
3730,Poggio S. Benedetto,A,Early Imperial Period,8,-30,100,130,0.35367826
3730,Poggio S. Benedetto,A,Mid-Imperial Period,9,100,300,200,0.35367826
3730,Poggio S. Benedetto,A,Late Imperial Period,10,300,500,200,0.35367826
3731,Poggio S. Benedetto,A,Republican Period,7,-300,-30,270,0.30444309
3731,Poggio S. Benedetto,A,Early Imperial Period,8,-30,100,130,0.30444309
3731,Poggio S. Benedetto,A,Mid-Imperial Period,9,100,300,200,0.30444309
3731,Poggio S. Benedetto,A,Late Imperial Period,10,300,500,200,0.30444309
3732,,A,Republican Period,7,-300,-30,270,0.5106743
3732,,A,Early Imperial Period,8,-30,100,130,0.5106743
3732,,A,Mid-Imperial Period,9,100,300,200,0.5106743
3732,,A,Late Imperial Period,10,300,500,200,0.5106743
3733,,A,Republican Period,7,-300,-30,270,0.46160385
3733,,A,Early Imperial Period,8,-30,100,130,0.46160385
3733,,A,Mid-Imperial Period,9,100,300,200,0.46160385
3733,,A,Late Imperial Period,10,300,500,200,0.46160385
3734,Faiano,A,Republican Period,7,-300,-30,270,0.38386378
3734,Faiano,A,Early Imperial Period,8,-30,100,130,0.38386378
3734,Faiano,A,Mid-Imperial Period,9,100,300,200,0.38386378
3734,Faiano,A,Late Imperial Period,10,300,500,200,0.38386378
3735,,A,Archaic Period,6,-500,-350,150,0.24642947
3735,,A,Republican Period,7,-350,-30,320,0.24642947
3735,,A,Early Imperial Period,8,-30,100,130,0.24642947
3735,,A,Mid-Imperial Period,9,100,300,200,0.24642947
3735,,A,Late Imperial Period,10,300,500,200,0.24642947
3736,,A,Archaic Period,6,-500,-350,150,0.24641277
3736,,A,Republican Period,7,-350,-30,320,0.24641277
3736,,A,Early Imperial Period,8,-30,100,130,0.24641277
3736,,A,Mid-Imperial Period,9,100,300,200,0.24641277
3736,,A,Late Imperial Period,10,300,500,200,0.24641277
3737,,A,Republican Period,7,-300,-30,270,0.2681945
3737,,A,Early Imperial Period,8,-30,100,130,0.2681945
3737,,A,Mid-Imperial Period,9,100,300,200,0.2681945
3737,,A,Late Imperial Period,10,300,500,200,0.2681945
3738,Oriano,A,Republican Period,7,-300,-30,270,0.27885565
3738,Oriano,A,Early Imperial Period,8,-30,100,130,0.27885565
3738,Oriano,A,Mid-Imperial Period,9,100,300,200,0.27885565
3738,Oriano,A,Late Imperial Period,10,300,500,200,0.27885565
3739,Campo Farnese,A,Republican Period,7,-300,-30,270,0.56212592
3739,Campo Farnese,A,Early Imperial Period,8,-30,100,130,0.56212592
3739,Campo Farnese,A,Mid-Imperial Period,9,100,300,200,0.56212592
3739,Campo Farnese,A,Late Imperial Period,10,300,500,200,0.56212592
3740,Pian di Colonna,A,Republican Period,7,-300,-30,270,0.29438439
3740,Pian di Colonna,A,Early Imperial Period,8,-30,100,130,0.29438439
3740,Pian di Colonna,A,Mid-Imperial Period,9,100,300,200,0.29438439
3740,Pian di Colonna,A,Late Imperial Period,10,300,500,200,0.29438439
3741,,A,Republican Period,7,-300,-30,270,1.6622883
3741,,A,Early Imperial Period,8,-30,100,130,1.6622883
3741,,A,Mid-Imperial Period,9,100,300,200,1.6622883
3741,,A,Late Imperial Period,10,300,500,200,1.6622883
3742,,A,Republican Period,7,-300,-30,270,0.3191919
3742,,A,Early Imperial Period,8,-30,100,130,0.3191919
3742,,A,Mid-Imperial Period,9,100,300,200,0.3191919
3742,,A,Late Imperial Period,10,300,500,200,0.3191919
3743,,A,Republican Period,7,-300,-30,270,0.47701669
3743,,A,Early Imperial Period,8,-30,100,130,0.47701669
3743,,A,Mid-Imperial Period,9,100,300,200,0.47701669
3743,,A,Late Imperial Period,10,300,500,200,0.47701669
3744,,A,Archaic Period,6,-500,-350,150,0.6699788
3744,,A,Republican Period,7,-350,-30,320,0.6699788
3744,,A,Early Imperial Period,8,-30,100,130,0.6699788
3744,,A,Mid-Imperial Period,9,100,300,200,0.6699788
3744,,A,Late Imperial Period,10,300,500,200,0.6699788
3745,,A,Archaic Period,6,-500,-350,150,0.66998184
3745,,A,Republican Period,7,-350,-30,320,0.66998184
3745,,A,Early Imperial Period,8,-30,100,130,0.66998184
3745,,A,Mid-Imperial Period,9,100,300,200,0.66998184
3745,,A,Late Imperial Period,10,300,500,200,0.66998184
3746,,A,Republican Period,7,-300,-30,270,0.4509061
3746,,A,Early Imperial Period,8,-30,100,130,0.4509061
3746,,A,Mid-Imperial Period,9,100,300,200,0.4509061
3746,,A,Late Imperial Period,10,300,500,200,0.4509061
3747,Campo delle Macine,A,Republican Period,7,-300,-30,270,0.94165832
3747,Campo delle Macine,A,Early Imperial Period,8,-30,100,130,0.94165832
3747,Campo delle Macine,A,Mid-Imperial Period,9,100,300,200,0.94165832
3747,Campo delle Macine,A,Late Imperial Period,10,300,500,200,0.94165832
3748,,A,Archaic Period,6,-500,-350,150,0.99082941
3748,,A,Republican Period,7,-350,-30,320,0.99082941
3748,,A,Early Imperial Period,8,-30,100,130,0.99082941
3748,,A,Mid-Imperial Period,9,100,300,200,0.99082941
3748,,A,Late Imperial Period,10,300,500,200,0.99082941
3749,,A,Republican Period,7,-300,-30,270,1.0612136
3749,,A,Early Imperial Period,8,-30,100,130,1.0612136
3749,,A,Mid-Imperial Period,9,100,300,200,1.0612136
3749,,A,Late Imperial Period,10,300,500,200,1.0612136
3750,,A,Early Imperial Period,8,-30,100,130,0.28107932
3750,,A,Mid-Imperial Period,9,100,300,200,0.28107932
3750,,A,Late Imperial Period,10,300,500,200,0.28107932
3751,,A,Early Imperial Period,8,-30,100,130,0.19599564
3751,,A,Mid-Imperial Period,9,100,300,200,0.19599564
3751,,A,Late Imperial Period,10,300,500,200,0.19599564
3752,,A,Early Imperial Period,8,-30,100,130,2.7923625
3752,,A,Mid-Imperial Period,9,100,300,200,2.7923625
3752,,A,Late Imperial Period,10,300,500,200,2.7923625
3753,,A,Republican Period,7,-300,-30,270,0.91516709
3753,,A,Early Imperial Period,8,-30,100,130,0.91516709
3753,,A,Mid-Imperial Period,9,100,300,200,0.91516709
3753,,A,Late Imperial Period,10,300,500,200,0.91516709
3754,pianoro Quarticciolo,A,Republican Period,7,-300,-30,270,8.2175045
3754,pianoro Quarticciolo,A,Early Imperial Period,8,-30,100,130,8.2175045
3754,pianoro Quarticciolo,A,Mid-Imperial Period,9,100,300,200,8.2175045
3754,pianoro Quarticciolo,A,Late Imperial Period,10,300,500,200,8.2175045
3755,,A,Republican Period,7,-300,-30,270,0.68398309
3755,,A,Early Imperial Period,8,-30,100,130,0.68398309
3755,,A,Mid-Imperial Period,9,100,300,200,0.68398309
3755,,A,Late Imperial Period,10,300,500,200,0.68398309
3756,,A,Archaic Period,6,-400,-350,50,0.19304916
3756,,A,Republican Period,7,-350,-100,250,0.19304916
3757,,A,Republican Period,7,-300,-30,270,0.28214005
3757,,A,Early Imperial Period,8,-30,100,130,0.28214005
3757,,A,Mid-Imperial Period,9,100,300,200,0.28214005
3757,,A,Late Imperial Period,10,300,500,200,0.28214005
3758,,A,Late Iron Age,5,-600,-580,20,2.5164597
3758,,A,Archaic Period,6,-580,-350,230,2.5164597
3758,,A,Republican Period,7,-350,-30,320,2.5164597
3758,,A,Early Imperial Period,8,-30,100,130,2.5164597
3758,,A,Mid-Imperial Period,9,100,300,200,2.5164597
3758,,A,Late Imperial Period,10,300,500,200,2.5164597
3759,,A,Republican Period,7,-200,-30,170,0.24127845
3760,,A,Republican Period,7,-200,-30,170,0.24128225
3761,,A,Republican Period,7,-200,-30,170,0.562666
3762,,A,Republican Period,7,-200,-30,170,0.18836205
3763,,A,Republican Period,7,-200,-30,170,0.18836181
3764,,A,Republican Period,7,-200,-30,170,0.18816271
3765,,A,Republican Period,7,-300,-30,270,0.4532586
3765,,A,Early Imperial Period,8,-30,100,130,0.4532586
3765,,A,Mid-Imperial Period,9,100,300,200,0.4532586
3765,,A,Late Imperial Period,10,300,500,200,0.4532586
3766,,A,Republican Period,7,-200,-30,170,0.28185371
3767,,A,Republican Period,7,-200,-30,170,0.42001712
3768,,A,Republican Period,7,-200,-30,170,0.31171858
3769,,A,Early Imperial Period,8,-30,100,130,0.50726944
3769,,A,Mid-Imperial Period,9,100,300,200,0.50726944
3769,,A,Late Imperial Period,10,300,500,200,0.50726944
3770,,A,Republican Period,7,-200,-30,170,0.23567554
3771,,A,Republican Period,7,-200,-30,170,1.3151766
3772,Sughereto,A,Republican Period,7,-200,-30,170,0.46843204
3773,Sughereto,A,Republican Period,7,-200,-30,170,0.4684121
3774,,A,Republican Period,7,-200,-30,170,0.29869261
3775,,A,Republican Period,7,-200,-30,170,0.30511698
3776,,A,Republican Period,7,-200,-30,170,0.1328968
3777,,A,Early Imperial Period,8,-30,100,130,0.49664938
3777,,A,Mid-Imperial Period,9,100,300,200,0.49664938
3777,,A,Late Imperial Period,10,300,500,200,0.49664938
3778,,A,Republican Period,7,-200,-30,170,0.35275766
3779,,A,Archaic Period,6,-400,-350,50,0.2790924
3779,,A,Republican Period,7,-350,-30,320,0.2790924
3780,,A,Republican Period,7,-200,-30,170,0.36782032
3781,,A,Archaic Period,6,-400,-350,50,0.65086448
3781,,A,Republican Period,7,-350,-30,320,0.65086448
3782,S. Lazzaro,A,Republican Period,7,-200,-30,170,0.17535579
3783,,A,Republican Period,7,-200,-30,170,0.25109127
3784,,A,Republican Period,7,-200,-30,170,0.22059852
3785,S. Lazzaro,A,Republican Period,7,-200,-30,170,0.27392578
3786,S. Lazzaro,A,Republican Period,7,-200,-30,170,0.18475816
3787,S. Lazzaro,A,Archaic Period,6,-400,-350,50,0.14572379
3787,S. Lazzaro,A,Republican Period,7,-350,-30,320,0.14572379
3788,Piantata,A,Republican Period,7,-200,-30,170,0.40284535
3789,,A,Republican Period,7,-200,-30,170,0.28084037
3790,,A,Early Imperial Period,8,-30,100,130,0.30391383
3790,,A,Mid-Imperial Period,9,100,300,200,0.30391383
3790,,A,Late Imperial Period,10,300,500,200,0.30391383
3791,,A,Republican Period,7,-200,-30,170,0.18001845
3792,,A,Early Imperial Period,8,-30,100,130,0.82707113
3792,,A,Mid-Imperial Period,9,100,300,200,0.82707113
3792,,A,Late Imperial Period,10,300,500,200,0.82707113
3793,,A,Republican Period,7,-200,-30,170,0.95614851
3794,S. Lazzaro,A,Archaic Period,6,-400,-350,50,0.98854065
3794,S. Lazzaro,A,Republican Period,7,-350,-30,320,0.98854065
3795,S. Lazzaro,A,Republican Period,7,-200,-30,170,0.33186847
3796,S. Lazzaro,A,Republican Period,7,-200,-30,170,0.33185503
3797,,A,Republican Period,7,-200,-30,170,1.4425575
3798,,A,Early Imperial Period,8,-30,100,130,1.9931902
3798,,A,Mid-Imperial Period,9,100,300,200,1.9931902
3798,,A,Late Imperial Period,10,300,500,200,1.9931902
3799,,A,Republican Period,7,-200,-30,170,0.23224263
3800,,A,Republican Period,7,-200,-30,170,0.50972986
3801,S. Lazzaro,A,Archaic Period,6,-400,-350,50,1.9501766
3801,S. Lazzaro,A,Republican Period,7,-350,-30,320,1.9501766
3801,S. Lazzaro,A,Early Imperial Period,8,-30,100,130,1.9501766
3801,S. Lazzaro,A,Mid-Imperial Period,9,100,300,200,1.9501766
3801,S. Lazzaro,A,Late Imperial Period,10,300,500,200,1.9501766
3802,S. Lazzaro,A,Archaic Period,6,-400,-350,50,1.5620116
3802,S. Lazzaro,A,Republican Period,7,-350,-30,320,1.5620116
3802,S. Lazzaro,A,Early Imperial Period,8,-30,100,130,1.5620116
3802,S. Lazzaro,A,Mid-Imperial Period,9,100,300,200,1.5620116
3802,S. Lazzaro,A,Late Imperial Period,10,300,500,200,1.5620116
3803,S. Lazzaro,A,Republican Period,7,-200,-30,170,0.2302388
3804,S. Lazzaro,A,Republican Period,7,-200,-30,170,0.23024441
3805,S. Lazzaro,A,Republican Period,7,-200,-30,170,0.23023798
3806,,A,Archaic Period,6,-400,-350,50,0.28436062
3806,,A,Republican Period,7,-350,-30,320,0.28436062
3807,,A,Republican Period,7,-200,-30,170,0.15792379
3808,S. Lazzaro,A,Republican Period,7,-200,-30,170,0.12764713
3809,S. Lazzaro,A,Early Imperial Period,8,-30,100,130,0.17988475
3809,S. Lazzaro,A,Mid-Imperial Period,9,100,300,200,0.17988475
3809,S. Lazzaro,A,Late Imperial Period,10,300,500,200,0.17988475
3810,S. Lazzaro,A,Archaic Period,6,-400,-350,50,0.14694405
3810,S. Lazzaro,A,Republican Period,7,-350,-30,320,0.14694405
3811,S. Lazzaro,A,Republican Period,7,-200,-30,170,0.10058396
3812,S. Lazzaro,A,Early Imperial Period,8,-30,100,130,0.12431701
3812,S. Lazzaro,A,Mid-Imperial Period,9,100,300,200,0.12431701
3812,S. Lazzaro,A,Late Imperial Period,10,300,500,200,0.12431701
3813,S. Lazzaro,A,Early Imperial Period,8,-30,100,130,0.31094891
3813,S. Lazzaro,A,Mid-Imperial Period,9,100,300,200,0.31094891
3813,S. Lazzaro,A,Late Imperial Period,10,300,500,200,0.31094891
3814,,A,Republican Period,7,-200,-30,170,0.38989681
3815,,A,Archaic Period,6,-400,-350,50,0.59706676
3815,,A,Republican Period,7,-350,-30,320,0.59706676
3816,,A,Late Iron Age,5,-600,-580,20,0.20626409
3816,,A,Archaic Period,6,-580,-500,80,0.20626409
3817,,A,Republican Period,7,-200,-30,170,0.23598477
3818,,A,Early Imperial Period,8,-30,100,130,0.32733977
3818,,A,Mid-Imperial Period,9,100,300,200,0.32733977
3818,,A,Late Imperial Period,10,300,500,200,0.32733977
3819,,A,Early Imperial Period,8,-30,100,130,0.74515367
3819,,A,Mid-Imperial Period,9,100,300,200,0.74515367
3819,,A,Late Imperial Period,10,300,500,200,0.74515367
3820,,A,Republican Period,7,-200,-30,170,0.54732591
3821,,A,Early Imperial Period,8,-30,100,130,0.60453355
3821,,A,Mid-Imperial Period,9,100,300,200,0.60453355
3821,,A,Late Imperial Period,10,300,500,200,0.60453355
3822,,A,Republican Period,7,-200,-30,170,0.73222935
3823,,A,Archaic Period,6,-400,-350,50,0.66346639
3823,,A,Republican Period,7,-350,-30,320,0.66346639
3823,,A,Early Imperial Period,8,-30,100,130,0.66346639
3823,,A,Mid-Imperial Period,9,100,300,200,0.66346639
3823,,A,Late Imperial Period,10,300,500,200,0.66346639
3824,,A,Republican Period,7,-200,-30,170,0.26177126
3825,,A,Republican Period,7,-200,-30,170,0.2617583
3826,,A,Republican Period,7,-200,-30,170,0.20487486
3827,S. Angelo,A,Republican Period,7,-200,-30,170,0.31657302
3828,S. Angelo,A,Republican Period,7,-200,-30,170,2.0305238
3828,S. Angelo,A,Early Imperial Period,8,-30,100,130,2.0305238
3828,S. Angelo,A,Mid-Imperial Period,9,100,300,200,2.0305238
3828,S. Angelo,A,Late Imperial Period,10,300,500,200,2.0305238
3829,,A,Republican Period,7,-300,-30,270,3.8820214
3829,,A,Early Imperial Period,8,-30,100,130,3.8820214
3829,,A,Mid-Imperial Period,9,100,300,200,3.8820214
3829,,A,Late Imperial Period,10,300,500,200,3.8820214
3830,Le Guinze,A,Republican Period,7,-200,-30,170,0.47280806
3830,Le Guinze,A,Early Imperial Period,8,-30,100,130,0.47280806
3830,Le Guinze,A,Mid-Imperial Period,9,100,300,200,0.47280806
3830,Le Guinze,A,Late Imperial Period,10,300,500,200,0.47280806
3831,Le Guinze,A,Republican Period,7,-200,-30,170,3.7536123
3831,Le Guinze,A,Early Imperial Period,8,-30,100,130,3.7536123
3831,Le Guinze,A,Mid-Imperial Period,9,100,300,200,3.7536123
3831,Le Guinze,A,Late Imperial Period,10,300,500,200,3.7536123
3832,Le Guinze,A,Republican Period,7,-300,-30,270,1.1695513
3832,Le Guinze,A,Early Imperial Period,8,-30,100,130,1.1695513
3832,Le Guinze,A,Mid-Imperial Period,9,100,300,200,1.1695513
3832,Le Guinze,A,Late Imperial Period,10,300,500,200,1.1695513
3833,,A,Republican Period,7,-200,-30,170,0.58012766
3834,,A,Republican Period,7,-200,-30,170,0.5800848
3835,,A,Archaic Period,6,-400,-350,50,0.29623064
3835,,A,Republican Period,7,-350,-30,320,0.29623064
3836,,A,Republican Period,7,-200,-30,170,0.97023457
3837,,A,Republican Period,7,-200,-30,170,0.18268681
3838,,A,Republican Period,7,-200,-30,170,0.18268017
3839,,A,Republican Period,7,-200,-30,170,0.18267415
3840,,A,Republican Period,7,-200,-30,170,0.18266517
3841,Sughereto,A,Republican Period,7,-200,-30,170,0.80156845
3842,,A,Archaic Period,6,-400,-350,50,0.56511867
3842,,A,Republican Period,7,-350,-30,320,0.56511867
3842,,A,Early Imperial Period,8,-30,100,130,0.56511867
3842,,A,Mid-Imperial Period,9,100,300,200,0.56511867
3842,,A,Late Imperial Period,10,300,500,200,0.56511867
3843,,A,Archaic Period,6,-400,-350,50,1.903324
3843,,A,Republican Period,7,-350,-30,320,1.903324
3843,,A,Early Imperial Period,8,-30,100,130,1.903324
3843,,A,Mid-Imperial Period,9,100,300,200,1.903324
3843,,A,Late Imperial Period,10,300,500,200,1.903324
3844,,A,Republican Period,7,-200,-30,170,0.69459087
3845,,A,Early Imperial Period,8,-30,100,130,1.1150357
3845,,A,Mid-Imperial Period,9,100,300,200,1.1150357
3845,,A,Late Imperial Period,10,300,500,200,1.1150357
3846,,A,Republican Period,7,-200,-30,170,0.21776886
3847,,A,Archaic Period,6,-400,-350,50,1.7652006
3847,,A,Republican Period,7,-350,-30,320,1.7652006
3847,,A,Early Imperial Period,8,-30,100,130,1.7652006
3847,,A,Mid-Imperial Period,9,100,300,200,1.7652006
3847,,A,Late Imperial Period,10,300,500,200,1.7652006
3848,,A,Republican Period,7,-200,-30,170,0.3942793
3849,,A,Republican Period,7,-200,-30,170,0.39426574
3850,,A,Republican Period,7,-200,-30,170,1.6107178
3850,,A,Early Imperial Period,8,-30,100,130,1.6107178
3850,,A,Mid-Imperial Period,9,100,300,200,1.6107178
3850,,A,Late Imperial Period,10,300,500,200,1.6107178
3851,,A,Republican Period,7,-200,-30,170,0.49669334
3852,,A,Archaic Period,6,-400,-350,50,3.9391997
3852,,A,Republican Period,7,-350,-30,320,3.9391997
3852,,A,Early Imperial Period,8,-30,100,130,3.9391997
3852,,A,Mid-Imperial Period,9,100,300,200,3.9391997
3852,,A,Late Imperial Period,10,300,500,200,3.9391997
3853,,A,Republican Period,7,-200,-30,170,0.59464264
3854,,A,Early Imperial Period,8,-30,100,130,0.85138971
3854,,A,Mid-Imperial Period,9,100,300,200,0.85138971
3854,,A,Late Imperial Period,10,300,500,200,0.85138971
3855,,A,Republican Period,7,-200,-30,170,0.63939244
3856,,A,Archaic Period,6,-400,-350,50,1.1466223
3856,,A,Republican Period,7,-350,-30,320,1.1466223
3857,,A,Early Imperial Period,8,-30,100,130,0.13257317
3857,,A,Mid-Imperial Period,9,100,300,200,0.13257317
3857,,A,Late Imperial Period,10,300,500,200,0.13257317
3858,,A,Republican Period,7,-200,-30,170,0.59324431
3859,,A,Republican Period,7,-200,-30,170,0.17025618
3860,,A,Republican Period,7,-200,-30,170,0.86689156
3860,,A,Early Imperial Period,8,-30,100,130,0.86689156
3860,,A,Mid-Imperial Period,9,100,300,200,0.86689156
3860,,A,Late Imperial Period,10,300,500,200,0.86689156
3861,,A,Early Imperial Period,8,-30,100,130,0.27753788
3861,,A,Mid-Imperial Period,9,100,300,200,0.27753788
3861,,A,Late Imperial Period,10,300,500,200,0.27753788
3862,,A,Republican Period,7,-200,-30,170,0.28285706
3863,,A,Republican Period,7,-200,-30,170,0.28284436
3864,,A,Early Imperial Period,8,-30,100,130,1.6682487
3864,,A,Mid-Imperial Period,9,100,300,200,1.6682487
3864,,A,Late Imperial Period,10,300,500,200,1.6682487
3865,Pian di Mola,A,Republican Period,7,-300,-30,270,2.2026329
3865,Pian di Mola,A,Early Imperial Period,8,-30,100,130,2.2026329
3865,Pian di Mola,A,Mid-Imperial Period,9,100,300,200,2.2026329
3865,Pian di Mola,A,Late Imperial Period,10,300,500,200,2.2026329
3866,,A,Republican Period,7,-200,-30,170,0.21288255
3867,,A,Republican Period,7,-200,-30,170,0.2128801
3868,,A,Late Iron Age,5,-600,-580,20,0.14547135
3868,,A,Archaic Period,6,-580,-500,80,0.14547135
3869,,A,Republican Period,7,-200,-30,170,0.20401514
3870,,A,Republican Period,7,-200,-30,170,0.20401049
3871,,A,Republican Period,7,-200,-30,170,0.20400567
3872,,A,Archaic Period,6,-400,-350,50,0.20400122
3872,,A,Republican Period,7,-350,-30,320,0.20400122
3873,,A,Archaic Period,6,-400,-350,50,0.15565744
3873,,A,Republican Period,7,-350,-30,320,0.15565744
3874,,A,Archaic Period,6,-400,-350,50,0.15565524
3874,,A,Republican Period,7,-350,-30,320,0.15565524
3875,,A,Republican Period,7,-200,-30,170,0.46691206
3876,,A,Republican Period,7,-200,-30,170,0.46689901
3877,,A,Republican Period,7,-200,-30,170,0.63578361
3878,,A,Early Imperial Period,8,-30,100,130,0.34422132
3878,,A,Mid-Imperial Period,9,100,300,200,0.34422132
3878,,A,Late Imperial Period,10,300,500,200,0.34422132
3879,,A,Early Imperial Period,8,-30,100,130,0.1468236
3879,,A,Mid-Imperial Period,9,100,300,200,0.1468236
3879,,A,Late Imperial Period,10,300,500,200,0.1468236
3880,,A,Early Imperial Period,8,-30,100,130,0.14682171
3880,,A,Mid-Imperial Period,9,100,300,200,0.14682171
3880,,A,Late Imperial Period,10,300,500,200,0.14682171
3881,,A,Early Imperial Period,8,-30,100,130,0.14681995
3881,,A,Mid-Imperial Period,9,100,300,200,0.14681995
3881,,A,Late Imperial Period,10,300,500,200,0.14681995
3882,,A,Republican Period,7,-200,-30,170,0.59521961
3883,,A,Archaic Period,6,-400,-350,50,0.17031822
3883,,A,Republican Period,7,-350,-30,320,0.17031822
3884,,A,Republican Period,7,-200,-30,170,0.12829147
3885,,A,Archaic Period,6,-400,-350,50,0.17031203
3885,,A,Republican Period,7,-350,-30,320,0.17031203
3886,,A,Archaic Period,6,-400,-350,50,0.17030405
3886,,A,Republican Period,7,-350,-30,320,0.17030405
3887,,A,Republican Period,7,-200,-30,170,0.17030792
3888,,A,Republican Period,7,-200,-30,170,0.17030676
3889,,A,Republican Period,7,-200,-30,170,0.17030555
3890,,A,Republican Period,7,-200,-30,170,0.17030028
3891,,A,Republican Period,7,-200,-30,170,0.17030132
3892,,A,Archaic Period,6,-400,-350,50,0.17029738
3892,,A,Republican Period,7,-350,-30,320,0.17029738
3893,,A,Republican Period,7,-200,-30,170,0.17029734
3894,,A,Republican Period,7,-200,-30,170,0.17029713
3895,,A,Early Imperial Period,8,-30,100,130,0.2084453
3895,,A,Mid-Imperial Period,9,100,300,200,0.2084453
3895,,A,Late Imperial Period,10,300,500,200,0.2084453
3896,Castelluccia,A,Archaic Period,6,-400,-350,50,6.1202116
3896,Castelluccia,A,Republican Period,7,-350,-30,320,6.1202116
3897,,A,Early Imperial Period,8,-30,100,130,0.17073151
3897,,A,Mid-Imperial Period,9,100,300,200,0.17073151
3897,,A,Late Imperial Period,10,300,500,200,0.17073151
3898,,A,Early Imperial Period,8,-30,100,130,0.17072849
3898,,A,Mid-Imperial Period,9,100,300,200,0.17072849
3898,,A,Late Imperial Period,10,300,500,200,0.17072849
3899,,A,Early Imperial Period,8,-30,100,130,0.39952317
3899,,A,Mid-Imperial Period,9,100,300,200,0.39952317
3899,,A,Late Imperial Period,10,300,500,200,0.39952317
3900,,A,Late Iron Age,5,-600,-580,20,0.21195407
3900,,A,Archaic Period,6,-580,-500,80,0.21195407
3901,,A,Early Imperial Period,8,-30,100,130,1.1673911
3901,,A,Mid-Imperial Period,9,100,300,200,1.1673911
3901,,A,Late Imperial Period,10,300,500,200,1.1673911
3902,,A,Republican Period,7,-200,-30,170,0.22078921
3903,,A,Early Imperial Period,8,-30,100,130,0.46953198
3903,,A,Mid-Imperial Period,9,100,300,200,0.46953198
3903,,A,Late Imperial Period,10,300,500,200,0.46953198
3904,,A,Republican Period,7,-200,-30,170,0.33251798
3905,,A,Archaic Period,6,-400,-350,50,0.20796347
3905,,A,Republican Period,7,-350,-30,320,0.20796347
3906,,A,Archaic Period,6,-400,-350,50,0.20796619
3906,,A,Republican Period,7,-350,-30,320,0.20796619
3907,,A,Early Imperial Period,8,-30,100,130,0.20618509
3907,,A,Mid-Imperial Period,9,100,300,200,0.20618509
3907,,A,Late Imperial Period,10,300,500,200,0.20618509
3908,Prato Lungo,A,Republican Period,7,-200,-30,170,0.20139998
3910,Prato Lungo,A,Early Imperial Period,8,-30,100,130,0.31245479
3910,Prato Lungo,A,Mid-Imperial Period,9,100,300,200,0.31245479
3910,Prato Lungo,A,Late Imperial Period,10,300,500,200,0.31245479
3911,Prato Lungo,A,Republican Period,7,-200,-30,170,0.28195417
3912,Prato Lungo,A,Early Imperial Period,8,-30,100,130,0.25612804
3912,Prato Lungo,A,Mid-Imperial Period,9,100,300,200,0.25612804
3912,Prato Lungo,A,Late Imperial Period,10,300,500,200,0.25612804
3913,Prato Lungo,A,Early Imperial Period,8,-30,100,130,0.33659548
3913,Prato Lungo,A,Mid-Imperial Period,9,100,300,200,0.33659548
3913,Prato Lungo,A,Late Imperial Period,10,300,500,200,0.33659548
3914,Prato Lungo,A,Republican Period,7,-200,-30,170,0.21567683
3915,Prato Lungo,A,Republican Period,7,-200,-30,170,0.21568152
3916,Prato Lungo,A,Archaic Period,6,-400,-350,50,0.15505663
3916,Prato Lungo,A,Republican Period,7,-350,-30,320,0.15505663
3917,,A,Archaic Period,6,-400,-350,50,0.26214015
3917,,A,Republican Period,7,-350,-30,320,0.26214015
3918,,A,Republican Period,7,-200,-30,170,0.14370839
3919,La Lega,A,Republican Period,7,-200,-30,170,0.39297593
3920,,A,Early Imperial Period,8,-30,100,130,0.22443072
3920,,A,Mid-Imperial Period,9,100,300,200,0.22443072
3920,,A,Late Imperial Period,10,300,500,200,0.22443072
3921,,A,Republican Period,7,-200,-30,170,0.16454963
3922,,A,Republican Period,7,-200,-30,170,0.16454662
3923,,A,Republican Period,7,-200,-30,170,0.16454987
3924,,A,Archaic Period,6,-400,-350,50,1.8813344
3924,,A,Republican Period,7,-350,-30,320,1.8813344
3924,,A,Early Imperial Period,8,-30,100,130,1.8813344
3924,,A,Mid-Imperial Period,9,100,300,200,1.8813344
3924,,A,Late Imperial Period,10,300,500,200,1.8813344
3925,,A,Republican Period,7,-200,-30,170,0.29759645
3926,,A,Republican Period,7,-200,-30,170,0.29758859
3927,,A,Republican Period,7,-200,-30,170,0.2975862
3928,,A,Republican Period,7,-200,-30,170,0.29757956
3929,,A,Republican Period,7,-200,-30,170,0.29757446
3930,,A,Republican Period,7,-200,-30,170,0.29757577
3931,,A,Republican Period,7,-200,-30,170,0.29749909
3932,,A,Archaic Period,6,-400,-350,50,0.18621725
3932,,A,Republican Period,7,-350,-30,320,0.18621725
3933,,A,Republican Period,7,-200,-30,170,0.26555732
3934,,A,Archaic Period,6,-400,-350,50,0.23939602
3934,,A,Republican Period,7,-350,-30,320,0.23939602
3935,,A,Archaic Period,6,-400,-350,50,0.23938972
3935,,A,Republican Period,7,-350,-30,320,0.23938972
3936,,A,Archaic Period,6,-400,-350,50,0.2745685
3936,,A,Republican Period,7,-350,-30,320,0.2745685
3937,,A,Early Imperial Period,8,-30,100,130,0.41602519
3937,,A,Mid-Imperial Period,9,100,300,200,0.41602519
3937,,A,Late Imperial Period,10,300,500,200,0.41602519
3938,,A,Archaic Period,6,-400,-350,50,0.3406477
3938,,A,Republican Period,7,-350,-30,320,0.3406477
3939,Comunella,A,Republican Period,7,-200,-30,170,0.4936955
3940,Campo Gallo,A,Republican Period,7,-200,-30,170,2.7951462
3941,Campo Gallo,A,Archaic Period,6,-400,-350,50,0.42409092
3941,Campo Gallo,A,Republican Period,7,-350,-30,320,0.42409092
3942,Buon Giorno,A,Archaic Period,6,-400,-350,50,0.23999435
3942,Buon Giorno,A,Republican Period,7,-350,-30,320,0.23999435
3943,Buon Giorno,A,Archaic Period,6,-400,-350,50,0.24000108
3943,Buon Giorno,A,Republican Period,7,-350,-30,320,0.24000108
3944,Buon Giorno,A,Republican Period,7,-200,-30,170,0.65391475
3945,Buon Giorno,A,Archaic Period,6,-400,-350,50,0.24000733
3945,Buon Giorno,A,Republican Period,7,-350,-30,320,0.24000733
3946,Buon Giorno,A,Archaic Period,6,-400,-350,50,0.24000862
3946,Buon Giorno,A,Republican Period,7,-350,-30,320,0.24000862
3947,Buon Giorno,A,Archaic Period,6,-400,-350,50,0.23999847
3947,Buon Giorno,A,Republican Period,7,-350,-30,320,0.23999847
3948,Buon Giorno,A,Republican Period,7,-200,-30,170,0.4804613
3949,Sassicheta,A,Republican Period,7,-200,-30,170,0.3234278
3950,Sassicheta,A,Republican Period,7,-200,-30,170,0.32343403
3951,Sassicheta,A,Archaic Period,6,-400,-350,50,0.23692341
3951,Sassicheta,A,Republican Period,7,-350,-30,320,0.23692341
3952,Buon Giorno,A,Republican Period,7,-200,-30,170,0.26353171
3953,Buon Giorno,A,Archaic Period,6,-400,-350,50,0.36068439
3953,Buon Giorno,A,Republican Period,7,-350,-30,320,0.36068439
3954,Buon Giorno,A,Archaic Period,6,-400,-350,50,0.3607102
3954,Buon Giorno,A,Republican Period,7,-350,-30,320,0.3607102
3955,Pagano,A,Archaic Period,6,-400,-350,50,0.143766
3955,Pagano,A,Republican Period,7,-350,-30,320,0.143766
3956,Pagano,A,Archaic Period,6,-400,-350,50,0.14376597
3956,Pagano,A,Republican Period,7,-350,-30,320,0.14376597
3957,,A,Archaic Period,6,-400,-350,50,0.14376588
3957,,A,Republican Period,7,-350,-30,320,0.14376588
3958,,A,Republican Period,7,-200,-30,170,0.2799888
3959,,A,Archaic Period,6,-400,-350,50,0.24317293
3959,,A,Republican Period,7,-350,-30,320,0.24317293
3960,,A,Archaic Period,6,-400,-350,50,0.24317683
3960,,A,Republican Period,7,-350,-30,320,0.24317683
3961,,A,Archaic Period,6,-400,-350,50,0.24318635
3961,,A,Republican Period,7,-350,-30,320,0.24318635
3962,,A,Republican Period,7,-200,-30,170,0.24051934
3963,,A,Republican Period,7,-200,-30,170,0.24052565
3964,,A,Archaic Period,6,-400,-350,50,0.31152987
3964,,A,Republican Period,7,-350,-30,320,0.31152987
3965,Campo Villano,A,Republican Period,7,-200,-30,170,0.27737728
3966,Campo Villano,A,Republican Period,7,-300,-30,270,0.77220947
3967,Campo Villano,A,Archaic Period,6,-400,-350,50,0.27649444
3967,Campo Villano,A,Republican Period,7,-350,-30,320,0.27649444
3968,Campo Villano,A,Archaic Period,6,-400,-350,50,0.23389824
3968,Campo Villano,A,Republican Period,7,-350,-30,320,0.23389824
3969,Campo Villano,A,Republican Period,7,-200,-30,170,0.63382882
3970,Campo Spilla,A,Archaic Period,6,-400,-350,50,0.23821439
3970,Campo Spilla,A,Republican Period,7,-350,-30,320,0.23821439
3971,Campo Spilla,A,Archaic Period,6,-400,-350,50,0.23821807
3971,Campo Spilla,A,Republican Period,7,-350,-30,320,0.23821807
3972,Campo Spilla,A,Archaic Period,6,-400,-350,50,0.23822179
3972,Campo Spilla,A,Republican Period,7,-350,-30,320,0.23822179
3973,Campo Spilla,A,Archaic Period,6,-400,-350,50,0.23823543
3973,Campo Spilla,A,Republican Period,7,-350,-30,320,0.23823543
3974,Campo Spilla,A,Archaic Period,6,-400,-350,50,0.23824097
3974,Campo Spilla,A,Republican Period,7,-350,-30,320,0.23824097
3975,Campo Spilla,A,Archaic Period,6,-400,-350,50,0.23823801
3975,Campo Spilla,A,Republican Period,7,-350,-30,320,0.23823801
3976,Campo Spilla,A,Republican Period,7,-200,-30,170,0.2382407
3977,Campo Spilla,A,Republican Period,7,-200,-30,170,0.23824728
3978,Casale Picarilla,A,Republican Period,7,-200,-30,170,0.21474209
3979,Casale Picarilla,A,Republican Period,7,-200,-30,170,0.21474661
3980,Casale Picarilla,A,Republican Period,7,-200,-30,170,0.21475831
3981,Podere Capecchio,A,Archaic Period,6,-400,-350,50,0.18148978
3981,Podere Capecchio,A,Republican Period,7,-350,-30,320,0.18148978
3982,,A,Archaic Period,6,-400,-350,50,0.33184385
3982,,A,Republican Period,7,-350,-30,320,0.33184385
3983,,A,Republican Period,7,-200,-30,170,0.34161162
3984,,A,Republican Period,7,-200,-30,170,0.34162533
3985,,A,Archaic Period,6,-400,-350,50,0.52219009
3985,,A,Republican Period,7,-350,-30,320,0.52219009
3986,,A,Republican Period,7,-200,-30,170,0.27640814
3987,,A,Republican Period,7,-200,-30,170,0.27641129
3988,,A,Archaic Period,6,-400,-350,50,0.51956022
3988,,A,Republican Period,7,-350,-30,320,0.51956022
3989,,A,Archaic Period,6,-400,-350,50,0.22983545
3989,,A,Republican Period,7,-350,-30,320,0.22983545
3990,,A,Archaic Period,6,-400,-350,50,0.22984125
3990,,A,Republican Period,7,-350,-30,320,0.22984125
3991,,A,Republican Period,7,-200,-30,170,0.3394461
3992,,A,Republican Period,7,-200,-30,170,0.61411035
3993,,A,Republican Period,7,-200,-30,170,1.0804573
3994,,A,Republican Period,7,-200,-30,170,0.15619509
3995,,A,Archaic Period,6,-400,-350,50,0.23741004
3995,,A,Republican Period,7,-350,-30,320,0.23741004
3996,,A,Archaic Period,6,-400,-350,50,1.088107
3996,,A,Republican Period,7,-350,-30,320,1.088107
3997,,A,Archaic Period,6,-400,-350,50,0.26582596
3997,,A,Republican Period,7,-350,-30,320,0.26582596
3998,,A,Late Iron Age,5,-600,-580,20,3.2091432
3998,,A,Archaic Period,6,-580,-350,230,3.2091432
3998,,A,Republican Period,7,-350,-30,320,3.2091432
3998,,A,Early Imperial Period,8,-30,100,130,3.2091432
3998,,A,Mid-Imperial Period,9,100,300,200,3.2091432
3998,,A,Late Imperial Period,10,300,500,200,3.2091432
3999,,A,Late Iron Age,5,-600,-580,20,0.27518055
3999,,A,Archaic Period,6,-580,-500,80,0.27518055
4000,,A,Republican Period,7,-200,-30,170,0.28215367
4001,,A,Early Imperial Period,8,-30,100,130,0.27683449
4001,,A,Mid-Imperial Period,9,100,300,200,0.27683449
4001,,A,Late Imperial Period,10,300,500,200,0.27683449
4002,,A,Archaic Period,6,-400,-350,50,0.4130545
4002,,A,Republican Period,7,-350,-30,320,0.4130545
4003,,A,Early Imperial Period,8,-30,100,130,0.13975918
4003,,A,Mid-Imperial Period,9,100,300,200,0.13975918
4003,,A,Late Imperial Period,10,300,500,200,0.13975918
4004,,A,Republican Period,7,-200,-30,170,0.27198675
4005,,A,Late Iron Age,5,-600,-580,20,0.653983
4005,,A,Archaic Period,6,-580,-350,230,0.653983
4005,,A,Republican Period,7,-350,-30,320,0.653983
4006,,A,Late Iron Age,5,-600,-580,20,0.65399957
4006,,A,Archaic Period,6,-580,-350,230,0.65399957
4006,,A,Republican Period,7,-350,-30,320,0.65399957
4007,,A,Archaic Period,6,-400,-350,50,0.60787326
4007,,A,Republican Period,7,-350,-30,320,0.60787326
4008,,A,Early Imperial Period,8,-30,100,130,0.61011225
4008,,A,Mid-Imperial Period,9,100,300,200,0.61011225
4008,,A,Late Imperial Period,10,300,500,200,0.61011225
4009,,A,Republican Period,7,-200,-30,170,1.7274036
4010,,A,Republican Period,7,-200,-30,170,0.2285243
4011,,A,Archaic Period,6,-400,-350,50,0.22143307
4011,,A,Republican Period,7,-350,-30,320,0.22143307
4012,,A,Republican Period,7,-200,-30,170,0.23253636
4013,,A,Archaic Period,6,-400,-350,50,0.52274013
4013,,A,Republican Period,7,-350,-30,320,0.52274013
4014,,A,Archaic Period,6,-400,-350,50,0.32128295
4014,,A,Republican Period,7,-350,-30,320,0.32128295
4014,,A,Early Imperial Period,8,-30,100,130,0.32128295
4014,,A,Mid-Imperial Period,9,100,300,200,0.32128295
4014,,A,Late Imperial Period,10,300,500,200,0.32128295
4015,,A,Archaic Period,6,-400,-350,50,0.61464489
4015,,A,Republican Period,7,-350,-30,320,0.61464489
4016,,A,Republican Period,7,-200,-30,170,0.45444426
4017,,A,Republican Period,7,-200,-30,170,0.2667239
4018,,A,Archaic Period,6,-400,-350,50,16.774595
4018,,A,Republican Period,7,-350,-30,320,16.774595
4018,,A,Early Imperial Period,8,-30,100,130,16.774595
4018,,A,Mid-Imperial Period,9,100,300,200,16.774595
4018,,A,Late Imperial Period,10,300,500,200,16.774595
4019,,A,Republican Period,7,-200,-30,170,0.41279337
4020,,A,Archaic Period,6,-400,-350,50,0.27741995
4020,,A,Republican Period,7,-350,-30,320,0.27741995
4021,,A,Archaic Period,6,-400,-350,50,0.27964503
4021,,A,Republican Period,7,-350,-30,320,0.27964503
4021,,A,Early Imperial Period,8,-30,100,130,0.27964503
4021,,A,Mid-Imperial Period,9,100,300,200,0.27964503
4021,,A,Late Imperial Period,10,300,500,200,0.27964503
4022,,A,Republican Period,7,-200,-30,170,0.17221852
4023,,A,Early Imperial Period,8,-30,100,130,0.32714555
4023,,A,Mid-Imperial Period,9,100,300,200,0.32714555
4023,,A,Late Imperial Period,10,300,500,200,0.32714555
4024,Tuscania (Tuscana),A,Late Iron Age,5,-700,-580,120,8.6068192
4024,Tuscania (Tuscana),A,Archaic Period,6,-580,-350,230,8.6068192
4024,Tuscania (Tuscana),A,Republican Period,7,-350,-30,320,8.6068192
4024,Tuscania (Tuscana),A,Early Imperial Period,8,-30,100,130,8.6068192
4024,Tuscania (Tuscana),A,Mid-Imperial Period,9,100,300,200,8.6068192
4024,Tuscania (Tuscana),A,Late Imperial Period,10,300,500,200,8.6068192
4025,Mentana (Nomentum),A,Early Iron Age,4,-800,-750,50,13.630691
4025,Mentana (Nomentum),A,Late Iron Age,5,-750,-580,170,13.630691
4025,Mentana (Nomentum),A,Archaic Period,6,-580,-350,230,13.630691
4025,Mentana (Nomentum),A,Republican Period,7,-350,-30,320,13.630691
4025,Mentana (Nomentum),A,Early Imperial Period,8,-30,100,130,13.630691
4025,Mentana (Nomentum),A,Mid-Imperial Period,9,100,300,200,13.630691
4025,Mentana (Nomentum),A,Late Imperial Period,10,300,500,200,13.630691
4026,,A,Republican Period,7,-300,-30,270,0.67966872
4026,,A,Early Imperial Period,8,-30,100,130,0.67966872
4026,,A,Mid-Imperial Period,9,100,300,200,0.67966872
4026,,A,Late Imperial Period,10,300,500,200,0.67966872
4027,Torre delle Torri,A,Republican Period,7,-300,-30,270,0.58539087
4027,Torre delle Torri,A,Early Imperial Period,8,-30,100,130,0.58539087
4027,Torre delle Torri,A,Mid-Imperial Period,9,100,300,200,0.58539087
4027,Torre delle Torri,A,Late Imperial Period,10,300,500,200,0.58539087
4028,Torre delle Torri,A,Republican Period,7,-300,-30,270,0.64966351
4028,Torre delle Torri,A,Early Imperial Period,8,-30,100,130,0.64966351
4028,Torre delle Torri,A,Mid-Imperial Period,9,100,300,200,0.64966351
4028,Torre delle Torri,A,Late Imperial Period,10,300,500,200,0.64966351
4029,Torre delle Torri,A,Republican Period,7,-300,-30,270,0.71136332
4029,Torre delle Torri,A,Early Imperial Period,8,-30,100,130,0.71136332
4029,Torre delle Torri,A,Mid-Imperial Period,9,100,300,200,0.71136332
4029,Torre delle Torri,A,Late Imperial Period,10,300,500,200,0.71136332
4030,Torre delle Torri,A,Republican Period,7,-300,-30,270,0.33020586
4030,Torre delle Torri,A,Early Imperial Period,8,-30,100,130,0.33020586
4030,Torre delle Torri,A,Mid-Imperial Period,9,100,300,200,0.33020586
4030,Torre delle Torri,A,Late Imperial Period,10,300,500,200,0.33020586
4031,,A,Republican Period,7,-300,-30,270,0.47505972
4031,,A,Early Imperial Period,8,-30,100,130,0.47505972
4031,,A,Mid-Imperial Period,9,100,300,200,0.47505972
4031,,A,Late Imperial Period,10,300,500,200,0.47505972
4032,,A,Republican Period,7,-300,-30,270,0.54193169
4032,,A,Early Imperial Period,8,-30,100,130,0.54193169
4032,,A,Mid-Imperial Period,9,100,300,200,0.54193169
4032,,A,Late Imperial Period,10,300,500,200,0.54193169
4033,,A,Early Imperial Period,8,-30,100,130,0.38159165
4033,,A,Mid-Imperial Period,9,100,300,200,0.38159165
4033,,A,Late Imperial Period,10,300,500,200,0.38159165
4034,,A,Republican Period,7,-300,-30,270,0.87885213
4034,,A,Early Imperial Period,8,-30,100,130,0.87885213
4034,,A,Mid-Imperial Period,9,100,300,200,0.87885213
4034,,A,Late Imperial Period,10,300,500,200,0.87885213
4035,,A,Republican Period,7,-300,-30,270,0.3716808
4035,,A,Early Imperial Period,8,-30,100,130,0.3716808
4035,,A,Mid-Imperial Period,9,100,300,200,0.3716808
4035,,A,Late Imperial Period,10,300,500,200,0.3716808
4036,,A,Republican Period,7,-300,-30,270,0.35871574
4036,,A,Early Imperial Period,8,-30,100,130,0.35871574
4036,,A,Mid-Imperial Period,9,100,300,200,0.35871574
4036,,A,Late Imperial Period,10,300,500,200,0.35871574
4037,,A,Republican Period,7,-300,-30,270,0.36498624
4037,,A,Early Imperial Period,8,-30,100,130,0.36498624
4037,,A,Mid-Imperial Period,9,100,300,200,0.36498624
4037,,A,Late Imperial Period,10,300,500,200,0.36498624
4038,,A,Republican Period,7,-300,-30,270,0.41098821
4038,,A,Early Imperial Period,8,-30,100,130,0.41098821
4038,,A,Mid-Imperial Period,9,100,300,200,0.41098821
4038,,A,Late Imperial Period,10,300,500,200,0.41098821
4039,,A,Republican Period,7,-300,-30,270,0.51637226
4039,,A,Early Imperial Period,8,-30,100,130,0.51637226
4039,,A,Mid-Imperial Period,9,100,300,200,0.51637226
4039,,A,Late Imperial Period,10,300,500,200,0.51637226
4040,,A,Republican Period,7,-300,-30,270,0.76163143
4040,,A,Early Imperial Period,8,-30,100,130,0.76163143
4040,,A,Mid-Imperial Period,9,100,300,200,0.76163143
4040,,A,Late Imperial Period,10,300,500,200,0.76163143
4041,,A,Republican Period,7,-300,-30,270,0.38908967
4041,,A,Early Imperial Period,8,-30,100,130,0.38908967
4041,,A,Mid-Imperial Period,9,100,300,200,0.38908967
4041,,A,Late Imperial Period,10,300,500,200,0.38908967
4042,,A,Republican Period,7,-300,-30,270,0.38910088
4042,,A,Early Imperial Period,8,-30,100,130,0.38910088
4042,,A,Mid-Imperial Period,9,100,300,200,0.38910088
4042,,A,Late Imperial Period,10,300,500,200,0.38910088
4043,La Cerquetta,A,Republican Period,7,-300,-30,270,1.7844666
4043,La Cerquetta,A,Early Imperial Period,8,-30,100,130,1.7844666
4043,La Cerquetta,A,Mid-Imperial Period,9,100,300,200,1.7844666
4043,La Cerquetta,A,Late Imperial Period,10,300,500,200,1.7844666
4044,La Cerquetta,A,Republican Period,7,-300,-30,270,0.50938404
4044,La Cerquetta,A,Early Imperial Period,8,-30,100,130,0.50938404
4044,La Cerquetta,A,Mid-Imperial Period,9,100,300,200,0.50938404
4044,La Cerquetta,A,Late Imperial Period,10,300,500,200,0.50938404
4045,Quarto della Conca,A,Republican Period,7,-300,-30,270,0.50621194
4045,Quarto della Conca,A,Early Imperial Period,8,-30,100,130,0.50621194
4045,Quarto della Conca,A,Mid-Imperial Period,9,100,300,200,0.50621194
4045,Quarto della Conca,A,Late Imperial Period,10,300,500,200,0.50621194
4046,Quarto della Conca,A,Republican Period,7,-300,-30,270,0.50620735
4046,Quarto della Conca,A,Early Imperial Period,8,-30,100,130,0.50620735
4046,Quarto della Conca,A,Mid-Imperial Period,9,100,300,200,0.50620735
4046,Quarto della Conca,A,Late Imperial Period,10,300,500,200,0.50620735
4047,Casale Santucci,A,Republican Period,7,-300,-30,270,0.36336374
4047,Casale Santucci,A,Early Imperial Period,8,-30,100,130,0.36336374
4047,Casale Santucci,A,Mid-Imperial Period,9,100,300,200,0.36336374
4047,Casale Santucci,A,Late Imperial Period,10,300,500,200,0.36336374
4048,La Contea,A,Republican Period,7,-300,-30,270,0.39767775
4048,La Contea,A,Early Imperial Period,8,-30,100,130,0.39767775
4048,La Contea,A,Mid-Imperial Period,9,100,300,200,0.39767775
4048,La Contea,A,Late Imperial Period,10,300,500,200,0.39767775
4049,La Contea,A,Republican Period,7,-300,-30,270,0.57215852
4049,La Contea,A,Early Imperial Period,8,-30,100,130,0.57215852
4049,La Contea,A,Mid-Imperial Period,9,100,300,200,0.57215852
4049,La Contea,A,Late Imperial Period,10,300,500,200,0.57215852
4050,La Contea,A,Republican Period,7,-300,-30,270,0.48006117
4050,La Contea,A,Early Imperial Period,8,-30,100,130,0.48006117
4050,La Contea,A,Mid-Imperial Period,9,100,300,200,0.48006117
4050,La Contea,A,Late Imperial Period,10,300,500,200,0.48006117
4051,Monte delle Cellette,A,Republican Period,7,-300,-30,270,0.61420304
4051,Monte delle Cellette,A,Early Imperial Period,8,-30,100,130,0.61420304
4051,Monte delle Cellette,A,Mid-Imperial Period,9,100,300,200,0.61420304
4051,Monte delle Cellette,A,Late Imperial Period,10,300,500,200,0.61420304
4052,,A,Republican Period,7,-300,-30,270,1.0436906
4052,,A,Early Imperial Period,8,-30,100,130,1.0436906
4052,,A,Mid-Imperial Period,9,100,300,200,1.0436906
4052,,A,Late Imperial Period,10,300,500,200,1.0436906
4053,,A,Republican Period,7,-300,-30,270,0.61459684
4053,,A,Early Imperial Period,8,-30,100,130,0.61459684
4053,,A,Mid-Imperial Period,9,100,300,200,0.61459684
4053,,A,Late Imperial Period,10,300,500,200,0.61459684
4054,,A,Republican Period,7,-300,-30,270,0.64357811
4054,,A,Early Imperial Period,8,-30,100,130,0.64357811
4054,,A,Mid-Imperial Period,9,100,300,200,0.64357811
4054,,A,Late Imperial Period,10,300,500,200,0.64357811
4055,Casale Colonnella,A,Republican Period,7,-300,-30,270,0.5344348
4055,Casale Colonnella,A,Early Imperial Period,8,-30,100,130,0.5344348
4055,Casale Colonnella,A,Mid-Imperial Period,9,100,300,200,0.5344348
4055,Casale Colonnella,A,Late Imperial Period,10,300,500,200,0.5344348
4056,Casale Colonnella,A,Republican Period,7,-300,-30,270,0.53445214
4056,Casale Colonnella,A,Early Imperial Period,8,-30,100,130,0.53445214
4056,Casale Colonnella,A,Mid-Imperial Period,9,100,300,200,0.53445214
4056,Casale Colonnella,A,Late Imperial Period,10,300,500,200,0.53445214
4057,,A,Republican Period,7,-300,-30,270,1.0946133
4057,,A,Early Imperial Period,8,-30,100,130,1.0946133
4057,,A,Mid-Imperial Period,9,100,300,200,1.0946133
4057,,A,Late Imperial Period,10,300,500,200,1.0946133
4058,,A,Republican Period,7,-300,-30,270,0.55883938
4058,,A,Early Imperial Period,8,-30,100,130,0.55883938
4058,,A,Mid-Imperial Period,9,100,300,200,0.55883938
4058,,A,Late Imperial Period,10,300,500,200,0.55883938
4059,,A,Republican Period,7,-300,-30,270,0.63737315
4059,,A,Early Imperial Period,8,-30,100,130,0.63737315
4059,,A,Mid-Imperial Period,9,100,300,200,0.63737315
4059,,A,Late Imperial Period,10,300,500,200,0.63737315
4060,,A,Republican Period,7,-300,-30,270,0.42936835
4060,,A,Early Imperial Period,8,-30,100,130,0.42936835
4060,,A,Mid-Imperial Period,9,100,300,200,0.42936835
4060,,A,Late Imperial Period,10,300,500,200,0.42936835
4061,,A,Republican Period,7,-300,-30,270,0.52534342
4061,,A,Early Imperial Period,8,-30,100,130,0.52534342
4061,,A,Mid-Imperial Period,9,100,300,200,0.52534342
4061,,A,Late Imperial Period,10,300,500,200,0.52534342
4062,,A,Republican Period,7,-300,-30,270,0.69274211
4062,,A,Early Imperial Period,8,-30,100,130,0.69274211
4062,,A,Mid-Imperial Period,9,100,300,200,0.69274211
4062,,A,Late Imperial Period,10,300,500,200,0.69274211
4063,,A,Republican Period,7,-300,-30,270,0.76900125
4063,,A,Early Imperial Period,8,-30,100,130,0.76900125
4063,,A,Mid-Imperial Period,9,100,300,200,0.76900125
4063,,A,Late Imperial Period,10,300,500,200,0.76900125
4064,Colle Lupo,A,Republican Period,7,-300,-30,270,0.45390788
4064,Colle Lupo,A,Early Imperial Period,8,-30,100,130,0.45390788
4064,Colle Lupo,A,Mid-Imperial Period,9,100,300,200,0.45390788
4064,Colle Lupo,A,Late Imperial Period,10,300,500,200,0.45390788
4065,Colle Lupo,A,Republican Period,7,-300,-30,270,1.243047
4065,Colle Lupo,A,Early Imperial Period,8,-30,100,130,1.243047
4065,Colle Lupo,A,Mid-Imperial Period,9,100,300,200,1.243047
4065,Colle Lupo,A,Late Imperial Period,10,300,500,200,1.243047
4066,,A,Republican Period,7,-300,-30,270,1.5770144
4066,,A,Early Imperial Period,8,-30,100,130,1.5770144
4066,,A,Mid-Imperial Period,9,100,300,200,1.5770144
4066,,A,Late Imperial Period,10,300,500,200,1.5770144
4067,,A,Republican Period,7,-300,-30,270,0.46020406
4067,,A,Early Imperial Period,8,-30,100,130,0.46020406
4067,,A,Mid-Imperial Period,9,100,300,200,0.46020406
4067,,A,Late Imperial Period,10,300,500,200,0.46020406
4068,Bufala,A,Republican Period,7,-300,-30,270,0.59551126
4068,Bufala,A,Early Imperial Period,8,-30,100,130,0.59551126
4068,Bufala,A,Mid-Imperial Period,9,100,300,200,0.59551126
4068,Bufala,A,Late Imperial Period,10,300,500,200,0.59551126
4069,Bufala,A,Republican Period,7,-300,-30,270,0.66645628
4069,Bufala,A,Early Imperial Period,8,-30,100,130,0.66645628
4069,Bufala,A,Mid-Imperial Period,9,100,300,200,0.66645628
4069,Bufala,A,Late Imperial Period,10,300,500,200,0.66645628
4070,Casale Grotta Marozza,A,Republican Period,7,-300,-30,270,0.92091435
4070,Casale Grotta Marozza,A,Early Imperial Period,8,-30,100,130,0.92091435
4070,Casale Grotta Marozza,A,Mid-Imperial Period,9,100,300,200,0.92091435
4070,Casale Grotta Marozza,A,Late Imperial Period,10,300,500,200,0.92091435
4071,,A,Republican Period,7,-300,-30,270,0.44955522
4071,,A,Early Imperial Period,8,-30,100,130,0.44955522
4071,,A,Mid-Imperial Period,9,100,300,200,0.44955522
4071,,A,Late Imperial Period,10,300,500,200,0.44955522
4072,,A,Republican Period,7,-300,-30,270,0.49009344
4072,,A,Early Imperial Period,8,-30,100,130,0.49009344
4072,,A,Mid-Imperial Period,9,100,300,200,0.49009344
4072,,A,Late Imperial Period,10,300,500,200,0.49009344
4073,,A,Republican Period,7,-300,-30,270,0.49012959
4073,,A,Early Imperial Period,8,-30,100,130,0.49012959
4073,,A,Mid-Imperial Period,9,100,300,200,0.49012959
4073,,A,Late Imperial Period,10,300,500,200,0.49012959
4074,Monte del Soldato,A,Republican Period,7,-300,-30,270,0.36548856
4074,Monte del Soldato,A,Early Imperial Period,8,-30,100,130,0.36548856
4074,Monte del Soldato,A,Mid-Imperial Period,9,100,300,200,0.36548856
4074,Monte del Soldato,A,Late Imperial Period,10,300,500,200,0.36548856
4075,Monte del Soldato,A,Republican Period,7,-300,-30,270,0.3654986
4075,Monte del Soldato,A,Early Imperial Period,8,-30,100,130,0.3654986
4075,Monte del Soldato,A,Mid-Imperial Period,9,100,300,200,0.3654986
4075,Monte del Soldato,A,Late Imperial Period,10,300,500,200,0.3654986
4076,,A,Republican Period,7,-300,-30,270,0.77218342
4076,,A,Early Imperial Period,8,-30,100,130,0.77218342
4076,,A,Mid-Imperial Period,9,100,300,200,0.77218342
4076,,A,Late Imperial Period,10,300,500,200,0.77218342
4077,,A,Republican Period,7,-300,-30,270,0.41422468
4077,,A,Early Imperial Period,8,-30,100,130,0.41422468
4077,,A,Mid-Imperial Period,9,100,300,200,0.41422468
4077,,A,Late Imperial Period,10,300,500,200,0.41422468
4078,,A,Republican Period,7,-300,-30,270,0.41420805
4078,,A,Early Imperial Period,8,-30,100,130,0.41420805
4078,,A,Mid-Imperial Period,9,100,300,200,0.41420805
4078,,A,Late Imperial Period,10,300,500,200,0.41420805
4079,,A,Republican Period,7,-300,-30,270,0.4892917
4079,,A,Early Imperial Period,8,-30,100,130,0.4892917
4079,,A,Mid-Imperial Period,9,100,300,200,0.4892917
4079,,A,Late Imperial Period,10,300,500,200,0.4892917
4080,Casale Pichini,A,Republican Period,7,-300,-30,270,0.64703268
4080,Casale Pichini,A,Early Imperial Period,8,-30,100,130,0.64703268
4080,Casale Pichini,A,Mid-Imperial Period,9,100,300,200,0.64703268
4080,Casale Pichini,A,Late Imperial Period,10,300,500,200,0.64703268
4081,Torraccio di Alongara,A,Republican Period,7,-300,-30,270,0.76367784
4081,Torraccio di Alongara,A,Early Imperial Period,8,-30,100,130,0.76367784
4081,Torraccio di Alongara,A,Mid-Imperial Period,9,100,300,200,0.76367784
4081,Torraccio di Alongara,A,Late Imperial Period,10,300,500,200,0.76367784
4082,Casale Pichini,A,Republican Period,7,-300,-30,270,0.43031359
4082,Casale Pichini,A,Early Imperial Period,8,-30,100,130,0.43031359
4082,Casale Pichini,A,Mid-Imperial Period,9,100,300,200,0.43031359
4082,Casale Pichini,A,Late Imperial Period,10,300,500,200,0.43031359
4083,,A,Republican Period,7,-300,-30,270,0.40347773
4083,,A,Early Imperial Period,8,-30,100,130,0.40347773
4083,,A,Mid-Imperial Period,9,100,300,200,0.40347773
4083,,A,Late Imperial Period,10,300,500,200,0.40347773
4084,,A,Republican Period,7,-300,-30,270,0.27070513
4084,,A,Early Imperial Period,8,-30,100,130,0.27070513
4084,,A,Mid-Imperial Period,9,100,300,200,0.27070513
4084,,A,Late Imperial Period,10,300,500,200,0.27070513
4085,Le Vignole,A,Republican Period,7,-300,-30,270,0.2707139
4085,Le Vignole,A,Early Imperial Period,8,-30,100,130,0.2707139
4085,Le Vignole,A,Mid-Imperial Period,9,100,300,200,0.2707139
4085,Le Vignole,A,Late Imperial Period,10,300,500,200,0.2707139
4086,Le Vignole,A,Republican Period,7,-300,-30,270,0.27072352
4086,Le Vignole,A,Early Imperial Period,8,-30,100,130,0.27072352
4086,Le Vignole,A,Mid-Imperial Period,9,100,300,200,0.27072352
4086,Le Vignole,A,Late Imperial Period,10,300,500,200,0.27072352
4087,,A,Republican Period,7,-300,-30,270,0.51093769
4087,,A,Early Imperial Period,8,-30,100,130,0.51093769
4087,,A,Mid-Imperial Period,9,100,300,200,0.51093769
4087,,A,Late Imperial Period,10,300,500,200,0.51093769
4088,,A,Republican Period,7,-300,-30,270,0.36888668
4088,,A,Early Imperial Period,8,-30,100,130,0.36888668
4088,,A,Mid-Imperial Period,9,100,300,200,0.36888668
4088,,A,Late Imperial Period,10,300,500,200,0.36888668
4089,,A,Republican Period,7,-300,-30,270,0.30191112
4089,,A,Early Imperial Period,8,-30,100,130,0.30191112
4089,,A,Mid-Imperial Period,9,100,300,200,0.30191112
4089,,A,Late Imperial Period,10,300,500,200,0.30191112
4090,,A,Republican Period,7,-300,-30,270,0.64420444
4090,,A,Early Imperial Period,8,-30,100,130,0.64420444
4090,,A,Mid-Imperial Period,9,100,300,200,0.64420444
4090,,A,Late Imperial Period,10,300,500,200,0.64420444
4091,,A,Republican Period,7,-300,-30,270,0.34886509
4091,,A,Early Imperial Period,8,-30,100,130,0.34886509
4091,,A,Mid-Imperial Period,9,100,300,200,0.34886509
4091,,A,Late Imperial Period,10,300,500,200,0.34886509
4092,,A,Republican Period,7,-300,-30,270,0.34486884
4092,,A,Early Imperial Period,8,-30,100,130,0.34486884
4092,,A,Mid-Imperial Period,9,100,300,200,0.34486884
4092,,A,Late Imperial Period,10,300,500,200,0.34486884
4093,Fontanile di Mezzaluna,A,Republican Period,7,-300,-30,270,0.4395175
4093,Fontanile di Mezzaluna,A,Early Imperial Period,8,-30,100,130,0.4395175
4093,Fontanile di Mezzaluna,A,Mid-Imperial Period,9,100,300,200,0.4395175
4093,Fontanile di Mezzaluna,A,Late Imperial Period,10,300,500,200,0.4395175
4094,Capanna Bruciata,A,Republican Period,7,-300,-30,270,0.30773857
4094,Capanna Bruciata,A,Early Imperial Period,8,-30,100,130,0.30773857
4094,Capanna Bruciata,A,Mid-Imperial Period,9,100,300,200,0.30773857
4094,Capanna Bruciata,A,Late Imperial Period,10,300,500,200,0.30773857
4095,Capanna Bruciata,A,Republican Period,7,-300,-30,270,0.30774352
4095,Capanna Bruciata,A,Early Imperial Period,8,-30,100,130,0.30774352
4095,Capanna Bruciata,A,Mid-Imperial Period,9,100,300,200,0.30774352
4095,Capanna Bruciata,A,Late Imperial Period,10,300,500,200,0.30774352
4096,Castello di Greppe,A,Republican Period,7,-300,-30,270,0.23386139
4096,Castello di Greppe,A,Early Imperial Period,8,-30,100,130,0.23386139
4096,Castello di Greppe,A,Mid-Imperial Period,9,100,300,200,0.23386139
4096,Castello di Greppe,A,Late Imperial Period,10,300,500,200,0.23386139
4097,,A,Republican Period,7,-300,-30,270,0.33154964
4097,,A,Early Imperial Period,8,-30,100,130,0.33154964
4097,,A,Mid-Imperial Period,9,100,300,200,0.33154964
4097,,A,Late Imperial Period,10,300,500,200,0.33154964
4098,,A,Republican Period,7,-300,-30,270,0.37800723
4098,,A,Early Imperial Period,8,-30,100,130,0.37800723
4098,,A,Mid-Imperial Period,9,100,300,200,0.37800723
4098,,A,Late Imperial Period,10,300,500,200,0.37800723
4099,Monte Ardone,A,Republican Period,7,-300,-30,270,0.29174471
4099,Monte Ardone,A,Early Imperial Period,8,-30,100,130,0.29174471
4099,Monte Ardone,A,Mid-Imperial Period,9,100,300,200,0.29174471
4099,Monte Ardone,A,Late Imperial Period,10,300,500,200,0.29174471
4100,Casale Andreuzza e Ferronea,A,Republican Period,7,-300,-30,270,0.46065095
4100,Casale Andreuzza e Ferronea,A,Early Imperial Period,8,-30,100,130,0.46065095
4100,Casale Andreuzza e Ferronea,A,Mid-Imperial Period,9,100,300,200,0.46065095
4100,Casale Andreuzza e Ferronea,A,Late Imperial Period,10,300,500,200,0.46065095
4101,Casale Andreuzza e Ferronea,A,Republican Period,7,-300,-30,270,0.46065241
4101,Casale Andreuzza e Ferronea,A,Early Imperial Period,8,-30,100,130,0.46065241
4101,Casale Andreuzza e Ferronea,A,Mid-Imperial Period,9,100,300,200,0.46065241
4101,Casale Andreuzza e Ferronea,A,Late Imperial Period,10,300,500,200,0.46065241
4102,Leva Sole,A,Republican Period,7,-300,-30,270,0.28815633
4102,Leva Sole,A,Early Imperial Period,8,-30,100,130,0.28815633
4102,Leva Sole,A,Mid-Imperial Period,9,100,300,200,0.28815633
4102,Leva Sole,A,Late Imperial Period,10,300,500,200,0.28815633
4103,Leva Sole,A,Republican Period,7,-300,-30,270,0.28814328
4103,Leva Sole,A,Early Imperial Period,8,-30,100,130,0.28814328
4103,Leva Sole,A,Mid-Imperial Period,9,100,300,200,0.28814328
4103,Leva Sole,A,Late Imperial Period,10,300,500,200,0.28814328
4104,Leva Sole,A,Republican Period,7,-300,-30,270,0.28813669
4104,Leva Sole,A,Early Imperial Period,8,-30,100,130,0.28813669
4104,Leva Sole,A,Mid-Imperial Period,9,100,300,200,0.28813669
4104,Leva Sole,A,Late Imperial Period,10,300,500,200,0.28813669
4105,,A,Republican Period,7,-300,-30,270,0.39220735
4105,,A,Early Imperial Period,8,-30,100,130,0.39220735
4105,,A,Mid-Imperial Period,9,100,300,200,0.39220735
4105,,A,Late Imperial Period,10,300,500,200,0.39220735
4106,Casale Monsignore,A,Republican Period,7,-300,-30,270,0.42584416
4106,Casale Monsignore,A,Early Imperial Period,8,-30,100,130,0.42584416
4106,Casale Monsignore,A,Mid-Imperial Period,9,100,300,200,0.42584416
4106,Casale Monsignore,A,Late Imperial Period,10,300,500,200,0.42584416
4107,Molino del Moro,A,Republican Period,7,-300,-30,270,0.45582598
4107,Molino del Moro,A,Early Imperial Period,8,-30,100,130,0.45582598
4107,Molino del Moro,A,Mid-Imperial Period,9,100,300,200,0.45582598
4107,Molino del Moro,A,Late Imperial Period,10,300,500,200,0.45582598
4108,Immagine Lunga,A,Republican Period,7,-300,-30,270,0.43037412
4108,Immagine Lunga,A,Early Imperial Period,8,-30,100,130,0.43037412
4108,Immagine Lunga,A,Mid-Imperial Period,9,100,300,200,0.43037412
4108,Immagine Lunga,A,Late Imperial Period,10,300,500,200,0.43037412
4109,,A,Republican Period,7,-300,-30,270,0.23717757
4109,,A,Early Imperial Period,8,-30,100,130,0.23717757
4109,,A,Mid-Imperial Period,9,100,300,200,0.23717757
4109,,A,Late Imperial Period,10,300,500,200,0.23717757
4110,,A,Republican Period,7,-300,-30,270,0.40869051
4110,,A,Early Imperial Period,8,-30,100,130,0.40869051
4110,,A,Mid-Imperial Period,9,100,300,200,0.40869051
4110,,A,Late Imperial Period,10,300,500,200,0.40869051
4111,Pozzo del Merlo,A,Republican Period,7,-300,-30,270,0.62082237
4111,Pozzo del Merlo,A,Early Imperial Period,8,-30,100,130,0.62082237
4111,Pozzo del Merlo,A,Mid-Imperial Period,9,100,300,200,0.62082237
4111,Pozzo del Merlo,A,Late Imperial Period,10,300,500,200,0.62082237
4112,Colle Fergiaro,A,Republican Period,7,-300,-30,270,0.43002865
4112,Colle Fergiaro,A,Early Imperial Period,8,-30,100,130,0.43002865
4112,Colle Fergiaro,A,Mid-Imperial Period,9,100,300,200,0.43002865
4112,Colle Fergiaro,A,Late Imperial Period,10,300,500,200,0.43002865
4113,,A,Republican Period,7,-300,-30,270,0.78680533
4113,,A,Early Imperial Period,8,-30,100,130,0.78680533
4113,,A,Mid-Imperial Period,9,100,300,200,0.78680533
4113,,A,Late Imperial Period,10,300,500,200,0.78680533
4114,,A,Republican Period,7,-300,-30,270,0.54607469
4114,,A,Early Imperial Period,8,-30,100,130,0.54607469
4114,,A,Mid-Imperial Period,9,100,300,200,0.54607469
4114,,A,Late Imperial Period,10,300,500,200,0.54607469
4115,Colli Giovannelle,A,Republican Period,7,-300,-30,270,0.32902998
4115,Colli Giovannelle,A,Early Imperial Period,8,-30,100,130,0.32902998
4115,Colli Giovannelle,A,Mid-Imperial Period,9,100,300,200,0.32902998
4115,Colli Giovannelle,A,Late Imperial Period,10,300,500,200,0.32902998
4116,Colli Giovannelle,A,Republican Period,7,-300,-30,270,0.29877272
4116,Colli Giovannelle,A,Early Imperial Period,8,-30,100,130,0.29877272
4116,Colli Giovannelle,A,Mid-Imperial Period,9,100,300,200,0.29877272
4116,Colli Giovannelle,A,Late Imperial Period,10,300,500,200,0.29877272
4117,Casale Ciollo,A,Republican Period,7,-300,-30,270,0.44450545
4117,Casale Ciollo,A,Early Imperial Period,8,-30,100,130,0.44450545
4117,Casale Ciollo,A,Mid-Imperial Period,9,100,300,200,0.44450545
4117,Casale Ciollo,A,Late Imperial Period,10,300,500,200,0.44450545
4118,Casale Ciollo,A,Republican Period,7,-300,-30,270,0.3737461
4118,Casale Ciollo,A,Early Imperial Period,8,-30,100,130,0.3737461
4118,Casale Ciollo,A,Mid-Imperial Period,9,100,300,200,0.3737461
4118,Casale Ciollo,A,Late Imperial Period,10,300,500,200,0.3737461
4119,Le Grottoline,A,Republican Period,7,-300,-30,270,0.57091206
4119,Le Grottoline,A,Early Imperial Period,8,-30,100,130,0.57091206
4119,Le Grottoline,A,Mid-Imperial Period,9,100,300,200,0.57091206
4119,Le Grottoline,A,Late Imperial Period,10,300,500,200,0.57091206
4120,Colle Roncetta,A,Republican Period,7,-300,-30,270,0.57314891
4120,Colle Roncetta,A,Early Imperial Period,8,-30,100,130,0.57314891
4120,Colle Roncetta,A,Mid-Imperial Period,9,100,300,200,0.57314891
4120,Colle Roncetta,A,Late Imperial Period,10,300,500,200,0.57314891
4121,,A,Republican Period,7,-300,-30,270,0.63393337
4121,,A,Early Imperial Period,8,-30,100,130,0.63393337
4121,,A,Mid-Imperial Period,9,100,300,200,0.63393337
4121,,A,Late Imperial Period,10,300,500,200,0.63393337
4122,,A,Republican Period,7,-300,-30,270,0.53984541
4122,,A,Early Imperial Period,8,-30,100,130,0.53984541
4122,,A,Mid-Imperial Period,9,100,300,200,0.53984541
4122,,A,Late Imperial Period,10,300,500,200,0.53984541
4123,Monte di Massa,A,Republican Period,7,-300,-30,270,0.28337413
4123,Monte di Massa,A,Early Imperial Period,8,-30,100,130,0.28337413
4123,Monte di Massa,A,Mid-Imperial Period,9,100,300,200,0.28337413
4123,Monte di Massa,A,Late Imperial Period,10,300,500,200,0.28337413
4124,Monte del Ficarone,A,Republican Period,7,-300,-30,270,0.50112975
4124,Monte del Ficarone,A,Early Imperial Period,8,-30,100,130,0.50112975
4124,Monte del Ficarone,A,Mid-Imperial Period,9,100,300,200,0.50112975
4124,Monte del Ficarone,A,Late Imperial Period,10,300,500,200,0.50112975
4125,Monte del Ficarone,A,Republican Period,7,-300,-30,270,0.19385079
4125,Monte del Ficarone,A,Early Imperial Period,8,-30,100,130,0.19385079
4125,Monte del Ficarone,A,Mid-Imperial Period,9,100,300,200,0.19385079
4125,Monte del Ficarone,A,Late Imperial Period,10,300,500,200,0.19385079
4126,,A,Republican Period,7,-300,-30,270,0.38279057
4126,,A,Early Imperial Period,8,-30,100,130,0.38279057
4126,,A,Mid-Imperial Period,9,100,300,200,0.38279057
4126,,A,Late Imperial Period,10,300,500,200,0.38279057
4127,Fondi di S. Lucia,A,Republican Period,7,-300,-30,270,0.31360808
4127,Fondi di S. Lucia,A,Early Imperial Period,8,-30,100,130,0.31360808
4127,Fondi di S. Lucia,A,Mid-Imperial Period,9,100,300,200,0.31360808
4127,Fondi di S. Lucia,A,Late Imperial Period,10,300,500,200,0.31360808
4128,Tenuta di Tor S. Giovanni,A,Republican Period,7,-300,-30,270,0.62146974
4128,Tenuta di Tor S. Giovanni,A,Early Imperial Period,8,-30,100,130,0.62146974
4128,Tenuta di Tor S. Giovanni,A,Mid-Imperial Period,9,100,300,200,0.62146974
4128,Tenuta di Tor S. Giovanni,A,Late Imperial Period,10,300,500,200,0.62146974
4129,Tenuta di Tor S. Giovanni,A,Republican Period,7,-300,-30,270,0.8846463
4129,Tenuta di Tor S. Giovanni,A,Early Imperial Period,8,-30,100,130,0.8846463
4129,Tenuta di Tor S. Giovanni,A,Mid-Imperial Period,9,100,300,200,0.8846463
4129,Tenuta di Tor S. Giovanni,A,Late Imperial Period,10,300,500,200,0.8846463
4130,Tenuta di Tor S. Giovanni,A,Republican Period,7,-300,-30,270,0.23322946
4130,Tenuta di Tor S. Giovanni,A,Early Imperial Period,8,-30,100,130,0.23322946
4130,Tenuta di Tor S. Giovanni,A,Mid-Imperial Period,9,100,300,200,0.23322946
4130,Tenuta di Tor S. Giovanni,A,Late Imperial Period,10,300,500,200,0.23322946
4131,,A,Republican Period,7,-300,-30,270,0.58668929
4131,,A,Early Imperial Period,8,-30,100,130,0.58668929
4131,,A,Mid-Imperial Period,9,100,300,200,0.58668929
4131,,A,Late Imperial Period,10,300,500,200,0.58668929
4132,La Costa,A,Republican Period,7,-300,-30,270,0.68542272
4132,La Costa,A,Early Imperial Period,8,-30,100,130,0.68542272
4132,La Costa,A,Mid-Imperial Period,9,100,300,200,0.68542272
4132,La Costa,A,Late Imperial Period,10,300,500,200,0.68542272
4133,,A,Republican Period,7,-300,-30,270,0.43402001
4133,,A,Early Imperial Period,8,-30,100,130,0.43402001
4133,,A,Mid-Imperial Period,9,100,300,200,0.43402001
4133,,A,Late Imperial Period,10,300,500,200,0.43402001
4134,Monte S. Ilario,A,Republican Period,7,-300,-30,270,0.4639172
4134,Monte S. Ilario,A,Early Imperial Period,8,-30,100,130,0.4639172
4134,Monte S. Ilario,A,Mid-Imperial Period,9,100,300,200,0.4639172
4134,Monte S. Ilario,A,Late Imperial Period,10,300,500,200,0.4639172
4135,Casale Riva,A,Republican Period,7,-300,-30,270,0.30717704
4135,Casale Riva,A,Early Imperial Period,8,-30,100,130,0.30717704
4135,Casale Riva,A,Mid-Imperial Period,9,100,300,200,0.30717704
4135,Casale Riva,A,Late Imperial Period,10,300,500,200,0.30717704
4136,,A,Republican Period,7,-300,-30,270,0.46154863
4136,,A,Early Imperial Period,8,-30,100,130,0.46154863
4136,,A,Mid-Imperial Period,9,100,300,200,0.46154863
4136,,A,Late Imperial Period,10,300,500,200,0.46154863
4137,S. Anzino,A,Republican Period,7,-300,-30,270,0.40481707
4137,S. Anzino,A,Early Imperial Period,8,-30,100,130,0.40481707
4137,S. Anzino,A,Mid-Imperial Period,9,100,300,200,0.40481707
4137,S. Anzino,A,Late Imperial Period,10,300,500,200,0.40481707
4138,S. Anzino,A,Republican Period,7,-300,-30,270,0.40481687
4138,S. Anzino,A,Early Imperial Period,8,-30,100,130,0.40481687
4138,S. Anzino,A,Mid-Imperial Period,9,100,300,200,0.40481687
4138,S. Anzino,A,Late Imperial Period,10,300,500,200,0.40481687
4139,S. Martinello,A,Republican Period,7,-300,-30,270,0.31469661
4139,S. Martinello,A,Early Imperial Period,8,-30,100,130,0.31469661
4139,S. Martinello,A,Mid-Imperial Period,9,100,300,200,0.31469661
4139,S. Martinello,A,Late Imperial Period,10,300,500,200,0.31469661
4140,,A,Early Imperial Period,8,-30,100,130,0.21817948
4140,,A,Mid-Imperial Period,9,100,300,200,0.21817948
4140,,A,Late Imperial Period,10,300,500,200,0.21817948
4141,,A,Early Imperial Period,8,-30,100,130,0.56328195
4141,,A,Mid-Imperial Period,9,100,300,200,0.56328195
4141,,A,Late Imperial Period,10,300,500,200,0.56328195
4142,Castel Giubileo,A,Early Imperial Period,8,-30,100,130,0.67484027
4142,Castel Giubileo,A,Mid-Imperial Period,9,100,300,200,0.67484027
4142,Castel Giubileo,A,Late Imperial Period,10,300,500,200,0.67484027
4143,,A,Early Imperial Period,8,-30,100,130,0.49912298
4143,,A,Mid-Imperial Period,9,100,300,200,0.49912298
4143,,A,Late Imperial Period,10,300,500,200,0.49912298
4144,,A,Late Iron Age,5,-700,-580,120,0.16793863
4144,,A,Archaic Period,6,-580,-500,80,0.16793863
4144,,B,Early Imperial Period,8,-30,100,130,0.21553762
4144,,B,Mid-Imperial Period,9,100,300,200,0.21553762
4144,,B,Late Imperial Period,10,300,500,200,0.21553762
4145,Tenuta di Castel Giubileo,A,Late Iron Age,5,-600,-580,20,0.32391235
4145,Tenuta di Castel Giubileo,A,Archaic Period,6,-580,-400,180,0.32391235
4145,Tenuta di Castel Giubileo,B,Early Imperial Period,8,-30,100,130,0.25028169
4145,Tenuta di Castel Giubileo,B,Mid-Imperial Period,9,100,300,200,0.25028169
4145,Tenuta di Castel Giubileo,B,Late Imperial Period,10,300,500,200,0.25028169
4146,Tenuta di Castel Giubileo,A,Late Iron Age,5,-600,-580,20,0.36981803
4146,Tenuta di Castel Giubileo,A,Archaic Period,6,-580,-500,80,0.36981803
4146,Tenuta di Castel Giubileo,B,Republican Period,7,-300,-100,200,0.68176359
4146,Tenuta di Castel Giubileo,C,Early Imperial Period,8,1,100,99,0.26133317
4146,Tenuta di Castel Giubileo,C,Mid-Imperial Period,9,100,300,200,0.26133317
4147,,A,Early Iron Age,4,-900,-750,150,0.86610031
4147,,A,Late Iron Age,5,-750,-580,170,0.86610031
4147,,A,Archaic Period,6,-580,-350,230,1.3097675
4147,,A,Republican Period,7,-350,-30,320,1.3097675
4147,,A,Early Imperial Period,8,-30,100,130,0.22367643
4147,,A,Mid-Imperial Period,9,100,300,200,0.22367643
4147,,A,Late Imperial Period,10,300,500,200,0.22367643
4148,Tenuta di Castel Giubileo,A,Early Imperial Period,8,-30,100,130,0.21340062
4148,Tenuta di Castel Giubileo,A,Mid-Imperial Period,9,100,300,200,0.21340062
4148,Tenuta di Castel Giubileo,A,Late Imperial Period,10,300,500,200,0.21340062
4149,Tenuta di Castel Giubileo,A,Early Imperial Period,8,-30,100,130,0.20021915
4149,Tenuta di Castel Giubileo,A,Mid-Imperial Period,9,100,300,200,0.20021915
4149,Tenuta di Castel Giubileo,A,Late Imperial Period,10,300,500,200,0.20021915
4150,Tenuta di Castel Giubileo,A,Early Imperial Period,8,-30,100,130,0.21933247
4151,Tenuta di Castel Giubileo,A,Republican Period,7,-300,-30,270,0.24838552
4151,Tenuta di Castel Giubileo,A,Early Imperial Period,8,-30,100,130,0.24838552
4151,Tenuta di Castel Giubileo,A,Mid-Imperial Period,9,100,300,200,0.24838552
4151,Tenuta di Castel Giubileo,A,Late Imperial Period,10,300,450,150,0.24838552
4152,,A,Late Iron Age,5,-600,-580,20,0.22369394
4152,,A,Archaic Period,6,-580,-500,80,0.22369394
4153,Tenuta di Castel Giubileo,A,Late Iron Age,5,-600,-580,20,0.15821354
4153,Tenuta di Castel Giubileo,A,Archaic Period,6,-580,-500,80,0.15821354
4154,Tenuta di Castel Giubileo,A,Republican Period,7,-300,-30,270,0.52112126
4154,Tenuta di Castel Giubileo,A,Early Imperial Period,8,-30,100,130,0.23050392
4154,Tenuta di Castel Giubileo,A,Mid-Imperial Period,9,100,300,200,0.23050392
4154,Tenuta di Castel Giubileo,A,Late Imperial Period,10,300,500,200,0.23050392
4155,,A,Archaic Period,6,-400,-350,50,0.67075181
4155,,A,Republican Period,7,-350,-30,320,0.67075181
4155,,A,Early Imperial Period,8,-30,100,130,0.17643148
4155,,A,Mid-Imperial Period,9,100,300,200,0.17643148
4155,,A,Late Imperial Period,10,300,500,200,0.17643148
4156,,A,Archaic Period,6,-500,-400,100,0.34459975
4156,,B,Early Imperial Period,8,-30,100,130,0.15598613
4156,,B,Mid-Imperial Period,9,100,300,200,0.15598613
4156,,B,Late Imperial Period,10,300,500,200,0.15598613
4157,,A,Republican Period,7,-100,-30,70,0.26169571
4157,,A,Early Imperial Period,8,-30,100,130,0.19364643
4157,,A,Mid-Imperial Period,9,100,300,200,0.19364643
4157,,A,Late Imperial Period,10,300,500,200,0.19364643
4158,,A,Republican Period,7,-200,-30,170,0.35578752
4158,,A,Early Imperial Period,8,-30,100,130,0.85918784
4158,,A,Mid-Imperial Period,9,100,200,100,0.85918784
4159,,A,Early Imperial Period,8,-30,100,130,0.24750623
4159,,A,Mid-Imperial Period,9,100,300,200,0.24750623
4159,,A,Late Imperial Period,10,300,500,200,0.24750623
4160,,A,Early Imperial Period,8,-30,100,130,0.24750529
4160,,A,Mid-Imperial Period,9,100,300,200,0.24750529
4160,,A,Late Imperial Period,10,300,500,200,0.24750529
4161,,A,Late Iron Age,5,-600,-580,20,0.94752634
4161,,A,Archaic Period,6,-580,-400,180,0.94752634
4162,,A,Early Imperial Period,8,-30,100,130,0.22169158
4162,,A,Mid-Imperial Period,9,100,300,200,0.22169158
4162,,A,Late Imperial Period,10,300,500,200,0.22169158
4163,,A,Late Iron Age,5,-600,-580,20,0.5600329
4163,,A,Archaic Period,6,-580,-500,80,0.5600329
4163,,B,Early Imperial Period,8,-30,100,130,0.24470645
4163,,B,Mid-Imperial Period,9,100,300,200,0.24470645
4163,,B,Late Imperial Period,10,300,500,200,0.24470645
4164,,A,Early Imperial Period,8,-30,100,130,0.22525483
4164,,A,Mid-Imperial Period,9,100,300,200,0.22525483
4164,,A,Late Imperial Period,10,300,500,200,0.22525483
4165,Casale Redicicoli,A,Late Iron Age,5,-600,-580,20,0.41355428
4165,Casale Redicicoli,A,Archaic Period,6,-580,-350,230,0.6865387
4165,Casale Redicicoli,A,Republican Period,7,-350,-200,150,0.6865387
4166,,A,Late Bronze Age,3,-1300,-1020,280,0.23354763
4166,,B,Early Iron Age,4,-1020,-750,270,0.2412557
4166,,B,Late Iron Age,5,-750,-700,50,0.2412557
4167,Tenuta Redicicoli,A,Late Iron Age,5,-600,-580,20,2.5124235
4167,Tenuta Redicicoli,A,Archaic Period,6,-580,-400,180,2.5124235
4167,Tenuta Redicicoli,B,Early Imperial Period,8,-30,100,130,0.20974052
4167,Tenuta Redicicoli,B,Mid-Imperial Period,9,100,300,200,0.20974052
4167,Tenuta Redicicoli,B,Late Imperial Period,10,300,500,200,0.20974052
4168,Tenuta Redicicoli,A,Early Imperial Period,8,-30,100,130,0.25611863
4168,Tenuta Redicicoli,A,Mid-Imperial Period,9,100,300,200,0.25611863
4168,Tenuta Redicicoli,A,Late Imperial Period,10,300,500,200,0.25611863
4169,,A,Late Iron Age,5,-600,-580,20,0.33825725
4169,,A,Archaic Period,6,-580,-500,80,0.33825725
4170,,A,Late Iron Age,5,-600,-580,20,0.17958173
4170,,A,Archaic Period,6,-580,-350,230,0.47068834
4170,,A,Republican Period,7,-350,-200,150,0.47068834
4170,,B,Early Imperial Period,8,-30,100,130,0.240931
4171,,A,Archaic Period,6,-500,-350,150,1.7643517
4171,,A,Republican Period,7,-350,-30,320,0.55295116
4171,,A,Early Imperial Period,8,-30,100,130,0.73086286
4171,,A,Mid-Imperial Period,9,100,300,200,0.73086286
4172,,A,Early Imperial Period,8,-30,100,130,0.2098774
4172,,A,Mid-Imperial Period,9,100,300,200,0.2098774
4172,,A,Late Imperial Period,10,300,500,200,0.2098774
4173,,A,Early Imperial Period,8,-30,100,130,0.27010411
4174,,A,Late Iron Age,5,-600,-580,20,0.27568644
4174,,A,Archaic Period,6,-580,-500,80,0.27568644
4174,,B,Early Imperial Period,8,-30,100,130,0.23199131
4174,,B,Mid-Imperial Period,9,100,300,200,0.23199131
4174,,B,Late Imperial Period,10,300,500,200,0.23199131
4175,,A,Late Iron Age,5,-600,-580,20,0.16526838
4175,,A,Archaic Period,6,-580,-500,80,0.16526838
4176,,A,Late Iron Age,5,-600,-580,20,0.44307381
4176,,B,Archaic Period,6,-580,-350,230,0.44307381
4176,,B,Republican Period,7,-350,-200,150,0.44307381
4177,,A,Late Iron Age,5,-600,-580,20,0.3236087
4177,,A,Archaic Period,6,-580,-400,180,0.3236087
4177,,B,Early Imperial Period,8,-30,100,130,0.19599794
4177,,B,Mid-Imperial Period,9,100,300,200,0.19599794
4177,,B,Late Imperial Period,10,300,500,200,0.19599794
4178,,A,Late Iron Age,5,-600,-580,20,0.67471558
4178,,A,Archaic Period,6,-580,-350,230,1.0881745
4178,,A,Republican Period,7,-350,-30,320,1.0881745
4178,,A,Early Imperial Period,8,-30,100,130,0.19980058
4178,,A,Mid-Imperial Period,9,100,300,200,0.19980058
4178,,A,Late Imperial Period,10,300,500,200,0.19980058
4179,,A,Archaic Period,6,-400,-350,50,0.20450452
4179,,A,Republican Period,7,-350,-30,320,0.20450452
4179,,A,Early Imperial Period,8,-30,100,130,0.23601636
4179,,A,Mid-Imperial Period,9,100,300,200,0.23601636
4179,,A,Late Imperial Period,10,300,500,200,0.23601636
4180,Tenuta di Villa Spada,A,Late Iron Age,5,-700,-580,120,1.2472796
4180,Tenuta di Villa Spada,A,Archaic Period,6,-580,-400,180,0.92039585
4180,Tenuta di Villa Spada,B,Early Imperial Period,8,-30,100,130,3.6302133
4180,Tenuta di Villa Spada,B,Mid-Imperial Period,9,100,300,200,3.6302133
4180,Tenuta di Villa Spada,B,Late Imperial Period,10,300,500,200,3.6302133
4181,Tenuta di Villa Spada,A,Early Imperial Period,8,-30,100,130,0.22395875
4181,Tenuta di Villa Spada,A,Mid-Imperial Period,9,100,300,200,0.22395875
4181,Tenuta di Villa Spada,A,Late Imperial Period,10,300,500,200,0.22395875
4182,Tenuta di Villa Spada,A,Late Iron Age,5,-600,-580,20,0.23579851
4182,Tenuta di Villa Spada,A,Archaic Period,6,-580,-400,180,0.23579851
4182,Tenuta di Villa Spada,B,Early Imperial Period,8,-30,100,130,0.21713586
4182,Tenuta di Villa Spada,B,Mid-Imperial Period,9,100,300,200,0.21713586
4182,Tenuta di Villa Spada,B,Late Imperial Period,10,300,500,200,0.21713586
4183,Tenuta di Villa Spada,A,Early Imperial Period,8,-30,100,130,0.23692265
4183,Tenuta di Villa Spada,A,Mid-Imperial Period,9,100,300,200,0.23692265
4183,Tenuta di Villa Spada,A,Late Imperial Period,10,300,500,200,0.23692265
4184,,A,Late Iron Age,5,-600,-580,20,0.17747378
4184,,A,Archaic Period,6,-580,-350,230,0.45888463
4184,,A,Republican Period,7,-350,-200,150,0.45888463
4184,,B,Early Imperial Period,8,-30,100,130,0.22351991
4184,,B,Mid-Imperial Period,9,100,300,200,0.22351991
4184,,B,Late Imperial Period,10,300,500,200,0.22351991
4185,Tenuta Serpentara,A,Early Imperial Period,8,-30,100,130,0.20028101
4185,Tenuta Serpentara,A,Mid-Imperial Period,9,100,300,200,0.20028101
4185,Tenuta Serpentara,A,Late Imperial Period,10,300,500,200,0.20028101
4186,Tenuta Serpentara,A,Early Imperial Period,8,-30,100,130,0.26375669
4186,Tenuta Serpentara,A,Mid-Imperial Period,9,100,300,200,0.26375669
4186,Tenuta Serpentara,A,Late Imperial Period,10,300,500,200,0.26375669
4187,Tenuta Serpentara,A,Late Iron Age,5,-700,-580,120,0.31203604
4187,Tenuta Serpentara,A,Archaic Period,6,-580,-350,230,0.31203604
4187,Tenuta Serpentara,A,Republican Period,7,-350,-200,150,0.31203604
4188,Tenuta Serpentara,A,Early Imperial Period,8,-30,100,130,0.41686267
4188,Tenuta Serpentara,A,Mid-Imperial Period,9,100,300,200,0.41686267
4188,Tenuta Serpentara,A,Late Imperial Period,10,300,500,200,0.41686267
4189,Tenuta Serpentara,A,Late Iron Age,5,-700,-580,120,0.23010154
4189,Tenuta Serpentara,B,Archaic Period,6,-580,-350,230,0.88028949
4189,Tenuta Serpentara,B,Republican Period,7,-350,-200,150,0.88028949
4189,Tenuta Serpentara,C,Early Imperial Period,8,-30,100,130,0.56089145
4189,Tenuta Serpentara,C,Mid-Imperial Period,9,100,300,200,0.56089145
4189,Tenuta Serpentara,C,Late Imperial Period,10,300,500,200,0.56089145
4190,,A,Late Iron Age,5,-600,-580,20,0.096893802
4190,,A,Archaic Period,6,-580,-350,230,0.23212095
4190,,A,Republican Period,7,-350,-100,250,0.23212095
4190,,B,Early Imperial Period,8,-30,100,130,0.27481401
4190,,B,Mid-Imperial Period,9,100,300,200,0.27481401
4190,,B,Late Imperial Period,10,300,500,200,0.27481401
4191,Tenuta Serpentara,A,Late Iron Age,5,-600,-580,20,1.3817916
4191,Tenuta Serpentara,B,Archaic Period,6,-580,-350,230,1.3817916
4191,Tenuta Serpentara,B,Republican Period,7,-350,-30,320,3.2307422
4191,Tenuta Serpentara,B,Early Imperial Period,8,-30,100,130,3.2307422
4191,Tenuta Serpentara,B,Mid-Imperial Period,9,100,300,200,3.2307422
4191,Tenuta Serpentara,B,Late Imperial Period,10,300,500,200,3.2307422
4192,,A,Republican Period,7,-50,-30,20,0.20877415
4192,,A,Early Imperial Period,8,-30,100,130,0.20877415
4193,,A,Republican Period,7,-50,-30,20,0.20877159
4193,,A,Early Imperial Period,8,-30,100,130,0.20877159
4194,,A,Early Imperial Period,8,-30,100,130,0.23124172
4194,,A,Mid-Imperial Period,9,100,300,200,0.23124172
4194,,A,Late Imperial Period,10,300,500,200,0.23124172
4195,Tenuta Tallongo,A,Late Iron Age,5,-600,-580,20,0.25896177
4195,Tenuta Tallongo,A,Archaic Period,6,-580,-500,80,0.25896177
4195,Tenuta Tallongo,B,Early Imperial Period,8,-30,100,130,0.21012148
4195,Tenuta Tallongo,B,Mid-Imperial Period,9,100,300,200,0.21012148
4195,Tenuta Tallongo,B,Late Imperial Period,10,300,500,200,0.21012148
4196,Tenuta Tallongo,A,Late Iron Age,5,-600,-580,20,0.78182358
4196,Tenuta Tallongo,A,Archaic Period,6,-580,-350,230,0.78182358
4196,Tenuta Tallongo,A,Republican Period,7,-350,-30,320,0.26243427
4196,Tenuta Tallongo,A,Early Imperial Period,8,-30,100,130,0.26243427
4196,Tenuta Tallongo,A,Mid-Imperial Period,9,100,300,200,0.26243427
4196,Tenuta Tallongo,A,Late Imperial Period,10,300,500,200,0.26243427
4197,,A,Late Iron Age,5,-600,-580,20,0.28277564
4197,,A,Archaic Period,6,-580,-400,180,0.28277564
4198,Torricella,A,Archaic Period,6,-500,-350,150,1.4968066
4198,Torricella,A,Republican Period,7,-350,-200,150,1.4968066
4198,Torricella,B,Early Imperial Period,8,-30,100,130,0.63053602
4198,Torricella,B,Mid-Imperial Period,9,100,200,100,0.63053602
4199,,A,Early Imperial Period,8,-30,100,130,0.27821609
4199,,A,Mid-Imperial Period,9,100,300,200,0.27821609
4199,,A,Late Imperial Period,10,300,500,200,0.27821609
4200,,A,Early Imperial Period,8,-30,100,130,0.24345322
4200,,A,Mid-Imperial Period,9,100,300,200,0.24345322
4200,,A,Late Imperial Period,10,300,500,200,0.24345322
4201,,A,Early Imperial Period,8,-30,100,130,0.24100356
4201,,A,Mid-Imperial Period,9,100,300,200,0.24100356
4201,,A,Late Imperial Period,10,300,500,200,0.24100356
4202,,A,Archaic Period,6,-500,-350,150,1.0222821
4202,,A,Republican Period,7,-350,-200,150,1.0222821
4202,,B,Early Imperial Period,8,-30,100,130,0.2191011
4202,,B,Mid-Imperial Period,9,100,300,200,0.2191011
4202,,B,Late Imperial Period,10,300,500,200,0.2191011
4203,,A,Early Imperial Period,8,-30,100,130,1.7274972
4203,,A,Mid-Imperial Period,9,100,300,200,1.7274972
4203,,A,Late Imperial Period,10,300,500,200,1.7274972
4204,,A,Early Imperial Period,8,-30,100,130,0.1968746
4204,,A,Mid-Imperial Period,9,100,300,200,0.1968746
4204,,A,Late Imperial Period,10,300,500,200,0.1968746
4205,,A,Early Imperial Period,8,-30,100,130,1.1686519
4205,,A,Mid-Imperial Period,9,100,300,200,1.1686519
4205,,A,Late Imperial Period,10,300,500,200,1.1686519
4206,Borgata Tufello,A,Early Imperial Period,8,-30,100,130,0.21330927
4206,Borgata Tufello,A,Mid-Imperial Period,9,100,300,200,0.21330927
4206,Borgata Tufello,A,Late Imperial Period,10,300,500,200,0.21330927
4207,,A,Late Iron Age,5,-600,-580,20,0.16663326
4207,,A,Archaic Period,6,-580,-350,230,0.37562373
4207,,A,Republican Period,7,-350,-200,150,0.37562373
4208,,A,Late Iron Age,5,-600,-580,20,0.53220016
4208,,A,Archaic Period,6,-580,-350,230,1.1869961
4208,,A,Republican Period,7,-350,-30,320,1.1869961
4208,,A,Early Imperial Period,8,-30,100,130,0.18761683
4208,,A,Mid-Imperial Period,9,100,300,200,0.18761683
4208,,A,Late Imperial Period,10,300,500,200,0.18761683
4209,,A,Mid-Imperial Period,9,100,300,200,0.21323664
4209,,A,Late Imperial Period,10,300,400,100,0.21323664
4210,,A,Late Iron Age,5,-600,-580,20,0.16148664
4210,,A,Archaic Period,6,-580,-350,230,0.41751903
4210,,A,Republican Period,7,-350,-200,150,0.41751903
4210,,B,Early Imperial Period,8,-30,100,130,0.24541689
4210,,B,Mid-Imperial Period,9,100,300,200,0.24541689
4210,,B,Late Imperial Period,10,300,500,200,0.24541689
4211,,A,Late Iron Age,5,-600,-580,20,1.8279699
4211,,A,Archaic Period,6,-580,-350,230,1.8279699
4211,,A,Republican Period,7,-350,-200,150,1.8279699
4211,,B,Early Imperial Period,8,-30,100,130,0.27134061
4211,,B,Mid-Imperial Period,9,100,300,200,0.27134061
4211,,B,Late Imperial Period,10,300,500,200,0.27134061
4212,,A,Archaic Period,6,-500,-350,150,0.36206836
4212,,A,Republican Period,7,-350,-200,150,0.36206836
4213,,A,Late Iron Age,5,-600,-580,20,0.12828073
4213,,A,Archaic Period,6,-580,-500,80,0.12828073
4214,,A,Late Iron Age,5,-600,-580,20,0.12672074
4214,,A,Archaic Period,6,-580,-350,230,0.77976698
4214,,A,Republican Period,7,-350,-30,320,0.77976698
4214,,A,Early Imperial Period,8,-30,100,130,0.22840993
4215,,A,Late Iron Age,5,-600,-580,20,0.26987144
4215,,A,Archaic Period,6,-580,-500,80,0.26987144
4216,,A,Late Iron Age,5,-600,-580,20,0.71642709
4216,,A,Archaic Period,6,-580,-350,230,0.71642709
4216,,A,Republican Period,7,-350,-30,320,0.71642709
4216,,A,Early Imperial Period,8,-30,100,130,0.21590079
4216,,A,Mid-Imperial Period,9,100,300,200,0.21590079
4216,,A,Late Imperial Period,10,300,500,200,0.21590079
4217,,A,Late Iron Age,5,-600,-580,20,0.58468044
4217,,A,Archaic Period,6,-580,-350,230,0.58468044
4217,,A,Republican Period,7,-350,-200,150,0.58468044
4218,Casale 1a Unita',A,Late Iron Age,5,-600,-580,20,0.45975333
4218,Casale 1a Unita',A,Archaic Period,6,-580,-350,230,0.45975333
4218,Casale 1a Unita',A,Republican Period,7,-350,-200,150,0.45975333
4219,,A,Late Iron Age,5,-600,-580,20,0.67411232
4219,,A,Archaic Period,6,-580,-400,180,0.67411232
4219,,B,Early Imperial Period,8,-30,100,130,0.20250198
4219,,B,Mid-Imperial Period,9,100,300,200,0.20250198
4219,,B,Late Imperial Period,10,300,500,200,0.20250198
4220,Tenuta Boccone,A,Late Iron Age,5,-600,-580,20,0.23257719
4220,Tenuta Boccone,A,Archaic Period,6,-580,-350,230,0.5317663
4220,Tenuta Boccone,A,Republican Period,7,-350,-300,50,0.5317663
4221,Casale Boccone,A,Late Iron Age,5,-600,-580,20,0.59124684
4221,Casale Boccone,A,Archaic Period,6,-580,-350,230,1.1367847
4221,Casale Boccone,A,Republican Period,7,-350,-200,150,1.1367847
4222,,A,Late Iron Age,5,-700,-580,120,1.8628803
4222,,A,Archaic Period,6,-580,-350,230,1.8628803
4222,,A,Republican Period,7,-350,-300,50,1.8628803
4222,,B,Early Imperial Period,8,-30,100,130,0.20072663
4222,,B,Mid-Imperial Period,9,100,300,200,0.20072663
4222,,B,Late Imperial Period,10,300,500,200,0.20072663
4223,,A,Republican Period,7,-50,-30,20,0.22643857
4223,,A,Early Imperial Period,8,-30,100,130,0.22643857
4223,,A,Mid-Imperial Period,9,100,300,200,0.22643857
4223,,A,Late Imperial Period,10,300,400,100,0.22643857
4224,,A,Late Iron Age,5,-600,-580,20,1.3040007
4224,,A,Archaic Period,6,-580,-350,230,1.3040007
4224,,A,Republican Period,7,-350,-200,150,1.3040007
4224,,B,Early Imperial Period,8,-30,100,130,0.25181413
4224,,B,Mid-Imperial Period,9,100,300,200,0.25181413
4224,,B,Late Imperial Period,10,300,500,200,0.25181413
4225,,A,Early Imperial Period,8,-30,100,130,0.22565918
4225,,A,Mid-Imperial Period,9,100,300,200,0.22565918
4225,,A,Late Imperial Period,10,300,500,200,0.22565918
4226,,A,Late Iron Age,5,-600,-580,20,0.3740916
4226,,A,Archaic Period,6,-580,-400,180,0.3740916
4227,,A,Early Imperial Period,8,-30,100,130,0.21840551
4227,,A,Mid-Imperial Period,9,100,300,200,0.21840551
4227,,A,Late Imperial Period,10,300,500,200,0.21840551
4228,,A,Archaic Period,6,-400,-350,50,0.46296582
4228,,A,Republican Period,7,-350,-200,150,0.46296582
4228,,B,Early Imperial Period,8,-30,100,130,0.21114051
4228,,B,Mid-Imperial Period,9,100,300,200,0.21114051
4228,,B,Late Imperial Period,10,300,500,200,0.21114051
4229,,A,Early Imperial Period,8,-30,100,130,0.28770217
4229,,A,Mid-Imperial Period,9,100,300,200,0.28770217
4229,,A,Late Imperial Period,10,300,500,200,0.28770217
4230,,A,Late Iron Age,5,-600,-580,20,0.75602227
4230,,A,Archaic Period,6,-580,-350,230,0.75602227
4230,,A,Republican Period,7,-350,-200,150,0.75602227
4230,,B,Early Imperial Period,8,-30,100,130,0.31687418
4230,,B,Mid-Imperial Period,9,100,300,200,0.31687418
4230,,B,Late Imperial Period,10,300,500,200,0.31687418
4231,,A,Early Imperial Period,8,-30,100,130,0.28223604
4231,,A,Mid-Imperial Period,9,100,200,100,0.28223604
4232,,A,Late Iron Age,5,-600,-580,20,0.1460941
4232,,A,Archaic Period,6,-580,-500,80,0.1460941
4233,,A,Archaic Period,6,-400,-350,50,0.30582881
4233,,A,Republican Period,7,-350,-200,150,0.30582881
4234,,A,Early Imperial Period,8,-30,100,130,0.27633002
4234,,A,Mid-Imperial Period,9,100,300,200,0.27633002
4234,,A,Late Imperial Period,10,300,500,200,0.27633002
4235,,A,Early Imperial Period,8,-30,100,130,1.7360221
4235,,A,Mid-Imperial Period,9,100,300,200,1.7360221
4235,,A,Late Imperial Period,10,300,500,200,1.7360221
4236,,A,Early Imperial Period,8,-30,100,130,0.2486245
4236,,A,Mid-Imperial Period,9,100,300,200,0.2486245
4236,,A,Late Imperial Period,10,300,500,200,0.2486245
4237,,A,Late Iron Age,5,-600,-580,20,0.1414126
4237,,A,Archaic Period,6,-580,-500,80,0.1414126
4238,,A,Republican Period,7,-100,-30,70,0.25746131
4238,,A,Early Imperial Period,8,-30,100,130,0.25746131
4238,,A,Mid-Imperial Period,9,100,300,200,0.25746131
4238,,A,Late Imperial Period,10,300,500,200,0.25746131
4239,,A,Early Imperial Period,8,-30,100,130,0.22795096
4239,,A,Mid-Imperial Period,9,100,300,200,0.22795096
4239,,A,Late Imperial Period,10,300,500,200,0.22795096
4240,,A,Early Imperial Period,8,-30,100,130,0.23803319
4240,,A,Mid-Imperial Period,9,100,300,200,0.23803319
4240,,A,Late Imperial Period,10,300,500,200,0.23803319
4241,,A,Early Imperial Period,8,-30,100,130,0.26464769
4241,,A,Mid-Imperial Period,9,100,200,100,0.26464769
4242,,A,Early Imperial Period,8,-30,100,130,0.24788314
4242,,A,Mid-Imperial Period,9,100,300,200,0.24788314
4242,,A,Late Imperial Period,10,300,500,200,0.24788314
4243,,A,Early Imperial Period,8,-30,100,130,0.2566143
4243,,A,Mid-Imperial Period,9,100,300,200,0.2566143
4243,,A,Late Imperial Period,10,300,500,200,0.2566143
4244,Monte Sacro,A,Republican Period,7,-100,-30,70,0.91910911
4244,Monte Sacro,A,Early Imperial Period,8,-30,100,130,0.91910911
4244,Monte Sacro,A,Mid-Imperial Period,9,100,300,200,0.91910911
4244,Monte Sacro,A,Late Imperial Period,10,300,500,200,0.91910911
4245,Monte Sacro,A,Republican Period,7,-200,-30,170,0.63872463
4245,Monte Sacro,A,Early Imperial Period,8,-30,100,130,0.46562478
4245,Monte Sacro,A,Mid-Imperial Period,9,100,300,200,0.46562478
4245,Monte Sacro,A,Late Imperial Period,10,300,500,200,0.46562478
4246,Monte Sacro,A,Early Imperial Period,8,-30,100,130,0.19557576
4246,Monte Sacro,A,Mid-Imperial Period,9,100,300,200,0.19557576
4246,Monte Sacro,A,Late Imperial Period,10,300,500,200,0.19557576
4247,Monte Sacro,A,Republican Period,7,-100,-30,70,0.51044816
4247,Monte Sacro,A,Early Imperial Period,8,-30,100,130,0.51044816
4247,Monte Sacro,A,Mid-Imperial Period,9,100,300,200,0.51044816
4247,Monte Sacro,A,Late Imperial Period,10,300,500,200,0.51044816
4248,Monte Sacro,A,Republican Period,7,-50,-30,20,0.17845392
4248,Monte Sacro,A,Early Imperial Period,8,-30,100,130,0.17845392
4249,Monte Sacro,A,Republican Period,7,-50,-30,20,0.52509689
4249,Monte Sacro,A,Early Imperial Period,8,-30,100,130,0.52509689
4250,Casal de' Pazzi,A,Late Iron Age,5,-600,-580,20,1.9668227
4250,Casal de' Pazzi,A,Archaic Period,6,-580,-350,230,1.9668227
4250,Casal de' Pazzi,A,Republican Period,7,-350,-200,150,1.9668227
4250,Casal de' Pazzi,B,Early Imperial Period,8,-30,100,130,0.42746693
4250,Casal de' Pazzi,B,Mid-Imperial Period,9,100,300,200,0.42746693
4250,Casal de' Pazzi,B,Late Imperial Period,10,300,500,200,0.42746693
4251,Casal de' Pazzi,A,Early Imperial Period,8,-30,100,130,0.21042813
4252,,A,Early Imperial Period,8,-30,100,130,0.15295699
4252,,A,Mid-Imperial Period,9,100,300,200,0.15295699
4252,,A,Late Imperial Period,10,300,500,200,0.15295699
4253,,A,Early Imperial Period,8,-30,100,130,0.15295346
4253,,A,Mid-Imperial Period,9,100,300,200,0.15295346
4253,,A,Late Imperial Period,10,300,500,200,0.15295346
4254,,A,Early Imperial Period,8,-30,100,130,0.22384113
4254,,A,Mid-Imperial Period,9,100,300,200,0.22384113
4254,,A,Late Imperial Period,10,300,500,200,0.22384113
4255,,A,Early Imperial Period,8,-30,100,130,0.21141811
4255,,A,Mid-Imperial Period,9,100,300,200,0.21141811
4255,,A,Late Imperial Period,10,300,500,200,0.21141811
4256,,A,Late Iron Age,5,-600,-580,20,0.59436995
4256,,A,Archaic Period,6,-580,-400,180,0.59436995
4256,,B,Early Imperial Period,8,-30,100,130,0.18634857
4256,,B,Mid-Imperial Period,9,100,300,200,0.18634857
4256,,B,Late Imperial Period,10,300,500,200,0.18634857
4257,,A,Archaic Period,6,-500,-400,100,0.20545679
4258,,A,Late Iron Age,5,-600,-580,20,0.54156083
4258,,A,Archaic Period,6,-580,-400,180,0.54156083
4258,,B,Early Imperial Period,8,-30,100,130,0.21130399
4258,,B,Mid-Imperial Period,9,100,300,200,0.21130399
4258,,B,Late Imperial Period,10,300,500,200,0.21130399
4259,,A,Early Imperial Period,8,-30,100,130,0.25790843
4259,,A,Mid-Imperial Period,9,100,300,200,0.25790843
4259,,A,Late Imperial Period,10,300,500,200,0.25790843
4260,,A,Early Imperial Period,8,-30,100,130,0.24818066
4260,,A,Mid-Imperial Period,9,100,300,200,0.24818066
4260,,A,Late Imperial Period,10,300,500,200,0.24818066
4261,,A,Early Imperial Period,8,-30,100,130,0.25454628
4261,,A,Mid-Imperial Period,9,100,300,200,0.25454628
4261,,A,Late Imperial Period,10,300,500,200,0.25454628
4262,,A,Early Imperial Period,8,-30,100,130,0.27555889
4262,,A,Mid-Imperial Period,9,100,300,200,0.27555889
4262,,A,Late Imperial Period,10,300,500,200,0.27555889
4263,,A,Early Imperial Period,8,-30,100,130,1.2029301
4263,,A,Mid-Imperial Period,9,100,300,200,1.2029301
4263,,A,Late Imperial Period,10,300,500,200,1.2029301
4264,,A,Late Iron Age,5,-700,-580,120,1.6669213
4264,,A,Archaic Period,6,-580,-350,230,1.6669213
4264,,A,Republican Period,7,-350,-200,150,1.6669213
4264,,B,Early Imperial Period,8,-30,100,130,0.23273411
4264,,B,Mid-Imperial Period,9,100,300,200,0.23273411
4264,,B,Late Imperial Period,10,300,500,200,0.23273411
4265,,A,Late Iron Age,5,-600,-580,20,1.3488023
4265,,A,Archaic Period,6,-580,-350,230,1.3488023
4265,,A,Republican Period,7,-350,-300,50,1.3488023
4265,,B,Early Imperial Period,8,-30,100,130,0.24669123
4265,,B,Mid-Imperial Period,9,100,300,200,0.24669123
4265,,B,Late Imperial Period,10,300,500,200,0.24669123
4266,,A,Late Iron Age,5,-600,-580,20,1.0253534
4266,,A,Archaic Period,6,-580,-350,230,1.0253534
4266,,A,Republican Period,7,-350,-200,150,1.0253534
4266,,B,Early Imperial Period,8,-30,100,130,0.20790866
4266,,B,Mid-Imperial Period,9,100,300,200,0.20790866
4266,,B,Late Imperial Period,10,300,500,200,0.20790866
4267,,A,Archaic Period,6,-500,-400,100,2.2006087
4267,,B,Early Imperial Period,8,-30,100,130,0.71177912
4267,,B,Mid-Imperial Period,9,100,300,200,0.71177912
4267,,B,Late Imperial Period,10,300,500,200,0.71177912
4268,,A,Late Iron Age,5,-600,-580,20,0.24925777
4268,,A,Archaic Period,6,-580,-500,80,0.24925777
4269,Casale Bocone,A,Late Iron Age,5,-600,-580,20,0.096681982
4269,Casale Bocone,A,Archaic Period,6,-580,-400,180,0.096681982
4270,,A,Late Iron Age,5,-600,-580,20,0.45111743
4270,,A,Archaic Period,6,-580,-400,180,0.45111743
4270,,B,Early Imperial Period,8,-30,100,130,0.19758774
4270,,B,Mid-Imperial Period,9,100,300,200,0.19758774
4270,,B,Late Imperial Period,10,300,500,200,0.19758774
4271,,A,Late Iron Age,5,-600,-580,20,0.22085299
4271,,A,Archaic Period,6,-580,-400,180,0.22085299
4272,,A,Republican Period,7,-100,-30,70,0.25817367
4272,,A,Early Imperial Period,8,-30,100,130,0.25817367
4273,,A,Early Imperial Period,8,-30,100,130,0.22944376
4273,,A,Mid-Imperial Period,9,100,300,200,0.22944376
4273,,A,Late Imperial Period,10,300,500,200,0.22944376
4274,,A,Archaic Period,6,-500,-350,150,0.58683467
4274,,A,Republican Period,7,-350,-300,50,0.58683467
4275,,A,Late Iron Age,5,-600,-580,20,0.38210192
4275,,A,Archaic Period,6,-580,-400,180,0.38210192
4275,,B,Early Imperial Period,8,-30,100,130,0.22094548
4275,,B,Mid-Imperial Period,9,100,300,200,0.22094548
4275,,B,Late Imperial Period,10,300,500,200,0.22094548
4276,,A,Archaic Period,6,-400,-350,50,0.46579146
4276,,A,Republican Period,7,-350,-200,150,0.46579146
4276,,B,Early Imperial Period,8,-30,100,130,0.20048694
4276,,B,Mid-Imperial Period,9,100,300,200,0.20048694
4276,,B,Late Imperial Period,10,300,500,200,0.20048694
4277,,A,Late Iron Age,5,-600,-580,20,0.21210676
4277,,A,Archaic Period,6,-580,-500,80,0.21210676
4278,,A,Late Iron Age,5,-600,-580,20,0.47808746
4278,,A,Archaic Period,6,-580,-500,80,0.47808746
4279,,A,Late Iron Age,5,-600,-580,20,4.3324585
4279,,A,Archaic Period,6,-580,-400,180,4.3324585
4279,,B,Early Imperial Period,8,-30,100,130,0.47012141
4279,,B,Mid-Imperial Period,9,100,300,200,0.47012141
4279,,B,Late Imperial Period,10,300,500,200,0.47012141
4280,,A,Late Iron Age,5,-600,-580,20,0.48307469
4280,,A,Archaic Period,6,-580,-350,230,0.48307469
4280,,A,Republican Period,7,-350,-300,50,0.48307469
4281,,A,Early Imperial Period,8,-30,100,130,0.24784616
4281,,A,Mid-Imperial Period,9,100,300,200,0.24784616
4281,,A,Late Imperial Period,10,300,500,200,0.24784616
4282,,A,Late Iron Age,5,-600,-580,20,0.36930433
4282,,A,Archaic Period,6,-580,-500,80,0.36930433
4283,,A,Archaic Period,6,-500,-350,150,0.4755576
4283,,A,Republican Period,7,-350,-300,50,0.4755576
4284,,A,Late Iron Age,5,-600,-580,20,0.56180346
4284,,A,Archaic Period,6,-580,-350,230,0.56180346
4284,,A,Republican Period,7,-350,-300,50,0.56180346
4285,,A,Archaic Period,6,-400,-350,50,0.54864633
4285,,A,Republican Period,7,-350,-30,320,0.54864633
4285,,A,Early Imperial Period,8,-30,100,130,0.2441543
4285,,A,Mid-Imperial Period,9,100,300,200,0.2441543
4285,,A,Late Imperial Period,10,300,500,200,0.2441543
4286,,A,Archaic Period,6,-400,-350,50,0.7330361
4286,,A,Republican Period,7,-350,-30,320,0.7330361
4286,,A,Early Imperial Period,8,-30,100,130,1.0729601
4286,,A,Mid-Imperial Period,9,100,300,200,1.0729601
4286,,A,Late Imperial Period,10,300,500,200,1.0729601
4287,,A,Late Iron Age,5,-600,-580,20,1.6824723
4287,,A,Archaic Period,6,-580,-350,230,1.6824723
4287,,A,Republican Period,7,-350,-30,320,1.6824723
4287,,A,Early Imperial Period,8,-30,100,130,0.47598609
4287,,A,Mid-Imperial Period,9,100,300,200,0.47598609
4287,,A,Late Imperial Period,10,300,500,200,0.47598609
4288,,A,Middle Bronze Age,2,-1700,-1300,400,0.31485069
4289,,A,Republican Period,7,-100,-30,70,0.20513484
4289,,A,Early Imperial Period,8,-30,100,130,0.20513484
4290,,A,Early Imperial Period,8,-30,100,130,0.24983084
4290,,A,Mid-Imperial Period,9,100,300,200,0.24983084
4290,,A,Late Imperial Period,10,300,500,200,0.24983084
4291,,A,Archaic Period,6,-500,-350,150,0.62581897
4291,,A,Republican Period,7,-350,-300,50,0.62581897
4292,Cures Sabini,A,Late Iron Age,5,-700,-580,120,23.167747
4292,Cures Sabini,A,Archaic Period,6,-580,-350,230,23.167747
4292,Cures Sabini,A,Republican Period,7,-350,-30,320,9.0257034
4292,Cures Sabini,A,Early Imperial Period,8,-30,100,130,9.0257034
4292,Cures Sabini,A,Mid-Imperial Period,9,100,300,200,9.0257034
4292,Cures Sabini,A,Late Imperial Period,10,300,500,200,9.0257034
4293,,A,Republican Period,7,-150,-30,120,1.3863624
4293,,A,Early Imperial Period,8,-30,100,130,1.3863624
4293,,A,Mid-Imperial Period,9,100,200,100,1.3863624
4294,colle Bernabei,A,Early Imperial Period,8,-30,100,130,0.35251001
4294,colle Bernabei,A,Mid-Imperial Period,9,100,200,100,0.35251001
4295,colle Bernabei,A,Early Imperial Period,8,-30,100,130,0.18272187
4295,colle Bernabei,A,Mid-Imperial Period,9,100,200,100,0.18272187
4296,colle Bernabei,A,Archaic Period,6,-500,-350,150,0.73849088
4296,colle Bernabei,A,Republican Period,7,-350,-30,320,0.73849088
4296,colle Bernabei,A,Early Imperial Period,8,-30,100,130,0.73849088
4296,colle Bernabei,A,Mid-Imperial Period,9,100,200,100,0.73849088
4297,,A,Early Imperial Period,8,-30,100,130,0.32715204
4297,,A,Mid-Imperial Period,9,100,200,100,0.32715204
4298,Zara Madonna,A,Early Iron Age,4,-1000,-750,250,1.1053125
4298,Zara Madonna,A,Late Iron Age,5,-750,-580,170,1.1053125
4298,Zara Madonna,A,Archaic Period,6,-580,-350,230,1.1053125
4298,Zara Madonna,A,Republican Period,7,-350,-30,320,1.1053125
4298,Zara Madonna,A,Early Imperial Period,8,-30,100,130,1.1053125
4298,Zara Madonna,A,Mid-Imperial Period,9,100,300,200,1.1053125
4298,Zara Madonna,A,Late Imperial Period,10,300,500,200,1.1053125
4299,,A,Early Imperial Period,8,-30,100,130,0.84282094
4299,,A,Mid-Imperial Period,9,100,200,100,0.84282094
4300,,A,Archaic Period,6,-500,-350,150,0.94356489
4300,,A,Republican Period,7,-350,-30,320,0.94356489
4300,,A,Early Imperial Period,8,-30,100,130,0.94356489
4300,,A,Mid-Imperial Period,9,100,200,100,0.94356489
4301,,A,Late Iron Age,5,-600,-580,20,1.8615099
4301,,A,Archaic Period,6,-580,-350,230,1.8615099
4301,,A,Republican Period,7,-350,-30,320,1.8615099
4301,,A,Early Imperial Period,8,-30,100,130,1.8615099
4301,,A,Mid-Imperial Period,9,100,200,100,1.8615099
4302,,A,Early Imperial Period,8,-30,100,130,0.5017876
4302,,A,Mid-Imperial Period,9,100,200,100,0.5017876
4303,,A,Early Imperial Period,8,-30,100,130,0.60468739
4303,,A,Mid-Imperial Period,9,100,200,100,0.60468739
4304,,A,Archaic Period,6,-500,-350,150,0.55654359
4304,,A,Republican Period,7,-350,-30,320,0.55654359
4304,,A,Early Imperial Period,8,-30,100,130,0.55654359
4304,,A,Mid-Imperial Period,9,100,200,100,0.55654359
4305,,A,Early Imperial Period,8,-30,100,130,0.56187248
4305,,A,Mid-Imperial Period,9,100,200,100,0.56187248
4306,,A,Archaic Period,6,-500,-350,150,0.2379556
4306,,A,Republican Period,7,-350,-30,320,0.2379556
4306,,A,Early Imperial Period,8,-30,100,130,0.2379556
4306,,A,Mid-Imperial Period,9,100,200,100,0.2379556
4307,,A,Early Imperial Period,8,-30,100,130,0.33064988
4307,,A,Mid-Imperial Period,9,100,200,100,0.33064988
4308,,A,Archaic Period,6,-400,-350,50,0.55391657
4308,,A,Republican Period,7,-350,-30,320,0.55391657
4308,,A,Early Imperial Period,8,-30,100,130,0.55391657
4308,,A,Mid-Imperial Period,9,100,200,100,0.55391657
4309,,A,Early Imperial Period,8,-30,100,130,0.46079507
4309,,A,Mid-Imperial Period,9,100,200,100,0.46079507
4310,,A,Early Imperial Period,8,-30,100,130,0.58738261
4310,,A,Mid-Imperial Period,9,100,200,100,0.58738261
4311,,A,Republican Period,7,-300,-30,270,0.57665741
4311,,A,Early Imperial Period,8,-30,100,130,0.57665741
4311,,A,Mid-Imperial Period,9,100,200,100,0.57665741
4312,,A,Archaic Period,6,-400,-350,50,0.54056209
4312,,A,Republican Period,7,-350,-30,320,0.54056209
4312,,A,Early Imperial Period,8,-30,100,130,0.54056209
4312,,A,Mid-Imperial Period,9,100,200,100,0.54056209
4313,,A,Early Imperial Period,8,-30,100,130,0.92329806
4313,,A,Mid-Imperial Period,9,100,200,100,0.92329806
4314,Casarino,A,Early Imperial Period,8,-30,100,130,0.67240286
4314,Casarino,A,Mid-Imperial Period,9,100,300,200,0.67240286
4314,Casarino,A,Late Imperial Period,10,300,500,200,0.67240286
4315,,A,Early Imperial Period,8,-30,100,130,0.86431831
4315,,A,Mid-Imperial Period,9,100,200,100,0.86431831
4316,Grottaglia,A,Early Imperial Period,8,-30,100,130,0.63798249
4316,Grottaglia,A,Mid-Imperial Period,9,100,200,100,0.63798249
4317,,A,Early Imperial Period,8,-30,100,130,0.53502917
4317,,A,Mid-Imperial Period,9,100,200,100,0.53502917
4318,Grotta di Torri,A,Republican Period,7,-150,-30,120,1.0789723
4318,Grotta di Torri,A,Early Imperial Period,8,-30,100,130,1.0789723
4318,Grotta di Torri,A,Mid-Imperial Period,9,100,300,200,1.0789723
4318,Grotta di Torri,A,Late Imperial Period,10,300,500,200,1.0789723
4319,,A,Early Imperial Period,8,-30,100,130,0.49142283
4319,,A,Mid-Imperial Period,9,100,200,100,0.49142283
4320,,A,Early Imperial Period,8,-30,100,130,0.61300105
4320,,A,Mid-Imperial Period,9,100,200,100,0.61300105
4321,Casale dello Stallone,A,Early Imperial Period,8,-30,100,130,0.54711282
4321,Casale dello Stallone,A,Mid-Imperial Period,9,100,200,100,0.54711282
4322,Colle del Dottore,A,Archaic Period,6,-400,-350,50,1.0241824
4322,Colle del Dottore,A,Republican Period,7,-350,-30,320,1.0241824
4322,Colle del Dottore,A,Early Imperial Period,8,-30,100,130,1.0241824
4322,Colle del Dottore,A,Mid-Imperial Period,9,100,300,200,1.0241824
4322,Colle del Dottore,A,Late Imperial Period,10,300,500,200,1.0241824
4323,,A,Early Imperial Period,8,-30,100,130,0.5235303
4323,,A,Mid-Imperial Period,9,100,200,100,0.5235303
4324,,A,Early Imperial Period,8,-30,100,130,0.54354048
4324,,A,Mid-Imperial Period,9,100,200,100,0.54354048
4325,,A,Early Imperial Period,8,-30,100,130,0.44907597
4325,,A,Mid-Imperial Period,9,100,200,100,0.44907597
4326,,A,Republican Period,7,-100,-30,70,0.63794565
4326,,A,Early Imperial Period,8,-30,100,130,0.63794565
4326,,A,Mid-Imperial Period,9,100,200,100,0.63794565
4327,Casale dell'Oppio,A,Early Imperial Period,8,-30,100,130,0.64948064
4327,Casale dell'Oppio,A,Mid-Imperial Period,9,100,200,100,0.64948064
4328,,A,Early Imperial Period,8,-30,100,130,0.30245343
4328,,A,Mid-Imperial Period,9,100,200,100,0.30245343
4329,,A,Early Imperial Period,8,-30,100,130,0.51799065
4329,,A,Mid-Imperial Period,9,100,200,100,0.51799065
4330,,A,Archaic Period,6,-400,-350,50,0.57211107
4330,,A,Republican Period,7,-350,-30,320,0.57211107
4330,,A,Early Imperial Period,8,-30,100,130,0.57211107
4330,,A,Mid-Imperial Period,9,100,200,100,0.57211107
4331,,A,Republican Period,7,-100,-30,70,1.1487559
4331,,A,Early Imperial Period,8,-30,100,130,1.1487559
4331,,A,Mid-Imperial Period,9,100,200,100,1.1487559
4332,,A,Archaic Period,6,-400,-350,50,0.94118267
4332,,A,Republican Period,7,-350,-30,320,0.94118267
4332,,A,Early Imperial Period,8,-30,100,130,0.94118267
4332,,A,Mid-Imperial Period,9,100,200,100,0.94118267
4333,,A,Early Imperial Period,8,-30,100,130,0.57493931
4333,,A,Mid-Imperial Period,9,100,200,100,0.57493931
4334,,A,Early Iron Age,4,-1000,-750,250,0.1140355
4334,,A,Late Iron Age,5,-750,-580,170,0.1140355
4334,,A,Archaic Period,6,-580,-350,230,0.7592141
4334,,A,Republican Period,7,-350,-30,320,0.7592141
4334,,A,Early Imperial Period,8,-30,100,130,0.7592141
4334,,A,Mid-Imperial Period,9,100,300,200,0.7592141
4334,,A,Late Imperial Period,10,300,500,200,0.7592141
4335,,A,Archaic Period,6,-400,-350,50,0.83212459
4335,,A,Republican Period,7,-350,-30,320,0.83212459
4335,,A,Early Imperial Period,8,-30,100,130,0.83212459
4335,,A,Mid-Imperial Period,9,100,300,200,0.83212459
4335,,A,Late Imperial Period,10,300,500,200,0.83212459
4336,,A,Early Imperial Period,8,-30,100,130,0.42589992
4336,,A,Mid-Imperial Period,9,100,200,100,0.42589992
4337,Caprola,A,Early Imperial Period,8,-30,100,130,0.74123353
4337,Caprola,A,Mid-Imperial Period,9,100,200,100,0.74123353
4338,,A,Early Imperial Period,8,-30,100,130,0.90044397
4338,,A,Mid-Imperial Period,9,100,200,100,0.90044397
4339,,A,Archaic Period,6,-400,-350,50,0.98028237
4339,,A,Republican Period,7,-350,-30,320,0.98028237
4339,,A,Early Imperial Period,8,-30,100,130,0.98028237
4339,,A,Mid-Imperial Period,9,100,200,100,0.98028237
4440,,A,Late Iron Age,5,-600,-580,20,0.24034822
4440,,A,Archaic Period,6,-580,-350,230,0.24034822
4440,,A,Republican Period,7,-350,-30,320,0.24034822
4440,,A,Early Imperial Period,8,-30,100,130,0.24034822
4440,,A,Mid-Imperial Period,9,100,200,100,0.24034822
4441,,A,Archaic Period,6,-400,-350,50,0.23828201
4441,,A,Republican Period,7,-350,-30,320,0.23828201
4441,,A,Early Imperial Period,8,-30,100,130,0.23828201
4441,,A,Mid-Imperial Period,9,100,200,100,0.23828201
4442,,A,Early Imperial Period,8,-30,100,130,0.1937149
4442,,A,Mid-Imperial Period,9,100,200,100,0.1937149
4443,,A,Early Imperial Period,8,-30,100,130,0.19371131
4443,,A,Mid-Imperial Period,9,100,200,100,0.19371131
4444,,A,Archaic Period,6,-400,-350,50,0.86494446
4444,,A,Republican Period,7,-350,-30,320,0.86494446
4444,,A,Early Imperial Period,8,-30,100,130,0.86494446
4444,,A,Mid-Imperial Period,9,100,200,100,0.86494446
4445,,A,Early Imperial Period,8,-30,100,130,0.56115925
4445,,A,Mid-Imperial Period,9,100,200,100,0.56115925
4446,,A,Early Imperial Period,8,-30,100,130,1.0606652
4446,,A,Mid-Imperial Period,9,100,200,100,1.0606652
4447,,A,Late Iron Age,5,-600,-580,20,0.26906449
4447,,A,Archaic Period,6,-580,-350,230,0.26906449
4447,,A,Republican Period,7,-350,-30,320,0.26906449
4447,,A,Early Imperial Period,8,-30,100,130,0.26906449
4447,,A,Mid-Imperial Period,9,100,200,100,0.26906449
4448,,A,Late Iron Age,5,-600,-580,20,2.3410006
4448,,A,Archaic Period,6,-580,-350,230,2.3410006
4448,,A,Republican Period,7,-350,-30,320,2.3410006
4448,,A,Early Imperial Period,8,-30,100,130,2.3410006
4448,,A,Mid-Imperial Period,9,100,200,100,2.3410006
4449,,A,Early Imperial Period,8,-30,100,130,0.52187884
4449,,A,Mid-Imperial Period,9,100,200,100,0.52187884
4450,,A,Early Imperial Period,8,-30,100,130,0.66048855
4450,,A,Mid-Imperial Period,9,100,200,100,0.66048855
4451,,A,Early Imperial Period,8,-30,100,130,0.46618298
4451,,A,Mid-Imperial Period,9,100,200,100,0.46618298
4452,,A,Early Imperial Period,8,-30,100,130,0.76285857
4452,,A,Mid-Imperial Period,9,100,200,100,0.76285857
4453,,A,Early Imperial Period,8,-30,100,130,0.2503776
4453,,A,Mid-Imperial Period,9,100,200,100,0.2503776
4454,,A,Late Iron Age,5,-600,-580,20,0.16020741
4454,,A,Archaic Period,6,-580,-350,230,0.16020741
4454,,A,Republican Period,7,-350,-30,320,0.16020741
4455,,A,Late Iron Age,5,-600,-580,20,0.52087498
4455,,A,Archaic Period,6,-580,-350,230,0.52087498
4455,,A,Republican Period,7,-350,-30,320,0.52087498
4455,,A,Early Imperial Period,8,-30,100,130,0.52087498
4455,,A,Mid-Imperial Period,9,100,200,100,0.52087498
4456,,A,Early Imperial Period,8,-30,100,130,0.54694098
4456,,A,Mid-Imperial Period,9,100,200,100,0.54694098
4457,,A,Early Imperial Period,8,-30,100,130,1.1591865
4457,,A,Mid-Imperial Period,9,100,300,200,1.1591865
4457,,A,Late Imperial Period,10,300,500,200,1.1591865
4458,,A,Early Imperial Period,8,-30,100,130,0.45990455
4458,,A,Mid-Imperial Period,9,100,200,100,0.45990455
4459,,A,Early Imperial Period,8,-30,100,130,0.47512054
4459,,A,Mid-Imperial Period,9,100,200,100,0.47512054
4460,,A,Archaic Period,6,-400,-350,50,0.68584722
4460,,A,Republican Period,7,-350,-30,320,0.68584722
4460,,A,Early Imperial Period,8,-30,100,130,0.68584722
4460,,A,Mid-Imperial Period,9,100,300,200,0.68584722
4460,,A,Late Imperial Period,10,300,500,200,0.68584722
4461,Casale dell'Orso,A,Late Iron Age,5,-600,-580,20,0.73486733
4461,Casale dell'Orso,A,Archaic Period,6,-580,-350,230,0.73486733
4461,Casale dell'Orso,A,Republican Period,7,-350,-30,320,0.73486733
4461,Casale dell'Orso,A,Early Imperial Period,8,-30,100,130,0.73486733
4461,Casale dell'Orso,A,Mid-Imperial Period,9,100,300,200,0.73486733
4461,Casale dell'Orso,A,Late Imperial Period,10,300,500,200,0.73486733
4462,Casale dell'Orso,A,Late Iron Age,5,-600,-580,20,0.89051116
4462,Casale dell'Orso,A,Archaic Period,6,-580,-350,230,0.89051116
4462,Casale dell'Orso,A,Republican Period,7,-350,-30,320,0.89051116
4462,Casale dell'Orso,A,Early Imperial Period,8,-30,100,130,0.89051116
4462,Casale dell'Orso,A,Mid-Imperial Period,9,100,300,200,0.89051116
4462,Casale dell'Orso,A,Late Imperial Period,10,300,500,200,0.89051116
4463,Casale dell'Orso,A,Early Imperial Period,8,-30,100,130,0.79087859
4463,Casale dell'Orso,A,Mid-Imperial Period,9,100,200,100,0.79087859
4464,,A,Early Imperial Period,8,-30,100,130,0.48197994
4464,,A,Mid-Imperial Period,9,100,200,100,0.48197994
4465,,A,Early Imperial Period,8,-30,100,130,0.87725204
4465,,A,Mid-Imperial Period,9,100,200,100,0.87725204
4466,,A,Early Imperial Period,8,-30,100,130,0.57393813
4466,,A,Mid-Imperial Period,9,100,200,100,0.57393813
4467,,A,Early Imperial Period,8,-30,100,130,0.38009405
4467,,A,Mid-Imperial Period,9,100,200,100,0.38009405
4468,Campo del Pozzo,A,Early Imperial Period,8,-30,100,130,0.75317633
4468,Campo del Pozzo,A,Mid-Imperial Period,9,100,200,100,0.75317633
4469,Campo del Pozzo,A,Early Iron Age,4,-1000,-750,250,8.671936
4469,Campo del Pozzo,A,Late Iron Age,5,-750,-580,170,8.671936
4469,Campo del Pozzo,A,Archaic Period,6,-580,-350,230,8.671936
4469,Campo del Pozzo,A,Republican Period,7,-350,-30,320,8.671936
4470,Campo del Pero,A,Early Imperial Period,8,-30,100,130,0.3812834
4470,Campo del Pero,A,Mid-Imperial Period,9,100,200,100,0.3812834
4471,Piano di Nazzano,A,Early Imperial Period,8,-30,100,130,2.0088975
4471,Piano di Nazzano,A,Mid-Imperial Period,9,100,200,100,2.0088975
4472,,A,Late Iron Age,5,-600,-580,20,1.271062
4472,,A,Archaic Period,6,-580,-350,230,1.271062
4472,,A,Republican Period,7,-350,-30,320,1.271062
4472,,A,Early Imperial Period,8,-30,100,130,1.271062
4472,,A,Mid-Imperial Period,9,100,200,100,1.271062
4473,,A,Early Imperial Period,8,-30,100,130,0.71033138
4473,,A,Mid-Imperial Period,9,100,200,100,0.71033138
4474,,A,Early Imperial Period,8,-30,100,130,0.82120705
4474,,A,Mid-Imperial Period,9,100,200,100,0.82120705
4475,,A,Early Imperial Period,8,-30,100,130,0.6907081
4475,,A,Mid-Imperial Period,9,100,200,100,0.6907081
4476,,A,Early Imperial Period,8,-30,100,130,0.77258176
4476,,A,Mid-Imperial Period,9,100,200,100,0.77258176
4477,,A,Late Iron Age,5,-600,-580,20,0.74958444
4477,,A,Archaic Period,6,-580,-350,230,0.74958444
4477,,A,Republican Period,7,-350,-30,320,0.74958444
4478,,A,Early Imperial Period,8,-30,100,130,0.40751073
4478,,A,Mid-Imperial Period,9,100,200,100,0.40751073
4479,,A,Archaic Period,6,-400,-350,50,0.70806319
4479,,A,Republican Period,7,-350,-30,320,0.70806319
4479,,A,Early Imperial Period,8,-30,100,130,0.70806319
4479,,A,Mid-Imperial Period,9,100,200,100,0.70806319
4480,,A,Early Imperial Period,8,-30,100,130,0.56231612
4480,,A,Mid-Imperial Period,9,100,200,100,0.56231612
4481,Castellaccio,A,Republican Period,7,-150,-30,120,0.66402376
4481,Castellaccio,A,Early Imperial Period,8,-30,100,130,0.66402376
4481,Castellaccio,A,Mid-Imperial Period,9,100,200,100,0.66402376
4482,Peschiera,A,Early Imperial Period,8,-30,100,130,0.78798491
4482,Peschiera,A,Mid-Imperial Period,9,100,200,100,0.78798491
4483,,A,Early Imperial Period,8,-30,100,130,0.19376677
4483,,A,Mid-Imperial Period,9,100,200,100,0.19376677
4484,Casale Moricelli,A,Late Iron Age,5,-600,-580,20,0.45094094
4484,Casale Moricelli,A,Archaic Period,6,-580,-350,230,0.45094094
4484,Casale Moricelli,A,Republican Period,7,-350,-30,320,0.45094094
4484,Casale Moricelli,A,Early Imperial Period,8,-30,100,130,0.45094094
4484,Casale Moricelli,A,Mid-Imperial Period,9,100,200,100,0.45094094
4485,,A,Late Iron Age,5,-600,-580,20,0.22813384
4485,,A,Archaic Period,6,-580,-500,80,0.22813384
4486,Casale S. Maria,A,Late Iron Age,5,-600,-580,20,0.22813107
4486,Casale S. Maria,A,Archaic Period,6,-580,-500,80,0.22813107
4487,,A,Early Imperial Period,8,-30,100,130,1.0038567
4487,,A,Mid-Imperial Period,9,100,200,100,1.0038567
4488,,A,Early Imperial Period,8,-30,100,130,0.89168054
4488,,A,Mid-Imperial Period,9,100,300,200,0.89168054
4488,,A,Late Imperial Period,10,300,500,200,0.89168054
4489,,A,Early Imperial Period,8,-30,100,130,0.61556345
4489,,A,Mid-Imperial Period,9,100,200,100,0.61556345
4490,,A,Archaic Period,6,-500,-350,150,0.94851363
4490,,A,Republican Period,7,-350,-30,320,0.94851363
4490,,A,Early Imperial Period,8,-30,100,130,0.94851363
4490,,A,Mid-Imperial Period,9,100,200,100,0.94851363
4491,,A,Early Imperial Period,8,-30,100,130,0.75569093
4491,,A,Mid-Imperial Period,9,100,200,100,0.75569093
4492,,A,Early Imperial Period,8,-30,100,130,0.68920964
4492,,A,Mid-Imperial Period,9,100,200,100,0.68920964
4493,,A,Archaic Period,6,-500,-350,150,0.92222285
4493,,A,Republican Period,7,-350,-30,320,0.92222285
4493,,A,Early Imperial Period,8,-30,100,130,0.92222285
4493,,A,Mid-Imperial Period,9,100,200,100,0.92222285
4494,,A,Early Imperial Period,8,-30,100,130,0.70115715
4494,,A,Mid-Imperial Period,9,100,200,100,0.70115715
4495,Casale d'Arcone,A,Early Imperial Period,8,-30,100,130,0.4573988
4495,Casale d'Arcone,A,Mid-Imperial Period,9,100,200,100,0.4573988
4496,,A,Early Imperial Period,8,-30,100,130,0.38306877
4496,,A,Mid-Imperial Period,9,100,200,100,0.38306877
4497,,A,Republican Period,7,-150,-30,120,0.44774729
4498,,A,Early Imperial Period,8,-30,100,130,0.34303215
4498,,A,Mid-Imperial Period,9,100,200,100,0.34303215
4499,,A,Early Imperial Period,8,-30,100,130,0.91087401
4499,,A,Mid-Imperial Period,9,100,200,100,0.91087401
4500,,A,Archaic Period,6,-400,-350,50,0.53581649
4500,,A,Republican Period,7,-350,-30,320,0.53581649
4500,,A,Early Imperial Period,8,-30,100,130,0.53581649
4500,,A,Mid-Imperial Period,9,100,200,100,0.53581649
4501,,A,Early Imperial Period,8,-30,100,130,0.68975037
4501,,A,Mid-Imperial Period,9,100,200,100,0.68975037
4502,,A,Early Imperial Period,8,-30,100,130,1.0262781
4502,,A,Mid-Imperial Period,9,100,200,100,1.0262781
4503,,A,Republican Period,7,-150,-30,120,0.42609081
4504,,A,Archaic Period,6,-400,-350,50,0.24465573
4504,,A,Republican Period,7,-350,-30,320,0.24465573
4504,,A,Early Imperial Period,8,-30,100,130,0.24465573
4504,,A,Mid-Imperial Period,9,100,200,100,0.24465573
4505,,A,Mid-Imperial Period,9,200,300,100,0.73484302
4505,,A,Late Imperial Period,10,300,500,200,0.73484302
4506,,A,Early Imperial Period,8,-30,100,130,0.35365573
4506,,A,Mid-Imperial Period,9,100,200,100,0.35365573
4507,,A,Late Iron Age,5,-600,-580,20,1.2747781
4507,,A,Archaic Period,6,-580,-350,230,1.2747781
4507,,A,Republican Period,7,-350,-30,320,1.2747781
4507,,A,Early Imperial Period,8,-30,100,130,1.2747781
4507,,A,Mid-Imperial Period,9,100,200,100,1.2747781
4508,,A,Late Iron Age,5,-600,-580,20,0.65174866
4508,,A,Archaic Period,6,-580,-350,230,0.65174866
4508,,A,Republican Period,7,-350,-30,320,0.65174866
4508,,A,Early Imperial Period,8,-30,100,130,0.65174866
4508,,A,Mid-Imperial Period,9,100,200,100,0.65174866
4509,,A,Late Iron Age,5,-600,-580,20,0.43230039
4509,,A,Archaic Period,6,-580,-350,230,0.43230039
4509,,A,Republican Period,7,-350,-30,320,0.43230039
4509,,A,Early Imperial Period,8,-30,100,130,0.43230039
4509,,A,Mid-Imperial Period,9,100,200,100,0.43230039
4510,,A,Early Imperial Period,8,-30,100,130,0.83664149
4510,,A,Mid-Imperial Period,9,100,200,100,0.83664149
4511,,A,Archaic Period,6,-400,-350,50,0.62335223
4511,,A,Republican Period,7,-350,-30,320,0.62335223
4511,,A,Early Imperial Period,8,-30,100,130,0.62335223
4511,,A,Mid-Imperial Period,9,100,200,100,0.62335223
4512,,A,Archaic Period,6,-400,-350,50,1.0420657
4512,,A,Republican Period,7,-350,-30,320,1.0420657
4512,,A,Early Imperial Period,8,-30,100,130,1.0420657
4512,,A,Mid-Imperial Period,9,100,200,100,1.0420657
4513,,A,Late Iron Age,5,-600,-580,20,0.26648611
4513,,A,Archaic Period,6,-580,-350,230,0.26648611
4513,,A,Republican Period,7,-350,-30,320,0.26648611
4513,,A,Early Imperial Period,8,-30,100,130,0.26648611
4513,,A,Mid-Imperial Period,9,100,200,100,0.26648611
4514,,A,Late Iron Age,5,-600,-580,20,0.29731813
4514,,A,Archaic Period,6,-580,-350,230,0.29731813
4514,,A,Republican Period,7,-350,-30,320,0.29731813
4514,,A,Early Imperial Period,8,-30,100,130,0.29731813
4514,,A,Mid-Imperial Period,9,100,200,100,0.29731813
4515,,A,Early Iron Age,4,-800,-750,50,1.6096325
4515,,A,Late Iron Age,5,-750,-580,170,1.6096325
4515,,A,Archaic Period,6,-580,-500,80,1.6096325
4516,,A,Early Imperial Period,8,-30,100,130,0.3772102
4516,,A,Mid-Imperial Period,9,100,200,100,0.3772102
4517,,A,Early Imperial Period,8,-30,100,130,0.61709857
4517,,A,Mid-Imperial Period,9,100,200,100,0.61709857
4518,,A,Early Imperial Period,8,-30,100,130,0.40550575
4518,,A,Mid-Imperial Period,9,100,200,100,0.40550575
4519,,A,Early Imperial Period,8,-30,100,130,0.40549394
4519,,A,Mid-Imperial Period,9,100,200,100,0.40549394
4520,,A,Late Iron Age,5,-600,-580,20,0.42854393
4520,,A,Archaic Period,6,-580,-350,230,0.42854393
4520,,A,Republican Period,7,-350,-30,320,0.42854393
4520,,A,Early Imperial Period,8,-30,100,130,0.42854393
4520,,A,Mid-Imperial Period,9,100,200,100,0.42854393
4521,,A,Early Imperial Period,8,-30,100,130,0.18469378
4521,,A,Mid-Imperial Period,9,100,200,100,0.18469378
4522,,A,Republican Period,7,-100,-30,70,0.79051173
4522,,A,Early Imperial Period,8,-30,100,130,0.79051173
4522,,A,Mid-Imperial Period,9,100,200,100,0.79051173
4523,Fontanaccia,A,Early Imperial Period,8,-30,100,130,0.51144242
4523,Fontanaccia,A,Mid-Imperial Period,9,100,200,100,0.51144242
4524,,A,Early Imperial Period,8,-30,100,130,0.69213527
4524,,A,Mid-Imperial Period,9,100,200,100,0.69213527
4525,,A,Late Iron Age,5,-600,-580,20,0.34360468
4525,,A,Archaic Period,6,-580,-500,80,0.34360468
4526,,A,Archaic Period,6,-500,-350,150,0.3306548
4526,,A,Republican Period,7,-350,-30,320,0.3306548
4526,,A,Early Imperial Period,8,-30,100,130,0.3306548
4526,,A,Mid-Imperial Period,9,100,200,100,0.3306548
4527,,A,Early Imperial Period,8,-30,100,130,0.76397872
4527,,A,Mid-Imperial Period,9,100,300,200,0.76397872
4527,,A,Late Imperial Period,10,300,500,200,0.76397872
4528,,A,Early Imperial Period,8,-30,100,130,0.28298241
4528,,A,Mid-Imperial Period,9,100,200,100,0.28298241
4529,,A,Early Imperial Period,8,-30,100,130,0.45011416
4529,,A,Mid-Imperial Period,9,100,200,100,0.45011416
4530,,A,Early Imperial Period,8,-30,100,130,0.38173136
4530,,A,Mid-Imperial Period,9,100,200,100,0.38173136
4531,,A,Early Imperial Period,8,-30,100,130,0.2901617
4531,,A,Mid-Imperial Period,9,100,200,100,0.2901617
4532,,A,Early Imperial Period,8,-30,100,130,0.24107918
4532,,A,Mid-Imperial Period,9,100,200,100,0.24107918
4533,,A,Early Imperial Period,8,-30,100,130,0.85442311
4533,,A,Mid-Imperial Period,9,100,200,100,0.85442311
4534,,A,Early Imperial Period,8,-30,100,130,0.34125105
4534,,A,Mid-Imperial Period,9,100,300,200,0.34125105
4534,,A,Late Imperial Period,10,300,500,200,0.34125105
4535,,A,Early Imperial Period,8,-30,100,130,0.44018143
4535,,A,Mid-Imperial Period,9,100,200,100,0.44018143
4536,,A,Early Imperial Period,8,-30,100,130,0.35595542
4536,,A,Mid-Imperial Period,9,100,200,100,0.35595542
4537,Nazzano Roman Periodo,A,Early Iron Age,4,-800,-750,50,7.8361707
4537,Nazzano Roman Periodo,A,Late Iron Age,5,-750,-580,170,7.8361707
4537,Nazzano Roman Periodo,A,Archaic Period,6,-580,-350,230,7.8361707
4537,Nazzano Roman Periodo,A,Republican Period,7,-350,-30,320,0.67170089
4537,Nazzano Roman Periodo,A,Early Imperial Period,8,-30,100,130,0.67170089
4537,Nazzano Roman Periodo,A,Mid-Imperial Period,9,100,300,200,0.67170089
4537,Nazzano Roman Periodo,A,Late Imperial Period,10,300,500,200,0.67170089
4538,,A,Archaic Period,6,-400,-350,50,0.39165923
4538,,A,Republican Period,7,-350,-30,320,0.39165923
4538,,A,Early Imperial Period,8,-30,100,130,0.39165923
4538,,A,Mid-Imperial Period,9,100,200,100,0.39165923
4539,,A,Late Iron Age,5,-600,-580,20,0.410072
4539,,A,Archaic Period,6,-580,-500,80,0.410072
4539,,B,Early Imperial Period,8,-30,100,130,0.410072
4539,,B,Mid-Imperial Period,9,100,200,100,0.410072
4540,,A,Early Imperial Period,8,-30,100,130,0.42850542
4540,,A,Mid-Imperial Period,9,100,200,100,0.42850542
4541,,A,Early Imperial Period,8,-30,100,130,0.7093848
4541,,A,Mid-Imperial Period,9,100,200,100,0.7093848
4542,,A,Early Imperial Period,8,-30,100,130,0.65747201
4542,,A,Mid-Imperial Period,9,100,200,100,0.65747201
4543,,A,Republican Period,7,-100,-30,70,0.42086503
4543,,A,Early Imperial Period,8,-30,100,130,0.42086503
4543,,A,Mid-Imperial Period,9,100,200,100,0.42086503
4546,S. Piero a Grado,A,Early Imperial Period,8,1,100,99,1.1652896
4546,S. Piero a Grado,A,Mid-Imperial Period,9,100,300,200,1.1652896
4546,S. Piero a Grado,A,Late Imperial Period,10,300,400,100,1.1652896
4547,Massaciuccoli,A,Early Imperial Period,8,1,100,99,1.6341356
4547,Massaciuccoli,A,Mid-Imperial Period,9,100,200,100,1.6341356
4567,Gli Ortacci,A,Early Imperial Period,8,-30,100,130,1.6800578
4567,Gli Ortacci,A,Mid-Imperial Period,9,100,300,200,1.6800578
4567,Gli Ortacci,A,Late Imperial Period,10,300,500,200,1.6800578
4568,Pisa (Pisae),A,Early Iron Age,4,-800,-750,50,9.5516386
4568,Pisa (Pisae),A,Late Iron Age,5,-750,-580,170,9.5516386
4568,Pisa (Pisae),A,Archaic Period,6,-580,-350,230,9.5516386
4568,Pisa (Pisae),A,Republican Period,7,-350,-30,320,62.104458
4568,Pisa (Pisae),A,Early Imperial Period,8,-30,100,130,62.104458
4568,Pisa (Pisae),A,Mid-Imperial Period,9,100,300,200,62.104458
4568,Pisa (Pisae),A,Late Imperial Period,10,300,500,200,62.104458
4569,,A,Republican Period,7,-200,-30,170,9.8432865
4569,,A,Early Imperial Period,8,-30,100,130,9.8432865
4569,,A,Mid-Imperial Period,9,100,300,200,9.8432865
4569,,A,Late Imperial Period,10,300,500,200,9.8432865
4570,Poggio Zenone,A,Early Iron Age,4,-800,-750,50,0.31917208
4570,Poggio Zenone,A,Late Iron Age,5,-750,-600,150,0.31917208
4571,,A,Archaic Period,6,-400,-350,50,0.31538936
4571,,A,Republican Period,7,-350,-30,320,0.31538936
4572,Il Pelagone,A,Archaic Period,6,-400,-350,50,0.42283541
4572,Il Pelagone,A,Republican Period,7,-350,-30,320,0.42283541
4573,,A,Archaic Period,6,-500,-400,100,0.7648719
4574,,A,Republican Period,7,-200,-30,170,0.63250643
4574,,A,Early Imperial Period,8,-30,100,130,0.63250643
4574,,A,Mid-Imperial Period,9,100,300,200,0.63250643
4574,,A,Late Imperial Period,10,300,500,200,0.63250643
4575,Casa Tiro a Segno,A,Archaic Period,6,-400,-350,50,0.37730542
4575,Casa Tiro a Segno,A,Republican Period,7,-350,-30,320,0.37730542
4576,,A,Republican Period,7,-200,-30,170,0.5640679
4576,,A,Early Imperial Period,8,-30,100,130,0.5640679
4576,,A,Mid-Imperial Period,9,100,300,200,0.5640679
4576,,A,Late Imperial Period,10,300,500,200,0.5640679
4577,Torraccia della Tenuta Vezzosa,A,Middle Bronze Age,2,-1400,-1300,100,1.6176467
4577,Torraccia della Tenuta Vezzosa,A,Late Bronze Age,3,-1300,-1200,100,1.6176467
4578,Badia Vecchia,A,Republican Period,7,-300,-100,200,1.4476622
4579,Badia Vecchia,A,Late Iron Age,5,-650,-580,70,0.4725652
4579,Badia Vecchia,A,Archaic Period,6,-580,-450,130,0.4725652
4580,,A,Republican Period,7,-300,-30,270,0.52116495
4580,,A,Early Imperial Period,8,-30,100,130,0.52116495
4580,,A,Mid-Imperial Period,9,100,300,200,0.52116495
4580,,A,Late Imperial Period,10,300,500,200,0.52116495
4581,Villa Poggialberi,A,Archaic Period,6,-400,-350,50,0.33942837
4581,Villa Poggialberi,A,Republican Period,7,-350,-30,320,0.33942837
4582,,A,Republican Period,7,-200,-30,170,0.91941065
4582,,A,Early Imperial Period,8,-30,100,130,0.91941065
4582,,A,Mid-Imperial Period,9,100,300,200,0.91941065
4582,,A,Late Imperial Period,10,300,500,200,0.91941065
4583,,A,Republican Period,7,-200,-30,170,1.7693068
4583,,A,Early Imperial Period,8,-30,100,130,1.7693068
4583,,A,Mid-Imperial Period,9,100,300,200,1.7693068
4583,,A,Late Imperial Period,10,300,500,200,1.7693068
4584,,A,Late Iron Age,5,-650,-580,70,0.56418765
4584,,A,Archaic Period,6,-580,-450,130,0.56418765
4585,,A,Early Imperial Period,8,-30,100,130,0.67813903
4585,,A,Mid-Imperial Period,9,100,300,200,0.67813903
4585,,A,Late Imperial Period,10,300,500,200,0.67813903
4586,,A,Early Imperial Period,8,-30,100,130,0.64506787
4586,,A,Mid-Imperial Period,9,100,300,200,0.64506787
4586,,A,Late Imperial Period,10,300,500,200,0.64506787
4587,,A,Archaic Period,6,-400,-350,50,1.0781538
4587,,A,Republican Period,7,-350,-30,320,1.0781538
4588,,A,Republican Period,7,-200,-30,170,0.48713848
4588,,A,Early Imperial Period,8,-30,100,130,0.48713848
4588,,A,Mid-Imperial Period,9,100,300,200,0.48713848
4588,,A,Late Imperial Period,10,300,500,200,0.48713848
4589,,A,Republican Period,7,-200,-30,170,0.75565058
4589,,A,Early Imperial Period,8,-30,100,130,0.75565058
4589,,A,Mid-Imperial Period,9,100,300,200,0.75565058
4589,,A,Late Imperial Period,10,300,500,200,0.75565058
4590,,A,Republican Period,7,-200,-30,170,0.73518848
4590,,A,Early Imperial Period,8,-30,100,130,0.73518848
4590,,A,Mid-Imperial Period,9,100,200,100,0.73518848
4591,,A,Republican Period,7,-200,-30,170,0.64801759
4592,,A,Archaic Period,6,-400,-350,50,1.3575951
4592,,A,Republican Period,7,-350,-30,320,1.3575951
4592,,A,Early Imperial Period,8,-30,100,130,1.3575951
4592,,A,Mid-Imperial Period,9,100,300,200,1.3575951
4592,,A,Late Imperial Period,10,300,500,200,1.3575951
4593,Vignamurata,A,Republican Period,7,-200,-30,170,0.74811542
4593,Vignamurata,A,Early Imperial Period,8,-30,100,130,0.74811542
4593,Vignamurata,A,Mid-Imperial Period,9,100,300,200,0.74811542
4593,Vignamurata,A,Late Imperial Period,10,300,500,200,0.74811542
4594,,A,Late Iron Age,5,-650,-580,70,1.8391222
4594,,A,Archaic Period,6,-580,-450,130,1.8391222
4594,,B,Republican Period,7,-200,-30,170,1.8391222
4594,,B,Early Imperial Period,8,-30,100,130,1.8391222
4594,,B,Mid-Imperial Period,9,100,300,200,1.8391222
4594,,B,Late Imperial Period,10,300,500,200,1.8391222
4595,,A,Late Iron Age,5,-650,-580,70,1.4555589
4595,,A,Archaic Period,6,-580,-450,130,1.4555589
4595,,B,Republican Period,7,-200,-30,170,1.4555589
4595,,B,Early Imperial Period,8,-30,100,130,1.4555589
4595,,B,Mid-Imperial Period,9,100,300,200,1.4555589
4595,,B,Late Imperial Period,10,300,500,200,1.4555589
4596,,A,Early Imperial Period,8,-30,100,130,0.74017566
4596,,A,Mid-Imperial Period,9,100,300,200,0.74017566
4596,,A,Late Imperial Period,10,300,500,200,0.74017566
4597,Podere Troppona,A,Republican Period,7,-200,-30,170,1.0141705
4598,Castiglione della Pescaia,A,Republican Period,7,-200,-30,170,15.171104
4598,Castiglione della Pescaia,A,Early Imperial Period,8,-30,100,130,15.171104
4598,Castiglione della Pescaia,A,Mid-Imperial Period,9,100,300,200,15.171104
4598,Castiglione della Pescaia,A,Late Imperial Period,10,300,500,200,15.171104
4599,Canova,A,Early Imperial Period,8,1,100,99,1.2347307
4599,Canova,A,Mid-Imperial Period,9,100,200,100,1.2347307
4600,,A,Early Iron Age,4,-800,-750,50,0.67807293
4600,,A,Late Iron Age,5,-750,-580,170,0.67807293
4600,,A,Archaic Period,6,-580,-500,80,0.67807293
4601,,A,Late Iron Age,5,-600,-580,20,0.84834725
4601,,A,Archaic Period,6,-580,-500,80,0.84834725
4601,,B,Republican Period,7,-100,-30,70,0.84834725
4601,,B,Early Imperial Period,8,-30,100,130,0.84834725
4601,,B,Mid-Imperial Period,9,100,300,200,0.84834725
4601,,B,Late Imperial Period,10,300,500,200,0.84834725
4602,,A,Early Imperial Period,8,-30,100,130,1.2619374
4602,,A,Mid-Imperial Period,9,100,300,200,1.2619374
4602,,A,Late Imperial Period,10,300,500,200,1.2619374
4603,,A,Republican Period,7,-300,-30,270,1.5580176
4603,,A,Early Imperial Period,8,-30,100,130,1.5580176
4603,,A,Mid-Imperial Period,9,100,300,200,1.5580176
4603,,A,Late Imperial Period,10,300,500,200,1.5580176
4604,,A,Early Imperial Period,8,-30,100,130,1.4219509
4604,,A,Mid-Imperial Period,9,100,300,200,1.4219509
4604,,A,Late Imperial Period,10,300,500,200,1.4219509
4605,,A,Early Imperial Period,8,-30,100,130,0.51526028
4605,,A,Mid-Imperial Period,9,100,300,200,0.51526028
4605,,A,Late Imperial Period,10,300,500,200,0.51526028
4606,,A,Republican Period,7,-300,-30,270,0.748182
4606,,A,Early Imperial Period,8,-30,100,130,0.748182
4606,,A,Mid-Imperial Period,9,100,300,200,0.748182
4606,,A,Late Imperial Period,10,300,500,200,0.748182
4607,,A,Republican Period,7,-300,-30,270,0.41699433
4607,,A,Early Imperial Period,8,-30,100,130,0.41699433
4607,,A,Mid-Imperial Period,9,100,300,200,0.41699433
4607,,A,Late Imperial Period,10,300,500,200,0.41699433
4608,,A,Republican Period,7,-300,-30,270,0.7130909
4608,,A,Early Imperial Period,8,-30,100,130,0.7130909
4608,,A,Mid-Imperial Period,9,100,300,200,0.7130909
4608,,A,Late Imperial Period,10,300,500,200,0.7130909
4609,,A,Early Imperial Period,8,-30,100,130,0.25711888
4609,,A,Mid-Imperial Period,9,100,300,200,0.25711888
4609,,A,Late Imperial Period,10,300,500,200,0.25711888
4610,,A,Republican Period,7,-300,-30,270,0.30489644
4610,,A,Early Imperial Period,8,-30,100,130,0.30489644
4610,,A,Mid-Imperial Period,9,100,300,200,0.30489644
4610,,A,Late Imperial Period,10,300,500,200,0.30489644
4611,,A,Republican Period,7,-300,-30,270,0.24542907
4612,,A,Republican Period,7,-300,-30,270,0.43770367
4613,,A,Republican Period,7,-300,-30,270,0.33490917
4614,,A,Early Imperial Period,8,-30,100,130,0.3986716
4614,,A,Mid-Imperial Period,9,100,300,200,0.3986716
4614,,A,Late Imperial Period,10,300,500,200,0.3986716
4615,,A,Republican Period,7,-300,-30,270,0.97096735
4616,,A,Republican Period,7,-300,-30,270,0.69504654
4617,,A,Early Imperial Period,8,-30,100,130,0.70134991
4617,,A,Mid-Imperial Period,9,100,300,200,0.70134991
4617,,A,Late Imperial Period,10,300,500,200,0.70134991
4618,,A,Republican Period,7,-300,-30,270,0.22725289
4618,,A,Early Imperial Period,8,-30,100,130,0.22725289
4618,,A,Mid-Imperial Period,9,100,300,200,0.22725289
4618,,A,Late Imperial Period,10,300,500,200,0.22725289
4619,,A,Early Imperial Period,8,-30,100,130,0.43374735
4619,,A,Mid-Imperial Period,9,100,300,200,0.43374735
4619,,A,Late Imperial Period,10,300,500,200,0.43374735
4620,,A,Republican Period,7,-300,-30,270,0.72752386
4620,,A,Early Imperial Period,8,-30,100,130,0.72752386
4620,,A,Mid-Imperial Period,9,100,300,200,0.72752386
4620,,A,Late Imperial Period,10,300,500,200,0.72752386
4621,,A,Republican Period,7,-300,-30,270,0.68466771
4621,,A,Early Imperial Period,8,-30,100,130,0.68466771
4621,,A,Mid-Imperial Period,9,100,300,200,0.68466771
4621,,A,Late Imperial Period,10,300,500,200,0.68466771
4622,,A,Republican Period,7,-300,-30,270,0.75501508
4623,,A,Republican Period,7,-300,-30,270,0.45664704
4624,,A,Republican Period,7,-300,-30,270,0.31714571
4624,,A,Early Imperial Period,8,-30,100,130,0.31714571
4624,,A,Mid-Imperial Period,9,100,300,200,0.31714571
4624,,A,Late Imperial Period,10,300,500,200,0.31714571
4625,,A,Republican Period,7,-300,-30,270,0.71615857
4625,,A,Early Imperial Period,8,-30,100,130,0.71615857
4625,,A,Mid-Imperial Period,9,100,300,200,0.71615857
4625,,A,Late Imperial Period,10,300,500,200,0.71615857
4626,,A,Republican Period,7,-300,-30,270,0.22665723
4626,,A,Early Imperial Period,8,-30,100,130,0.22665723
4626,,A,Mid-Imperial Period,9,100,300,200,0.22665723
4627,,A,Republican Period,7,-300,-30,270,0.17683533
4627,,A,Early Imperial Period,8,-30,100,130,0.17683533
4627,,A,Mid-Imperial Period,9,100,300,200,0.17683533
4628,,A,Early Imperial Period,8,-30,100,130,0.28822684
4628,,A,Mid-Imperial Period,9,100,300,200,0.28822684
4629,,A,Republican Period,7,-300,-30,270,0.48561642
4630,,A,Early Imperial Period,8,-30,100,130,0.50036174
4630,,A,Mid-Imperial Period,9,100,300,200,0.50036174
4631,,A,Early Imperial Period,8,-30,100,130,0.18100974
4631,,A,Mid-Imperial Period,9,100,300,200,0.18100974
4632,,A,Republican Period,7,-300,-30,270,0.42910883
4632,,A,Early Imperial Period,8,-30,100,130,0.42910883
4632,,A,Mid-Imperial Period,9,100,300,200,0.42910883
4632,,A,Late Imperial Period,10,300,500,200,0.42910883
4633,,A,Republican Period,7,-300,-30,270,0.99012065
4633,,A,Early Imperial Period,8,-30,100,130,0.99012065
4633,,A,Mid-Imperial Period,9,100,300,200,0.99012065
4634,,A,Republican Period,7,-300,-30,270,0.42960763
4634,,A,Early Imperial Period,8,-30,100,130,0.42960763
4634,,A,Mid-Imperial Period,9,100,300,200,0.42960763
4635,,A,Early Imperial Period,8,-30,100,130,0.27025157
4635,,A,Mid-Imperial Period,9,100,300,200,0.27025157
4635,,A,Late Imperial Period,10,300,500,200,0.27025157
4636,,A,Early Imperial Period,8,-30,100,130,0.54655975
4636,,A,Mid-Imperial Period,9,100,300,200,0.54655975
4636,,A,Late Imperial Period,10,300,500,200,0.54655975
4637,Forum Cassii,A,Republican Period,7,-150,-30,120,3.6980648
4637,Forum Cassii,A,Early Imperial Period,8,-30,100,130,3.6980648
4637,Forum Cassii,A,Mid-Imperial Period,9,100,300,200,3.6980648
4637,Forum Cassii,A,Late Imperial Period,10,300,500,200,3.6980648
4638,,A,Republican Period,7,-300,-30,270,0.31869704
4639,,A,Early Imperial Period,8,-30,100,130,0.26085168
4639,,A,Mid-Imperial Period,9,100,300,200,0.26085168
4639,,A,Late Imperial Period,10,300,500,200,0.26085168
4640,,A,Early Imperial Period,8,-30,100,130,0.37896666
4640,,A,Mid-Imperial Period,9,100,300,200,0.37896666
4640,,A,Late Imperial Period,10,300,500,200,0.37896666
4641,Casalino,A,Early Imperial Period,8,-30,100,130,1.3014591
4641,Casalino,A,Mid-Imperial Period,9,100,300,200,1.3014591
4641,Casalino,A,Late Imperial Period,10,300,500,200,1.3014591
4642,,A,Early Imperial Period,8,-30,100,130,0.27290449
4642,,A,Mid-Imperial Period,9,100,300,200,0.27290449
4642,,A,Late Imperial Period,10,300,500,200,0.27290449
4643,,A,Republican Period,7,-300,-30,270,0.17401996
4644,,A,Early Imperial Period,8,-30,100,130,0.21018234
4644,,A,Mid-Imperial Period,9,100,300,200,0.21018234
4644,,A,Late Imperial Period,10,300,500,200,0.21018234
4645,Casalino,A,Republican Period,7,-100,-30,70,1.010967
4645,Casalino,A,Early Imperial Period,8,-30,100,130,1.010967
4646,,A,Republican Period,7,-300,-30,270,0.24333145
4647,,A,Republican Period,7,-100,-30,70,0.8111164
4647,,A,Early Imperial Period,8,-30,100,130,0.8111164
4648,,A,Republican Period,7,-100,-30,70,0.23258887
4648,,A,Early Imperial Period,8,-30,100,130,0.23258887
4649,,A,Early Imperial Period,8,-30,100,130,0.20753762
4649,,A,Mid-Imperial Period,9,100,300,200,0.20753762
4649,,A,Late Imperial Period,10,300,500,200,0.20753762
4650,,A,Early Imperial Period,8,-30,100,130,0.20753489
4650,,A,Mid-Imperial Period,9,100,300,200,0.20753489
4650,,A,Late Imperial Period,10,300,500,200,0.20753489
4651,,A,Early Imperial Period,8,-30,100,130,0.20753501
4651,,A,Mid-Imperial Period,9,100,300,200,0.20753501
4651,,A,Late Imperial Period,10,300,500,200,0.20753501
4652,,A,Late Iron Age,5,-600,-580,20,0.079847462
4652,,A,Archaic Period,6,-580,-500,80,0.079847462
4653,,A,Archaic Period,6,-500,-350,150,0.24104792
4653,,A,Republican Period,7,-350,-30,320,0.24104792
4654,Casale Valle Falsetta,A,Early Imperial Period,8,-30,100,130,1.3325382
4654,Casale Valle Falsetta,A,Mid-Imperial Period,9,100,300,200,1.3325382
4654,Casale Valle Falsetta,A,Late Imperial Period,10,300,500,200,1.3325382
4655,Poggio dei cunicchi,A,Republican Period,7,-300,-30,270,2.0014889
4656,,A,Archaic Period,6,-500,-350,150,0.24143343
4656,,A,Republican Period,7,-350,-30,320,0.24143343
4657,,A,Archaic Period,6,-500,-350,150,0.24143286
4657,,A,Republican Period,7,-350,-30,320,0.24143286
4658,,A,Republican Period,7,-300,-30,270,0.29170001
4659,,A,Republican Period,7,-100,-30,70,0.58005995
4659,,A,Early Imperial Period,8,-30,100,130,0.58005995
4660,,A,Early Imperial Period,8,-30,100,130,0.24681328
4660,,A,Mid-Imperial Period,9,100,300,200,0.24681328
4660,,A,Late Imperial Period,10,300,500,200,0.24681328
4661,,A,Late Iron Age,5,-600,-580,20,0.27245149
4661,,A,Archaic Period,6,-580,-500,80,0.27245149
4662,,A,Archaic Period,6,-500,-350,150,0.75162637
4662,,A,Republican Period,7,-350,-30,320,0.75162637
4663,,A,Republican Period,7,-150,-30,120,0.61754328
4663,,A,Early Imperial Period,8,-30,100,130,0.61754328
4663,,A,Mid-Imperial Period,9,100,300,200,0.61754328
4663,,A,Late Imperial Period,10,300,400,100,0.61754328
4664,,A,Late Iron Age,5,-600,-580,20,0.1484995
4664,,A,Archaic Period,6,-580,-500,80,0.1484995
4665,,A,Republican Period,7,-100,-30,70,0.26667401
4665,,A,Early Imperial Period,8,-30,100,130,0.26667401
4666,,A,Republican Period,7,-100,-30,70,0.40394309
4666,,A,Early Imperial Period,8,-30,100,130,0.40394309
4667,,A,Late Iron Age,5,-600,-580,20,0.23027298
4667,,A,Archaic Period,6,-580,-500,80,0.23027298
4668,,A,Republican Period,7,-100,-30,70,0.88621521
4668,,A,Early Imperial Period,8,-30,100,130,0.88621521
4669,Querceto Nardini,A,Early Imperial Period,8,-30,100,130,0.29998389
4669,Querceto Nardini,A,Mid-Imperial Period,9,100,300,200,0.29998389
4669,Querceto Nardini,A,Late Imperial Period,10,300,500,200,0.29998389
4670,,A,Republican Period,7,-100,-30,70,0.38357767
4670,,A,Early Imperial Period,8,-30,100,130,0.38357767
4671,,A,Republican Period,7,-100,-30,70,1.2661388
4671,,A,Early Imperial Period,8,-30,100,130,1.2661388
4672,,A,Republican Period,7,-100,-30,70,1.1047404
4672,,A,Early Imperial Period,8,-30,100,130,1.1047404
4673,,A,Early Imperial Period,8,-30,100,130,0.46878949
4673,,A,Mid-Imperial Period,9,100,300,200,0.46878949
4673,,A,Late Imperial Period,10,300,500,200,0.46878949
4674,,A,Early Imperial Period,8,-30,100,130,0.60713494
4674,,A,Mid-Imperial Period,9,100,300,200,0.60713494
4674,,A,Late Imperial Period,10,300,500,200,0.60713494
4675,Poggio Paternostro,A,Early Imperial Period,8,-30,100,130,0.86669523
4675,Poggio Paternostro,A,Mid-Imperial Period,9,100,300,200,0.86669523
4675,Poggio Paternostro,A,Late Imperial Period,10,300,500,200,0.86669523
4676,,A,Early Imperial Period,8,-30,100,130,0.17969936
4676,,A,Mid-Imperial Period,9,100,300,200,0.17969936
4676,,A,Late Imperial Period,10,300,500,200,0.17969936
4677,,A,Republican Period,7,-100,-30,70,0.92120832
4677,,A,Early Imperial Period,8,-30,100,130,0.92120832
4678,S. Mariano,A,Republican Period,7,-100,-30,70,3.4874256
4678,S. Mariano,A,Early Imperial Period,8,-30,100,130,3.4874256
4679,Poggio di Cilli,A,Republican Period,7,-100,-30,70,0.29251236
4679,Poggio di Cilli,A,Early Imperial Period,8,-30,100,130,0.29251236
4680,Poggio di Cilli,A,Early Imperial Period,8,-30,100,130,0.29250768
4680,Poggio di Cilli,A,Mid-Imperial Period,9,100,300,200,0.29250768
4680,Poggio di Cilli,A,Late Imperial Period,10,300,500,200,0.29250768
4681,,A,Republican Period,7,-100,-30,70,1.4413517
4681,,A,Early Imperial Period,8,-30,100,130,1.4413517
4682,,A,Republican Period,7,-100,-30,70,0.5681448
4682,,A,Early Imperial Period,8,-30,100,130,0.5681448
4683,,A,Republican Period,7,-100,-30,70,1.4781595
4683,,A,Early Imperial Period,8,-30,100,130,1.4781595
4684,,A,Early Imperial Period,8,-30,100,130,0.2507571
4684,,A,Mid-Imperial Period,9,100,300,200,0.2507571
4684,,A,Late Imperial Period,10,300,500,200,0.2507571
4685,,A,Late Iron Age,5,-600,-580,20,0.30217576
4685,,A,Archaic Period,6,-580,-500,80,0.30217576
4685,,B,Early Imperial Period,8,-30,100,130,0.30217576
4685,,B,Mid-Imperial Period,9,100,300,200,0.30217576
4685,,B,Late Imperial Period,10,300,500,200,0.30217576
4686,,A,Late Iron Age,5,-600,-580,20,0.92172539
4686,,A,Archaic Period,6,-580,-350,230,0.92172539
4686,,A,Republican Period,7,-350,-100,250,0.92172539
4687,,A,Early Imperial Period,8,-30,100,130,1.0843538
4687,,A,Mid-Imperial Period,9,100,300,200,1.0843538
4687,,A,Late Imperial Period,10,300,500,200,1.0843538
4688,Cerracchio,A,Late Iron Age,5,-600,-580,20,1.1272545
4688,Cerracchio,A,Archaic Period,6,-580,-350,230,1.1272545
4688,Cerracchio,A,Republican Period,7,-350,-100,250,1.1272545
4689,Cerracchio,A,Republican Period,7,-300,-30,270,0.27691436
4690,,A,Republican Period,7,-100,-30,70,1.8038435
4690,,A,Early Imperial Period,8,-30,100,130,1.8038435
4691,,A,Early Imperial Period,8,-30,100,130,0.16426693
4691,,A,Mid-Imperial Period,9,100,300,200,0.16426693
4691,,A,Late Imperial Period,10,300,500,200,0.16426693
4692,,A,Late Iron Age,5,-600,-580,20,0.14956297
4692,,A,Archaic Period,6,-580,-500,80,0.14956297
4693,,A,Republican Period,7,-300,-200,100,0.24280459
4694,,A,Archaic Period,6,-500,-350,150,0.20343417
4694,,A,Republican Period,7,-350,-100,250,0.20343417
4695,,A,Early Imperial Period,8,-30,100,130,0.23036569
4695,,A,Mid-Imperial Period,9,100,300,200,0.23036569
4695,,A,Late Imperial Period,10,300,500,200,0.23036569
4696,,A,Early Imperial Period,8,-30,100,130,0.23035626
4696,,A,Mid-Imperial Period,9,100,300,200,0.23035626
4696,,A,Late Imperial Period,10,300,500,200,0.23035626
4697,,A,Republican Period,7,-100,-30,70,0.2303564
4698,,A,Republican Period,7,-100,-30,70,1.8690255
4698,,A,Early Imperial Period,8,-30,100,130,1.8690255
4699,,A,Early Imperial Period,8,-30,100,130,0.27224693
4699,,A,Mid-Imperial Period,9,100,300,200,0.27224693
4699,,A,Late Imperial Period,10,300,500,200,0.27224693
4700,,A,Early Imperial Period,8,-30,100,130,0.27224198
4700,,A,Mid-Imperial Period,9,100,300,200,0.27224198
4700,,A,Late Imperial Period,10,300,500,200,0.27224198
4701,,A,Early Imperial Period,8,-30,100,130,0.67561072
4701,,A,Mid-Imperial Period,9,100,300,200,0.67561072
4701,,A,Late Imperial Period,10,300,500,200,0.67561072
4702,,A,Early Imperial Period,8,-30,100,130,0.23210624
4702,,A,Mid-Imperial Period,9,100,300,200,0.23210624
4702,,A,Late Imperial Period,10,300,500,200,0.23210624
4703,,A,Early Imperial Period,8,-30,100,130,1.0617275
4703,,A,Mid-Imperial Period,9,100,300,200,1.0617275
4703,,A,Late Imperial Period,10,300,500,200,1.0617275
4704,,A,Republican Period,7,-100,-30,70,0.62031436
4704,,A,Early Imperial Period,8,-30,100,130,0.62031436
4705,,A,Early Imperial Period,8,-30,100,130,0.65494454
4705,,A,Mid-Imperial Period,9,100,300,200,0.65494454
4705,,A,Late Imperial Period,10,300,500,200,0.65494454
4706,,A,Early Imperial Period,8,-30,100,130,0.19249827
4706,,A,Mid-Imperial Period,9,100,300,200,0.19249827
4706,,A,Late Imperial Period,10,300,500,200,0.19249827
4707,,A,Early Imperial Period,8,-30,100,130,1.0642586
4707,,A,Mid-Imperial Period,9,100,300,200,1.0642586
4707,,A,Late Imperial Period,10,300,500,200,1.0642586
4708,,A,Early Imperial Period,8,-30,100,130,0.20715268
4708,,A,Mid-Imperial Period,9,100,300,200,0.20715268
4708,,A,Late Imperial Period,10,300,500,200,0.20715268
4709,,A,Early Imperial Period,8,-30,100,130,0.20714204
4709,,A,Mid-Imperial Period,9,100,300,200,0.20714204
4709,,A,Late Imperial Period,10,300,500,200,0.20714204
4710,,A,Late Iron Age,5,-600,-580,20,0.20716025
4710,,A,Archaic Period,6,-580,-500,80,0.20716025
4711,,A,Early Imperial Period,8,-30,100,130,0.77681506
4711,,A,Mid-Imperial Period,9,100,300,200,0.77681506
4711,,A,Late Imperial Period,10,300,500,200,0.77681506
4712,,A,Late Iron Age,5,-600,-580,20,0.32524344
4712,,A,Archaic Period,6,-580,-500,80,0.32524344
4713,,A,Late Iron Age,5,-600,-580,20,0.58872408
4713,,A,Archaic Period,6,-580,-500,80,0.58872408
4714,,A,Early Imperial Period,8,-30,100,130,0.47233683
4714,,A,Mid-Imperial Period,9,100,300,200,0.47233683
4714,,A,Late Imperial Period,10,300,500,200,0.47233683
4715,,A,Early Imperial Period,8,-30,100,130,0.75458497
4715,,A,Mid-Imperial Period,9,100,300,200,0.75458497
4715,,A,Late Imperial Period,10,300,500,200,0.75458497
4716,,A,Republican Period,7,-100,-30,70,0.17049901
4716,,A,Early Imperial Period,8,-30,100,130,0.17049901
4717,,A,Republican Period,7,-100,-30,70,0.24718884
4717,,A,Early Imperial Period,8,-30,100,130,0.24718884
4718,Podere S. Basilio,A,Republican Period,7,-100,-30,70,1.5395679
4718,Podere S. Basilio,A,Early Imperial Period,8,-30,100,130,1.5395679
4719,Poggio S. Guardiano,A,Republican Period,7,-100,-30,70,0.54613841
4719,Poggio S. Guardiano,A,Early Imperial Period,8,-30,100,130,0.54613841
4720,,A,Republican Period,7,-100,-30,70,0.81924492
4720,,A,Early Imperial Period,8,-30,100,130,0.81924492
4721,,A,Late Iron Age,5,-600,-580,20,0.28557375
4721,,A,Archaic Period,6,-580,-500,80,0.28557375
4722,,A,Late Iron Age,5,-600,-580,20,0.14353818
4722,,A,Archaic Period,6,-580,-500,80,0.14353818
4723,,A,Early Imperial Period,8,-30,100,130,0.26784864
4723,,A,Mid-Imperial Period,9,100,300,200,0.26784864
4723,,A,Late Imperial Period,10,300,500,200,0.26784864
4724,,A,Republican Period,7,-100,-30,70,0.78922087
4724,,A,Early Imperial Period,8,-30,100,130,0.78922087
4725,,A,Late Iron Age,5,-600,-580,20,0.57146931
4725,,A,Archaic Period,6,-580,-500,80,0.57146931
4726,,A,Late Iron Age,5,-600,-580,20,0.18709625
4726,,A,Archaic Period,6,-580,-500,80,0.18709625
4727,,A,Early Imperial Period,8,-30,100,130,0.79513747
4727,,A,Mid-Imperial Period,9,100,300,200,0.79513747
4727,,A,Late Imperial Period,10,300,500,200,0.79513747
4728,,A,Early Imperial Period,8,-30,100,130,0.19483957
4728,,A,Mid-Imperial Period,9,100,300,200,0.19483957
4728,,A,Late Imperial Period,10,300,500,200,0.19483957
4729,,A,Late Iron Age,5,-600,-580,20,0.27604207
4729,,A,Archaic Period,6,-580,-500,80,0.27604207
4730,,A,Early Imperial Period,8,-30,100,130,0.56985021
4730,,A,Mid-Imperial Period,9,100,300,200,0.56985021
4730,,A,Late Imperial Period,10,300,500,200,0.56985021
4731,,A,Early Imperial Period,8,-30,100,130,0.30867258
4731,,A,Mid-Imperial Period,9,100,300,200,0.30867258
4731,,A,Late Imperial Period,10,300,500,200,0.30867258
4732,,A,Early Imperial Period,8,-30,100,130,0.30866247
4732,,A,Mid-Imperial Period,9,100,300,200,0.30866247
4732,,A,Late Imperial Period,10,300,500,200,0.30866247
4733,,A,Republican Period,7,-100,-30,70,0.5036971
4733,,A,Early Imperial Period,8,-30,100,130,0.5036971
4734,,A,Republican Period,7,-100,-30,70,1.9508399
4734,,A,Early Imperial Period,8,-30,100,130,1.9508399
4735,,A,Republican Period,7,-100,-30,70,1.0749876
4736,,A,Early Imperial Period,8,-30,100,130,0.19524288
4736,,A,Mid-Imperial Period,9,100,300,200,0.19524288
4736,,A,Late Imperial Period,10,300,500,200,0.19524288
4737,,A,Late Iron Age,5,-600,-580,20,0.2154126
4737,,A,Archaic Period,6,-580,-350,230,0.2154126
4737,,A,Republican Period,7,-350,-100,250,0.2154126
4738,Poggio Rosanello,A,Republican Period,7,-100,-30,70,0.26872265
4738,Poggio Rosanello,A,Early Imperial Period,8,-30,100,130,0.26872265
4739,Poggio Rosanello,A,Early Imperial Period,8,-30,100,130,0.68989652
4739,Poggio Rosanello,A,Mid-Imperial Period,9,100,300,200,0.68989652
4739,Poggio Rosanello,A,Late Imperial Period,10,300,500,200,0.68989652
4740,,A,Early Imperial Period,8,-30,100,130,0.29191414
4740,,A,Mid-Imperial Period,9,100,300,200,0.29191414
4740,,A,Late Imperial Period,10,300,500,200,0.29191414
4741,,A,Republican Period,7,-100,-30,70,0.55068839
4741,,A,Early Imperial Period,8,-30,100,130,0.55068839
4742,,A,Archaic Period,6,-400,-350,50,0.52959442
4742,,A,Republican Period,7,-350,-30,320,0.52959442
4742,,A,Early Imperial Period,8,-30,100,130,0.52959442
4742,,A,Mid-Imperial Period,9,100,300,200,0.52959442
4742,,A,Late Imperial Period,10,300,500,200,0.52959442
4743,,A,Republican Period,7,-100,-30,70,0.95555741
4743,,A,Early Imperial Period,8,-30,100,130,0.95555741
4744,,A,Early Imperial Period,8,-30,100,130,1.0316284
4744,,A,Mid-Imperial Period,9,100,300,200,1.0316284
4744,,A,Late Imperial Period,10,300,500,200,1.0316284
4745,,A,Early Imperial Period,8,-30,100,130,0.86832935
4745,,A,Mid-Imperial Period,9,100,300,200,0.86832935
4745,,A,Late Imperial Period,10,300,500,200,0.86832935
4746,,A,Early Imperial Period,8,-30,100,130,0.23377892
4746,,A,Mid-Imperial Period,9,100,300,200,0.23377892
4746,,A,Late Imperial Period,10,300,500,200,0.23377892
4747,,A,Early Imperial Period,8,-30,100,130,0.233795
4747,,A,Mid-Imperial Period,9,100,300,200,0.233795
4747,,A,Late Imperial Period,10,300,500,200,0.233795
4748,,A,Republican Period,7,-100,-30,70,1.4934758
4748,,A,Early Imperial Period,8,-30,100,130,1.4934758
4749,,A,Republican Period,7,-100,-30,70,0.41631505
4749,,A,Early Imperial Period,8,-30,100,130,0.41631505
4750,Il Capannone,A,Republican Period,7,-100,-30,70,1.2052191
4751,,A,Republican Period,7,-100,-30,70,3.6156418
4751,,A,Early Imperial Period,8,-30,100,130,3.6156418
4752,,A,Early Imperial Period,8,-30,100,130,0.24133052
4752,,A,Mid-Imperial Period,9,100,300,200,0.24133052
4752,,A,Late Imperial Period,10,300,500,200,0.24133052
4753,,A,Early Imperial Period,8,-30,100,130,1.8245033
4753,,A,Mid-Imperial Period,9,100,300,200,1.8245033
4753,,A,Late Imperial Period,10,300,500,200,1.8245033
4754,,A,Early Imperial Period,8,-30,100,130,0.20023908
4754,,A,Mid-Imperial Period,9,100,300,200,0.20023908
4754,,A,Late Imperial Period,10,300,500,200,0.20023908
4755,,A,Early Imperial Period,8,-30,100,130,0.20024168
4755,,A,Mid-Imperial Period,9,100,300,200,0.20024168
4755,,A,Late Imperial Period,10,300,500,200,0.20024168
4756,,A,Early Imperial Period,8,-30,100,130,0.55642664
4756,,A,Mid-Imperial Period,9,100,300,200,0.55642664
4756,,A,Late Imperial Period,10,300,500,200,0.55642664
4757,,A,Early Imperial Period,8,-30,100,130,0.2002463
4757,,A,Mid-Imperial Period,9,100,300,200,0.2002463
4757,,A,Late Imperial Period,10,300,500,200,0.2002463
4758,,A,Late Iron Age,5,-600,-580,20,0.67975557
4758,,A,Archaic Period,6,-580,-350,230,0.67975557
4758,,A,Republican Period,7,-350,-30,320,0.67975557
4758,,A,Early Imperial Period,8,-30,100,130,0.67975557
4759,,A,Early Imperial Period,8,-30,100,130,0.46683851
4759,,A,Mid-Imperial Period,9,100,300,200,0.46683851
4759,,A,Late Imperial Period,10,300,500,200,0.46683851
4760,,A,Republican Period,7,-100,-30,70,0.46964881
4760,,A,Early Imperial Period,8,-30,100,130,0.46964881
4761,,A,Republican Period,7,-100,-30,70,0.32918519
4761,,A,Early Imperial Period,8,-30,100,130,0.32918519
4762,,A,Republican Period,7,-300,-30,270,0.16797405
4762,,A,Early Imperial Period,8,-30,100,130,0.16797405
4762,,A,Mid-Imperial Period,9,100,300,200,0.16797405
4762,,A,Late Imperial Period,10,300,500,200,0.16797405
4763,,A,Late Iron Age,5,-600,-580,20,0.84330058
4763,,A,Archaic Period,6,-580,-350,230,0.84330058
4763,,A,Republican Period,7,-350,-30,320,0.84330058
4763,,A,Early Imperial Period,8,-30,100,130,0.84330058
4763,,A,Mid-Imperial Period,9,100,300,200,0.84330058
4763,,A,Late Imperial Period,10,300,500,200,0.84330058
4764,,A,Early Imperial Period,8,-30,100,130,0.21644278
4764,,A,Mid-Imperial Period,9,100,300,200,0.21644278
4764,,A,Late Imperial Period,10,300,500,200,0.21644278
4765,,A,Early Imperial Period,8,-30,100,130,0.2164347
4765,,A,Mid-Imperial Period,9,100,300,200,0.2164347
4765,,A,Late Imperial Period,10,300,500,200,0.2164347
4766,,A,Republican Period,7,-300,-30,270,0.21643257
4767,,A,Early Imperial Period,8,-30,100,130,0.21641918
4767,,A,Mid-Imperial Period,9,100,300,200,0.21641918
4767,,A,Late Imperial Period,10,300,500,200,0.21641918
4768,,A,Early Imperial Period,8,-30,100,130,0.40606135
4768,,A,Mid-Imperial Period,9,100,300,200,0.40606135
4768,,A,Late Imperial Period,10,300,500,200,0.40606135
4769,,A,Early Imperial Period,8,-30,100,130,0.21641685
4769,,A,Mid-Imperial Period,9,100,300,200,0.21641685
4769,,A,Late Imperial Period,10,300,500,200,0.21641685
4770,,A,Early Imperial Period,8,-30,100,130,0.21642268
4770,,A,Mid-Imperial Period,9,100,300,200,0.21642268
4770,,A,Late Imperial Period,10,300,500,200,0.21642268
4771,,A,Republican Period,7,-300,-30,270,0.46378696
4771,,A,Early Imperial Period,8,-30,100,130,0.46378696
4771,,A,Mid-Imperial Period,9,100,300,200,0.46378696
4771,,A,Late Imperial Period,10,300,500,200,0.46378696
4772,,A,Early Imperial Period,8,-30,100,130,0.2164176
4772,,A,Mid-Imperial Period,9,100,300,200,0.2164176
4772,,A,Late Imperial Period,10,300,500,200,0.2164176
4773,,A,Early Imperial Period,8,-30,100,130,0.21641411
4773,,A,Mid-Imperial Period,9,100,300,200,0.21641411
4773,,A,Late Imperial Period,10,300,500,200,0.21641411
4774,,A,Early Imperial Period,8,-30,100,130,0.73071873
4774,,A,Mid-Imperial Period,9,100,300,200,0.73071873
4774,,A,Late Imperial Period,10,300,500,200,0.73071873
4775,,A,Early Imperial Period,8,-30,100,130,0.29239446
4775,,A,Mid-Imperial Period,9,100,300,200,0.29239446
4775,,A,Late Imperial Period,10,300,500,200,0.29239446
4776,Casolare le Piane,A,Early Imperial Period,8,-30,100,130,0.50088674
4776,Casolare le Piane,A,Mid-Imperial Period,9,100,300,200,0.50088674
4776,Casolare le Piane,A,Late Imperial Period,10,300,500,200,0.50088674
4777,,A,Republican Period,7,-300,-30,270,0.58738488
4777,,A,Early Imperial Period,8,-30,100,130,0.58738488
4777,,A,Mid-Imperial Period,9,100,300,200,0.58738488
4777,,A,Late Imperial Period,10,300,500,200,0.58738488
4778,,A,Early Imperial Period,8,-30,100,130,0.24317363
4778,,A,Mid-Imperial Period,9,100,300,200,0.24317363
4778,,A,Late Imperial Period,10,300,500,200,0.24317363
4779,,A,Early Imperial Period,8,-30,100,130,0.24317136
4779,,A,Mid-Imperial Period,9,100,300,200,0.24317136
4779,,A,Late Imperial Period,10,300,500,200,0.24317136
4780,,A,Early Imperial Period,8,-30,100,130,0.98777932
4780,,A,Mid-Imperial Period,9,100,300,200,0.98777932
4780,,A,Late Imperial Period,10,300,500,200,0.98777932
4781,,A,Early Imperial Period,8,-30,100,130,0.67555213
4781,,A,Mid-Imperial Period,9,100,300,200,0.67555213
4781,,A,Late Imperial Period,10,300,500,200,0.67555213
4782,,A,Early Imperial Period,8,-30,100,130,0.45008478
4782,,A,Mid-Imperial Period,9,100,300,200,0.45008478
4782,,A,Late Imperial Period,10,300,500,200,0.45008478
4783,,A,Early Imperial Period,8,-30,100,130,0.47893316
4783,,A,Mid-Imperial Period,9,100,300,200,0.47893316
4783,,A,Late Imperial Period,10,300,500,200,0.47893316
4784,,A,Republican Period,7,-100,-30,70,1.5228057
4784,,A,Early Imperial Period,8,-30,100,130,1.5228057
4784,,A,Mid-Imperial Period,9,100,200,100,1.5228057
4785,,A,Archaic Period,6,-500,-350,150,0.22449353
4785,,A,Republican Period,7,-350,-30,320,0.22449353
4785,,A,Early Imperial Period,8,-30,100,130,0.22449353
4785,,A,Mid-Imperial Period,9,100,300,200,0.22449353
4785,,A,Late Imperial Period,10,300,500,200,0.22449353
4786,,A,Early Imperial Period,8,-30,100,130,0.47086158
4786,,A,Mid-Imperial Period,9,100,300,200,0.47086158
4786,,A,Late Imperial Period,10,300,500,200,0.47086158
4787,,A,Early Imperial Period,8,-30,100,130,0.22451399
4787,,A,Mid-Imperial Period,9,100,300,200,0.22451399
4787,,A,Late Imperial Period,10,300,500,200,0.22451399
4788,,A,Republican Period,7,-100,-30,70,0.35300466
4789,,A,Early Imperial Period,8,-30,100,130,0.23728508
4789,,A,Mid-Imperial Period,9,100,300,200,0.23728508
4789,,A,Late Imperial Period,10,300,500,200,0.23728508
4790,,A,Republican Period,7,-100,-30,70,0.23728135
4791,,A,Archaic Period,6,-500,-350,150,0.23728932
4791,,A,Republican Period,7,-350,-30,320,0.23728932
4792,,A,Early Imperial Period,8,-30,100,130,0.23727953
4792,,A,Mid-Imperial Period,9,100,300,200,0.23727953
4792,,A,Late Imperial Period,10,300,500,200,0.23727953
4793,,A,Early Imperial Period,8,-30,100,130,0.48626128
4793,,A,Mid-Imperial Period,9,100,300,200,0.48626128
4793,,A,Late Imperial Period,10,300,500,200,0.48626128
4794,,A,Late Iron Age,5,-600,-580,20,0.135144
4794,,A,Archaic Period,6,-580,-400,180,0.135144
4795,,A,Republican Period,7,-100,-30,70,0.25577918
4795,,A,Early Imperial Period,8,-30,100,130,0.25577918
4796,,A,Early Imperial Period,8,-30,100,130,0.25579023
4796,,A,Mid-Imperial Period,9,100,300,200,0.25579023
4796,,A,Late Imperial Period,10,300,500,200,0.25579023
4797,Blera,A,Late Bronze Age,3,-1200,-1020,180,6.5757184
4797,Blera,B,Early Iron Age,4,-1020,-750,270,6.5757184
4797,Blera,B,Late Iron Age,5,-750,-580,170,6.5757184
4797,Blera,B,Archaic Period,6,-580,-350,230,6.5757184
4797,Blera,B,Republican Period,7,-350,-30,320,6.5757184
4797,Blera,B,Early Imperial Period,8,-30,100,130,6.5757184
4797,Blera,B,Mid-Imperial Period,9,100,300,200,6.5757184
4797,Blera,B,Late Imperial Period,10,300,500,200,6.5757184
4798,,A,Republican Period,7,-300,-30,270,0.55962324
4798,,A,Early Imperial Period,8,-30,100,130,0.55962324
4798,,A,Mid-Imperial Period,9,100,300,200,0.55962324
4798,,A,Late Imperial Period,10,300,500,200,0.55962324
4799,,A,Republican Period,7,-100,-30,70,0.9178679
4799,,A,Early Imperial Period,8,-30,100,130,0.9178679
4800,,A,Early Imperial Period,8,-30,100,130,0.32247645
4800,,A,Mid-Imperial Period,9,100,300,200,0.32247645
4800,,A,Late Imperial Period,10,300,500,200,0.32247645
4801,,A,Late Iron Age,5,-600,-580,20,0.21635994
4801,,A,Archaic Period,6,-580,-500,80,0.21635994
4802,,A,Early Imperial Period,8,-30,100,130,0.60627443
4802,,A,Mid-Imperial Period,9,100,300,200,0.60627443
4802,,A,Late Imperial Period,10,300,500,200,0.60627443
4803,,A,Republican Period,7,-100,-30,70,0.86376435
4803,,A,Early Imperial Period,8,-30,100,130,0.86376435
4804,,A,Early Imperial Period,8,-30,100,130,0.25656682
4804,,A,Mid-Imperial Period,9,100,300,200,0.25656682
4804,,A,Late Imperial Period,10,300,500,200,0.25656682
4805,,A,Early Imperial Period,8,-30,100,130,0.25656226
4805,,A,Mid-Imperial Period,9,100,300,200,0.25656226
4805,,A,Late Imperial Period,10,300,500,200,0.25656226
4806,,A,Republican Period,7,-300,-30,270,0.25656292
4807,,A,Late Iron Age,5,-600,-580,20,0.25201344
4807,,A,Archaic Period,6,-580,-500,80,0.25201344
4808,,A,Republican Period,7,-100,-30,70,0.50457394
4808,,A,Early Imperial Period,8,-30,100,130,0.50457394
4808,,A,Mid-Imperial Period,9,100,300,200,0.50457394
4808,,A,Late Imperial Period,10,300,500,200,0.50457394
4809,,A,Late Iron Age,5,-600,-580,20,0.24492528
4809,,A,Archaic Period,6,-580,-500,80,0.24492528
4809,,B,Republican Period,7,-300,-30,270,0.24492528
4810,,A,Archaic Period,6,-400,-350,50,0.31252432
4810,,A,Republican Period,7,-350,-30,320,0.31252432
4811,Morganello,A,Republican Period,7,-100,-30,70,0.67996329
4811,Morganello,A,Early Imperial Period,8,-30,100,130,0.67996329
4811,Morganello,A,Mid-Imperial Period,9,100,200,100,0.67996329
4812,,A,Republican Period,7,-100,-30,70,0.67718321
4812,,A,Early Imperial Period,8,-30,100,130,0.67718321
4813,,A,Early Imperial Period,8,-30,100,130,0.55963421
4813,,A,Mid-Imperial Period,9,100,300,200,0.55963421
4813,,A,Late Imperial Period,10,300,500,200,0.55963421
4814,,A,Republican Period,7,-100,-30,70,0.71807355
4814,,A,Early Imperial Period,8,-30,100,130,0.71807355
4815,,A,Early Imperial Period,8,-30,100,130,2.4370165
4815,,A,Mid-Imperial Period,9,100,300,200,2.4370165
4815,,A,Late Imperial Period,10,300,500,200,2.4370165
4816,,A,Early Imperial Period,8,-30,100,130,0.38257134
4816,,A,Mid-Imperial Period,9,100,300,200,0.38257134
4816,,A,Late Imperial Period,10,300,500,200,0.38257134
4817,,A,Republican Period,7,-100,-30,70,0.54518294
4817,,A,Early Imperial Period,8,-30,100,130,0.54518294
4817,,A,Mid-Imperial Period,9,100,300,200,0.54518294
4817,,A,Late Imperial Period,10,300,500,200,0.54518294
4818,,A,Republican Period,7,-300,-200,100,0.27513233
4819,,A,Early Imperial Period,8,-30,100,130,0.23275939
4819,,A,Mid-Imperial Period,9,100,300,200,0.23275939
4819,,A,Late Imperial Period,10,300,500,200,0.23275939
4820,,A,Republican Period,7,-100,-30,70,0.82498252
4820,,A,Early Imperial Period,8,-30,100,130,0.82498252
4821,,A,Early Imperial Period,8,-30,100,130,0.29597044
4821,,A,Mid-Imperial Period,9,100,300,200,0.29597044
4821,,A,Late Imperial Period,10,300,500,200,0.29597044
4822,,A,Early Imperial Period,8,-30,100,130,0.29596111
4822,,A,Mid-Imperial Period,9,100,300,200,0.29596111
4822,,A,Late Imperial Period,10,300,500,200,0.29596111
4823,,A,Republican Period,7,-300,-30,270,0.21021527
4824,,A,Republican Period,7,-100,-30,70,1.1792487
4824,,A,Early Imperial Period,8,-30,100,130,1.1792487
4825,,A,Early Imperial Period,8,-30,100,130,0.22879443
4825,,A,Mid-Imperial Period,9,100,300,200,0.22879443
4825,,A,Late Imperial Period,10,300,500,200,0.22879443
4826,,A,Early Imperial Period,8,-30,100,130,0.26595607
4826,,A,Mid-Imperial Period,9,100,300,200,0.26595607
4826,,A,Late Imperial Period,10,300,500,200,0.26595607
4827,,A,Early Imperial Period,8,-30,100,130,0.3841103
4827,,A,Mid-Imperial Period,9,100,300,200,0.3841103
4827,,A,Late Imperial Period,10,300,500,200,0.3841103
4828,,A,Early Imperial Period,8,-30,100,130,1.6113963
4828,,A,Mid-Imperial Period,9,100,300,200,1.6113963
4828,,A,Late Imperial Period,10,300,500,200,1.6113963
4829,,A,Early Imperial Period,8,-30,100,130,0.56470931
4829,,A,Mid-Imperial Period,9,100,300,200,0.56470931
4829,,A,Late Imperial Period,10,300,500,200,0.56470931
4830,,A,Republican Period,7,-100,-30,70,0.42811695
4830,,A,Early Imperial Period,8,-30,100,130,0.42811695
4831,,A,Republican Period,7,-100,-30,70,0.57982266
4832,,A,Republican Period,7,-100,-30,70,0.23658665
4832,,A,Early Imperial Period,8,-30,100,130,0.23658665
4833,,A,Republican Period,7,-100,-30,70,1.1627839
4833,,A,Early Imperial Period,8,-30,100,130,1.1627839
4834,,A,Early Imperial Period,8,-30,100,130,0.51704848
4834,,A,Mid-Imperial Period,9,100,300,200,0.51704848
4834,,A,Late Imperial Period,10,300,500,200,0.51704848
4835,,A,Early Imperial Period,8,-30,100,130,0.22256485
4835,,A,Mid-Imperial Period,9,100,300,200,0.22256485
4835,,A,Late Imperial Period,10,300,500,200,0.22256485
4836,,A,Early Imperial Period,8,-30,100,130,0.2225741
4836,,A,Mid-Imperial Period,9,100,300,200,0.2225741
4836,,A,Late Imperial Period,10,300,500,200,0.2225741
4837,,A,Early Imperial Period,8,-30,100,130,2.7647004
4837,,A,Mid-Imperial Period,9,100,300,200,2.7647004
4837,,A,Late Imperial Period,10,300,500,200,2.7647004
4838,,A,Republican Period,7,-100,-30,70,0.67421788
4838,,A,Early Imperial Period,8,-30,100,130,0.67421788
4838,,A,Mid-Imperial Period,9,100,300,200,0.67421788
4838,,A,Late Imperial Period,10,300,500,200,0.67421788
4839,,A,Republican Period,7,-200,-30,170,0.27749133
4840,,A,Early Imperial Period,8,-30,100,130,0.44686154
4840,,A,Mid-Imperial Period,9,100,300,200,0.44686154
4840,,A,Late Imperial Period,10,300,500,200,0.44686154
4841,,A,Early Imperial Period,8,-30,100,130,0.19422877
4841,,A,Mid-Imperial Period,9,100,300,200,0.19422877
4841,,A,Late Imperial Period,10,300,500,200,0.19422877
4842,,A,Early Imperial Period,8,-30,100,130,0.25131169
4842,,A,Mid-Imperial Period,9,100,300,200,0.25131169
4842,,A,Late Imperial Period,10,300,500,200,0.25131169
4843,,A,Republican Period,7,-300,-30,270,0.2061626
4844,,A,Republican Period,7,-100,-30,70,0.71022666
4844,,A,Early Imperial Period,8,-30,100,130,0.71022666
4845,,A,Republican Period,7,-100,-30,70,0.62194008
4845,,A,Early Imperial Period,8,-30,100,130,0.62194008
4846,,A,Early Imperial Period,8,-30,100,130,0.31188959
4846,,A,Mid-Imperial Period,9,100,300,200,0.31188959
4846,,A,Late Imperial Period,10,300,500,200,0.31188959
4847,Casale Gorziglia,A,Republican Period,7,-100,-30,70,0.61467576
4847,Casale Gorziglia,A,Early Imperial Period,8,-30,100,130,0.61467576
4848,,A,Republican Period,7,-100,-30,70,0.80957794
4848,,A,Early Imperial Period,8,-30,100,130,0.80957794
4849,,A,Early Imperial Period,8,-30,100,130,1.3908857
4849,,A,Mid-Imperial Period,9,100,300,200,1.3908857
4849,,A,Late Imperial Period,10,300,400,100,1.3908857
4850,,A,Early Imperial Period,8,-30,100,130,0.23638904
4850,,A,Mid-Imperial Period,9,100,300,200,0.23638904
4850,,A,Late Imperial Period,10,300,500,200,0.23638904
4851,Petrola,A,Early Imperial Period,8,-30,100,130,0.85618752
4851,Petrola,A,Mid-Imperial Period,9,100,300,200,0.85618752
4851,Petrola,A,Late Imperial Period,10,300,500,200,0.85618752
4852,,A,Early Imperial Period,8,-30,100,130,0.28130773
4852,,A,Mid-Imperial Period,9,100,300,200,0.28130773
4852,,A,Late Imperial Period,10,300,500,200,0.28130773
4853,,A,Republican Period,7,-100,-30,70,0.5275957
4853,,A,Early Imperial Period,8,-30,100,130,0.5275957
4854,,A,Early Imperial Period,8,-30,100,130,0.55194199
4854,,A,Mid-Imperial Period,9,100,300,200,0.55194199
4854,,A,Late Imperial Period,10,300,500,200,0.55194199
4855,,A,Late Iron Age,5,-600,-580,20,0.30364126
4855,,A,Archaic Period,6,-580,-500,80,0.30364126
4856,,A,Early Imperial Period,8,-30,100,130,0.14734291
4856,,A,Mid-Imperial Period,9,100,300,200,0.14734291
4856,,A,Late Imperial Period,10,300,500,200,0.14734291
4857,,A,Archaic Period,6,-500,-350,150,0.22809601
4857,,A,Republican Period,7,-350,-200,150,0.22809601
4858,,A,Early Imperial Period,8,-30,100,130,0.22809388
4858,,A,Mid-Imperial Period,9,100,300,200,0.22809388
4858,,A,Late Imperial Period,10,300,500,200,0.22809388
4859,,A,Archaic Period,6,-500,-350,150,0.22808819
4859,,A,Republican Period,7,-350,-300,50,0.22808819
4860,,A,Early Imperial Period,8,-30,100,130,0.22808415
4860,,A,Mid-Imperial Period,9,100,300,200,0.22808415
4860,,A,Late Imperial Period,10,300,500,200,0.22808415
4861,,A,Early Imperial Period,8,-30,100,130,0.22808562
4861,,A,Mid-Imperial Period,9,100,300,200,0.22808562
4861,,A,Late Imperial Period,10,300,500,200,0.22808562
4862,,A,Archaic Period,6,-500,-350,150,0.22808997
4862,,A,Republican Period,7,-350,-100,250,0.22808997
4863,Barbarano Roman Periodo,A,Republican Period,7,-100,-30,70,2.0462668
4863,Barbarano Roman Periodo,A,Early Imperial Period,8,-30,100,130,2.0462668
4864,Barbarano Roman Periodo,A,Late Bronze Age,3,-1200,-1020,180,0.41353953
4864,Barbarano Roman Periodo,A,Early Iron Age,4,-1020,-1000,20,0.41353953
4865,,A,Republican Period,7,-300,-30,270,0.27822739
4866,,A,Late Iron Age,5,-600,-580,20,1.2353597
4866,,A,Archaic Period,6,-580,-500,80,1.2353597
4867,,A,Late Iron Age,5,-600,-580,20,1.2394909
4867,,A,Archaic Period,6,-580,-500,80,1.2394909
4868,,A,Early Imperial Period,8,-30,100,130,0.28811908
4868,,A,Mid-Imperial Period,9,100,300,200,0.28811908
4868,,A,Late Imperial Period,10,300,500,200,0.28811908
4869,,A,Republican Period,7,-300,-30,270,0.55670822
4870,,A,Republican Period,7,-100,-30,70,0.23222357
4871,S. Giuliano,A,Early Iron Age,4,-1000,-750,250,5.2223248
4871,S. Giuliano,A,Late Iron Age,5,-750,-580,170,5.2223248
4871,S. Giuliano,A,Archaic Period,6,-580,-350,230,5.2223248
4871,S. Giuliano,A,Republican Period,7,-350,-30,320,5.2223248
4871,S. Giuliano,A,Early Imperial Period,8,-30,0,30,5.2223248
4872,,A,Late Iron Age,5,-600,-580,20,0.20453697
4872,,A,Archaic Period,6,-580,-500,80,0.20453697
4873,,A,Late Iron Age,5,-600,-580,20,0.20454039
4873,,A,Archaic Period,6,-580,-500,80,0.20454039
4874,Podere Capaccia,A,Republican Period,7,-300,-100,200,0.050000001
4875,Casa Mondeggi,A,Republican Period,7,-300,-100,200,0.039999999
4876,Casa Mondeggi,A,Republican Period,7,-300,-100,200,0.050000001
4877,Casa Ellere,A,Republican Period,7,-300,-100,200,0.1
4878,Casa le Fraschette,A,Republican Period,7,-300,-100,200,0.050000001
4879,S. Maria Novella,A,Republican Period,7,-300,-30,270,0.1
4880,Casa Corno,A,Republican Period,7,-50,-30,20,0.029999999
4880,Casa Corno,A,Early Imperial Period,8,-30,100,130,0.029999999
4881,Poggio la Guardia,A,Republican Period,7,-300,-100,200,0.1
4882,Caspreno,A,Republican Period,7,-50,-30,20,0.050000001
4882,Caspreno,A,Early Imperial Period,8,-30,50,80,0.050000001
4883,Caspreno,A,Republican Period,7,-300,-100,200,0.050000001
4884,Balze di Caspreno,A,Republican Period,7,-300,-100,200,0.039999999
4885,Caspreno,A,Republican Period,7,-300,-100,200,0.050000001
4886,Caspreno,A,Early Imperial Period,8,-30,50,80,0.050000001
4887,Catignano,A,Late Imperial Period,10,300,500,200,0.050000001
4888,Monaciano,A,Late Imperial Period,10,300,500,200,0.1
4889,Catignano,A,Late Imperial Period,10,300,500,200,0.050000001
4890,Pontignanello,A,Late Imperial Period,10,300,500,200,0.1
4891,Pontignanello,A,Republican Period,7,-300,-100,200,0.1
4892,Pontignanello,A,Republican Period,7,-300,-100,200,0.050000001
4893,Pontignanello,A,Early Imperial Period,8,-30,50,80,0.050000001
4894,La Sugliera,A,Republican Period,7,-300,-100,200,0.1
4895,Fangacci,A,Late Iron Age,5,-600,-580,20,0.1
4895,Fangacci,A,Archaic Period,6,-580,-500,80,0.1
4896,Lucignano,A,Republican Period,7,-100,-30,70,0.1
4897,Cerreto,A,Republican Period,7,-50,-30,20,0.050000001
4897,Cerreto,A,Early Imperial Period,8,-30,50,80,0.050000001
4898,Poggino,A,Republican Period,7,-50,-30,20,0.050000001
4898,Poggino,A,Early Imperial Period,8,-30,50,80,0.050000001
4899,Casa Bistolfo,A,Republican Period,7,-50,-30,20,0.050000001
4899,Casa Bistolfo,A,Early Imperial Period,8,-30,50,80,0.050000001
4901,Pieve di S. Marcellino,A,Early Imperial Period,8,-30,100,130,0.5
4901,Pieve di S. Marcellino,A,Mid-Imperial Period,9,100,300,200,0.5
4901,Pieve di S. Marcellino,A,Late Imperial Period,10,300,500,200,0.5
4902,S. Marcellino,A,Early Imperial Period,8,1,100,99,0.5
4902,S. Marcellino,A,Mid-Imperial Period,9,100,200,100,0.5
4903,Gaggiola,A,Early Imperial Period,8,-30,100,130,0.5
4903,Gaggiola,A,Mid-Imperial Period,9,100,200,100,0.5
4904,Petroio,A,Early Imperial Period,8,-30,100,130,0.2
4904,Petroio,A,Mid-Imperial Period,9,100,300,200,0.2
4904,Petroio,A,Late Imperial Period,10,300,500,200,0.2
4905,Maciallina,A,Republican Period,7,-300,-30,270,0.050000001
4906,Macialla,A,Late Iron Age,5,-600,-580,20,0.30000001
4906,Macialla,A,Archaic Period,6,-580,-500,80,0.30000001
4907,Lilliano,A,Republican Period,7,-300,-100,200,0.039999999
4908,Lilliano,A,Early Imperial Period,8,-30,100,130,0.69999999
4908,Lilliano,A,Mid-Imperial Period,9,100,300,200,0.69999999
4908,Lilliano,A,Late Imperial Period,10,300,500,200,0.69999999
4909,Casina,A,Early Imperial Period,8,-30,50,80,0.01
4910,Casina,A,Republican Period,7,-300,-100,200,0.01
4911,Miniera di Lignite,A,Republican Period,7,-300,-100,200,0.01
4912,Miniera di Lignite,A,Republican Period,7,-300,-100,200,0.01
4913,Le Cogne,A,Republican Period,7,-300,-100,200,0.01
4914,Le Cogne,A,Republican Period,7,-300,-100,200,0.01
4915,Le Cogne,A,Republican Period,7,-300,-100,200,0.01
4916,Le Cogne,A,Republican Period,7,-300,-100,200,0.01
4917,Le Cogne,A,Republican Period,7,-300,-100,200,0.01
4918,Le Cogne,A,Republican Period,7,-300,-100,200,0.01
4919,Le Macie,A,Republican Period,7,-300,-100,200,0.01
4919,Le Macie,B,Early Imperial Period,8,-30,100,130,0.01
4920,Le Macie,A,Republican Period,7,-300,-100,200,0.01
4921,Montelupo,A,Republican Period,7,-300,-100,200,0.01
4922,La Leccia,A,Republican Period,7,-300,-100,200,0.01
4923,La Leccia,A,Republican Period,7,-300,-100,200,0.30000001
4924,Bagnale,A,Early Imperial Period,8,-30,50,80,0.30000001
4925,Gaggiole,A,Republican Period,7,-300,-100,200,0.30000001
4926,Gaggiole,A,Republican Period,7,-300,-100,200,0.01
4927,Casa Belvedere,A,Republican Period,7,-300,-100,200,0.01
4928,Casa Belvedere,A,Republican Period,7,-300,-100,200,0.01
4929,Casa Belvedere,A,Republican Period,7,-300,-100,200,0.01
4930,S. Antimo,A,Republican Period,7,-100,-30,70,0.02
4931,S. Antimo,A,Republican Period,7,-100,-30,70,0.01
4932,S. Iacopo,A,Mid-Imperial Period,9,100,200,100,0.059999999
4933,Borro di Gagliano,A,Republican Period,7,-300,-100,200,0.02
4934,Borro di Gagliano,A,Republican Period,7,-300,-100,200,0.01
4935,Borro di Gagliano,A,Republican Period,7,-300,-100,200,0.01
4936,Rodano,A,Late Imperial Period,10,300,500,200,0.01
4937,Rodano,A,Late Imperial Period,10,300,500,200,0.01
4938,Rodano,A,Late Imperial Period,10,300,500,200,0.01
4939,Rodano,A,Republican Period,7,-300,-100,200,0.01
4940,Castellina in Chianti,A,Late Iron Age,5,-600,-580,20,0.80000001
4940,Castellina in Chianti,A,Archaic Period,6,-580,-350,230,0.80000001
4940,Castellina in Chianti,A,Republican Period,7,-350,-30,320,0.80000001
4941,Adine,A,Republican Period,7,-200,-30,170,0.01
4942,Cerreta,A,Republican Period,7,-300,-100,200,1
4943,Filanda,A,Republican Period,7,-300,-100,200,0.01
4944,La Casuccia,A,Early Imperial Period,8,-30,50,80,0.01
4945,S. Donato in Perano,A,Early Imperial Period,8,-30,50,80,0.01
4946,Podere Uliveta,A,Early Imperial Period,8,-30,50,80,0.01
4947,La Casa,A,Early Imperial Period,8,-30,50,80,0.01
4948,Fontecaresi,A,Early Imperial Period,8,-30,50,80,0.01
4949,Cetamura del Chianti,A,Republican Period,7,-200,-30,170,0.5
4949,Cetamura del Chianti,A,Early Imperial Period,8,-30,100,130,0.5
4950,Podere Domine,A,Republican Period,7,-300,-100,200,0.1
4951,Poggio la Croce,A,Late Iron Age,5,-700,-580,120,0.30000001
4951,Poggio la Croce,A,Archaic Period,6,-580,-350,230,0.30000001
4951,Poggio la Croce,A,Republican Period,7,-350,-200,150,0.30000001
4952,Casa S. Cristina,A,Republican Period,7,-300,-100,200,0.01
4953,Casa Beretone,A,Republican Period,7,-300,-100,200,0.01
4954,Casa Selvale,A,Republican Period,7,-300,-100,200,0.01
4955,Istine,A,Republican Period,7,-300,-100,200,0.5
4956,La Fonte,A,Republican Period,7,-300,-100,200,0.01
4957,La Fonte,A,Republican Period,7,-300,-250,50,0.01
4958,La Fonte,A,Mid-Imperial Period,9,200,300,100,0.01
4958,La Fonte,A,Late Imperial Period,10,300,400,100,0.01
4959,Terminone,A,Late Imperial Period,10,400,500,100,0.01
4959,Terminone,A,Late Antique Period,11,500,600,100,0.01
4960,I Caggi,A,Early Imperial Period,8,50,100,50,0.01
4961,I Caggi,A,Early Imperial Period,8,50,100,50,0.01
4962,I Caggi,A,Late Iron Age,5,-600,-580,20,0.01
4962,I Caggi,A,Archaic Period,6,-580,-500,80,0.01
4963,I Caggi,A,Republican Period,7,-200,-100,100,0.01
4964,I Caggi,A,Republican Period,7,-200,-100,100,0.01
4965,I Caggi,A,Republican Period,7,-200,-100,100,0.01
4966,I Caggi,A,Republican Period,7,-200,-100,100,0.01
4967,I Caggi,A,Republican Period,7,-200,-100,100,0.01
4968,I Caggi,A,Republican Period,7,-200,-100,100,0.029999999
4969,I Caggi,A,Republican Period,7,-200,-100,100,0.01
4970,,A,Early Imperial Period,8,-30,50,80,0.01
4971,Calosine,A,Early Imperial Period,8,-30,50,80,0.01
4972,Calosine,A,Late Imperial Period,10,300,500,200,0.02
4973,Calosine,A,Early Imperial Period,8,-30,50,80,0.01
4974,Calosine,A,Early Imperial Period,8,-30,50,80,0.01
4975,Calosine,A,Early Imperial Period,8,-30,50,80,0.01
4976,Calosine,A,Republican Period,7,-300,-100,200,0.01
4977,Calosine,A,Early Imperial Period,8,-30,50,80,0.01
4978,Calosine,A,Early Imperial Period,8,-30,50,80,0.01
4980,Molinaccio,A,Early Imperial Period,8,-30,50,80,0.01
4981,Molinaccio,A,Republican Period,7,-300,-100,200,0.01
4982,Abbadia a Monastero,A,Republican Period,7,-300,-100,200,0.01
4983,Abbadia a Monastero,A,Republican Period,7,-300,-100,200,0.01
4984,Abbadia a Monastero,A,Republican Period,7,-300,-100,200,0.01
4985,La Palazzina,A,Early Imperial Period,8,-30,50,80,0.01
4986,Borro delle Pisciole,A,Late Iron Age,5,-700,-580,120,0.30000001
4986,Borro delle Pisciole,A,Archaic Period,6,-580,-500,80,0.30000001
4987,Monastero d'Ombrone,A,Early Imperial Period,8,-30,50,80,0.01
4988,Monastero d'Ombrone,A,Early Imperial Period,8,-30,50,80,0.01
4989,Rancino,A,Late Imperial Period,10,300,500,200,0.01
4990,Rancino,A,Early Imperial Period,8,-30,50,80,0.01
4991,S. Vito,A,Early Imperial Period,8,-30,50,80,0.01
4992,Pieve a Pacina,A,Early Imperial Period,8,-30,50,80,0.01
4993,S. Polo,A,Early Imperial Period,8,-30,50,80,0.01
4994,S. Polo,A,Early Imperial Period,8,-30,50,80,0.01
4995,S. Polo,A,Early Bronze Age,1,-2300,-1700,600,0.01
4995,S. Polo,A,Middle Bronze Age,2,-1700,-1300,400,0.01
4995,S. Polo,A,Late Bronze Age,3,-1300,-1020,280,0.01
4995,S. Polo,A,Early Iron Age,4,-1020,-1000,20,0.01
4996,Le Pici,A,Republican Period,7,-300,-100,200,0.1
4997,Le Pici,A,Republican Period,7,-200,-100,100,1
4998,S. Felice,A,Republican Period,7,-50,-30,20,0.2
4998,S. Felice,A,Early Imperial Period,8,-30,100,130,0.2
4998,S. Felice,A,Mid-Imperial Period,9,100,200,100,0.2
4999,S. Felice,A,Republican Period,7,-50,-30,20,0.1
4999,S. Felice,A,Early Imperial Period,8,-30,0,30,0.1
5000,Chiesamonti,A,Early Imperial Period,8,-30,100,130,0.2
5000,Chiesamonti,A,Mid-Imperial Period,9,100,300,200,0.2
5000,Chiesamonti,A,Late Imperial Period,10,300,500,200,0.2
5001,Chiesamonti,A,Early Imperial Period,8,-30,50,80,0.01
5002,Chiesamonti,A,Late Iron Age,5,-700,-580,120,0.01
5002,Chiesamonti,A,Archaic Period,6,-580,-500,80,0.01
5003,La Chiusa,A,Late Iron Age,5,-700,-580,120,0.30000001
5003,La Chiusa,A,Archaic Period,6,-580,-400,180,0.30000001
5004,Villa a Sesta,A,Late Iron Age,5,-700,-580,120,0.30000001
5004,Villa a Sesta,A,Archaic Period,6,-580,-500,80,0.30000001
5005,La Casa,A,Early Imperial Period,8,-30,100,130,0.01
5006,La Casa,A,Early Imperial Period,8,-30,100,130,0.01
5007,,A,Early Imperial Period,8,-30,100,130,0.02
5008,Collaleccio,A,Early Imperial Period,8,-30,100,130,0.1
5009,Pianacci,A,Early Imperial Period,8,-30,50,80,0.01
5010,Sestaccia,A,Republican Period,7,-200,-30,170,0.01
5010,Sestaccia,A,Early Imperial Period,8,-30,100,130,0.01
5010,Sestaccia,A,Mid-Imperial Period,9,100,300,200,0.01
5010,Sestaccia,A,Late Imperial Period,10,300,500,200,0.01
5011,Poggio Tondo,A,Late Iron Age,5,-700,-580,120,0.1
5011,Poggio Tondo,A,Archaic Period,6,-580,-550,30,0.1
5012,Campi,A,Late Iron Age,5,-600,-580,20,0.01
5012,Campi,A,Archaic Period,6,-580,-350,230,0.01
5012,Campi,A,Republican Period,7,-350,-300,50,0.01
5013,Cetamura,A,Late Bronze Age,3,-1200,-1020,180,1.5
5013,Cetamura,A,Early Iron Age,4,-1020,-750,270,1.5
5013,Cetamura,A,Late Iron Age,5,-750,-580,170,1.5
5013,Cetamura,A,Archaic Period,6,-580,-350,230,1.5
5013,Cetamura,A,Republican Period,7,-350,-30,320,1.5
5014,Castellare,A,Republican Period,7,-200,-100,100,0.01
5015,Monteluco,A,Republican Period,7,-200,-30,170,0.01
5016,Montemassetto,A,Late Iron Age,5,-700,-580,120,0.30000001
5016,Montemassetto,A,Archaic Period,6,-580,-500,80,0.30000001
5017,Montemuro,A,Late Iron Age,5,-700,-580,120,0.1
5017,Montemuro,A,Archaic Period,6,-580,-500,80,0.1
5018,Fontealpino,A,Early Imperial Period,8,-30,100,130,1
5018,Fontealpino,A,Mid-Imperial Period,9,100,300,200,1
5018,Fontealpino,A,Late Imperial Period,10,300,500,200,1
5019,Fontealpino,A,Republican Period,7,-200,-30,170,0.01
5020,Fontealpino,A,Republican Period,7,-200,-30,170,0.01
5021,Fontealpino,A,Republican Period,7,-200,-30,170,0.01
5022,Monteaperti,A,Archaic Period,6,-550,-450,100,0.01
5023,Casa Madonna,A,Early Imperial Period,8,-30,100,130,0.1
5023,Casa Madonna,A,Mid-Imperial Period,9,100,300,200,0.1
5023,Casa Madonna,A,Late Imperial Period,10,300,500,200,0.1
5024,Casa Madonna,A,Republican Period,7,-200,-30,170,0.01
5025,Mencia,A,Republican Period,7,-50,-30,20,0.01
5025,Mencia,A,Early Imperial Period,8,-30,50,80,0.01
5026,Mencia,A,Late Iron Age,5,-600,-580,20,0.01
5026,Mencia,A,Archaic Period,6,-580,-400,180,0.01
5027,Mencia,A,Late Bronze Age,3,-1200,-1020,180,0.01
5027,Mencia,A,Early Iron Age,4,-1020,-1000,20,0.01
5028,Mencia,A,Late Bronze Age,3,-1200,-1020,180,0.1
5028,Mencia,A,Early Iron Age,4,-1020,-1000,20,0.1
5028,Mencia,B,Late Iron Age,5,-700,-580,120,0.1
5028,Mencia,B,Archaic Period,6,-580,-500,80,0.1
5028,Mencia,D,Republican Period,7,-300,-30,270,0.01
5028,Mencia,D,Early Imperial Period,8,-30,50,80,0.01
5029,Poggiarone,A,Late Iron Age,5,-700,-580,120,0.1
5029,Poggiarone,A,Archaic Period,6,-580,-500,80,0.1
5030,Acqua Borra,A,Late Bronze Age,3,-1200,-1020,180,0.01
5030,Acqua Borra,A,Early Iron Age,4,-1020,-1000,20,0.01
5031,Monteaperti,A,Late Iron Age,5,-600,-580,20,0.02
5031,Monteaperti,A,Archaic Period,6,-580,-500,80,0.02
5032,Monteaperti,A,Republican Period,7,-50,-30,20,0.01
5032,Monteaperti,A,Early Imperial Period,8,-30,50,80,0.01
5033,Poggione,A,Late Iron Age,5,-600,-580,20,0.01
5033,Poggione,A,Archaic Period,6,-580,-500,80,0.01
5034,S. Antonio,A,Republican Period,7,-50,-30,20,0.02
5034,S. Antonio,A,Early Imperial Period,8,-30,100,130,0.02
5035,S. Antonio,A,Republican Period,7,-200,-30,170,0.02
5036,S. Antonio,A,Republican Period,7,-200,-30,170,0.02
5037,S. Antonio,A,Republican Period,7,-200,-30,170,0.02
5038,S. Antonio,A,Republican Period,7,-200,-30,170,0.02
5039,Poggio a Pancole,A,Republican Period,7,-300,-200,100,0.059999999
5040,Poggio a Pancole,A,Republican Period,7,-300,-200,100,0.059999999
5041,Poggio a Pancole,A,Republican Period,7,-300,-200,100,0.059999999
5042,Scalia,A,Republican Period,7,-200,-30,170,0.01
5042,Scalia,A,Early Imperial Period,8,-30,50,80,0.01
5043,I Borghi,A,Early Imperial Period,8,-30,50,80,0.01
5044,Poggio del Crocino,A,Republican Period,7,-50,-30,20,0.029999999
5044,Poggio del Crocino,A,Early Imperial Period,8,-30,100,130,0.029999999
5045,Poggio del Crocino,A,Republican Period,7,-300,-100,200,0.01
5046,Poggio del Crocino,A,Republican Period,7,-300,-100,200,0.01
5047,Spretto,A,Late Imperial Period,10,400,500,100,0.2
5048,Spretto,A,Republican Period,7,-200,-100,100,0.01
5049,Spretto,A,Late Imperial Period,10,300,500,200,0.01
5050,Pian di Zoccolo,A,Republican Period,7,-300,-100,200,0.01
5051,Melariano,A,Republican Period,7,-50,-30,20,0.01
5051,Melariano,A,Early Imperial Period,8,-30,100,130,0.01
5052,Melariano,A,Republican Period,7,-50,-30,20,0.01
5052,Melariano,A,Early Imperial Period,8,-30,100,130,0.01
5053,Melariano,A,Republican Period,7,-50,-30,20,0.01
5053,Melariano,A,Early Imperial Period,8,-30,100,130,0.01
5054,Colonna del Grillo,A,Republican Period,7,-300,-100,200,0.01
5055,Colonna del Grillo,A,Republican Period,7,-50,-30,20,0.01
5055,Colonna del Grillo,A,Early Imperial Period,8,-30,100,130,0.01
5056,Colonna del Grillo,A,Late Imperial Period,10,300,500,200,0.01
5057,Colonna del Grillo,A,Late Imperial Period,10,300,500,200,0.01
5058,Badiola,A,Republican Period,7,-50,-30,20,0.01
5058,Badiola,A,Early Imperial Period,8,-30,100,130,0.01
5059,Badiola,A,Republican Period,7,-50,-30,20,0.01
5059,Badiola,A,Early Imperial Period,8,-30,100,130,0.01
5060,Quercetino,A,Republican Period,7,-200,-30,170,0.02
5061,Quercetino,A,Republican Period,7,-200,-30,170,0.02
5062,Paterno,A,Republican Period,7,-50,-30,20,0.01
5062,Paterno,A,Early Imperial Period,8,-30,50,80,0.01
5063,Paterno,A,Republican Period,7,-50,-30,20,0.02
5063,Paterno,A,Early Imperial Period,8,-30,100,130,0.02
5064,Paterno,A,Republican Period,7,-50,-30,20,0.02
5064,Paterno,A,Early Imperial Period,8,-30,100,130,0.02
5065,Paterno,A,Republican Period,7,-300,-100,200,0.01
5066,Paterno,A,Republican Period,7,-300,-100,200,0.01
5067,Paterno,A,Republican Period,7,-300,-100,200,0.01
5068,Casanuova,A,Republican Period,7,-50,-30,20,0.01
5068,Casanuova,A,Early Imperial Period,8,-30,50,80,0.01
5069,La Casina,A,Late Imperial Period,10,300,500,200,0.1
5070,S. Quirico,A,Republican Period,7,-50,-30,20,0.01
5070,S. Quirico,A,Early Imperial Period,8,-30,100,130,0.01
5071,S. Quirico,A,Republican Period,7,-300,-100,200,0.01
5072,S. Quirico,A,Republican Period,7,-300,-100,200,0.01
5073,S. Quirico,A,Republican Period,7,-200,-30,170,0.02
5074,S. Quirico,A,Republican Period,7,-300,-100,200,0.01
5075,S. Quirico,A,Republican Period,7,-300,-100,200,0.01
5076,Guistrigona,A,Republican Period,7,-300,-100,200,0.01
5077,Ligari,A,Republican Period,7,-200,-100,100,0.01
5078,Palazzo,A,Republican Period,7,-100,-30,70,0.01
5079,Pacinella,A,Republican Period,7,-200,-100,100,0.01
5080,Cornia,A,Republican Period,7,-200,-30,170,0.01
5081,Cornia,A,Republican Period,7,-50,-30,20,0.01
5081,Cornia,A,Early Imperial Period,8,-30,0,30,0.01
5082,Cornia,A,Republican Period,7,-50,-30,20,0.01
5082,Cornia,A,Early Imperial Period,8,-30,50,80,0.01
5083,Scalia,A,Republican Period,7,-300,-100,200,0.039999999
5084,Scalia,A,Republican Period,7,-300,-100,200,0.01
5085,Scalia,A,Republican Period,7,-300,-100,200,0.01
5086,Scalia,A,Republican Period,7,-300,-100,200,0.01
5087,Casa Coppi,A,Republican Period,7,-300,-100,200,0.01
5088,Radicofani,A,Republican Period,7,-100,-30,70,1
5088,Radicofani,A,Early Imperial Period,8,-30,100,130,1
5088,Radicofani,A,Mid-Imperial Period,9,100,300,200,1
5088,Radicofani,A,Late Imperial Period,10,300,500,200,1
5089,Radicofani,A,Republican Period,7,-100,-30,70,0.01
5089,Radicofani,A,Early Imperial Period,8,-30,100,130,0.01
5089,Radicofani,A,Mid-Imperial Period,9,100,300,200,0.01
5089,Radicofani,A,Late Imperial Period,10,300,500,200,0.01
5090,Radicofani,A,Republican Period,7,-100,-30,70,0.02
5090,Radicofani,A,Early Imperial Period,8,-30,100,130,0.02
5090,Radicofani,A,Mid-Imperial Period,9,100,300,200,0.02
5090,Radicofani,A,Late Imperial Period,10,300,500,200,0.02
5091,Radicofani,A,Republican Period,7,-100,-30,70,0.050000001
5091,Radicofani,A,Early Imperial Period,8,-30,100,130,0.050000001
5091,Radicofani,A,Mid-Imperial Period,9,100,300,200,0.050000001
5091,Radicofani,A,Late Imperial Period,10,300,500,200,0.050000001
5092,Radicofani,A,Republican Period,7,-200,-30,170,0.01
5092,Radicofani,A,Early Imperial Period,8,-30,100,130,0.01
5093,Radicofani,A,Republican Period,7,-200,-30,170,0.050000001
5093,Radicofani,A,Early Imperial Period,8,-30,100,130,0.050000001
5093,Radicofani,A,Mid-Imperial Period,9,100,300,200,0.050000001
5093,Radicofani,A,Late Imperial Period,10,300,500,200,0.050000001
5094,Radicofani,A,Republican Period,7,-200,-30,170,0.02
5094,Radicofani,A,Early Imperial Period,8,-30,100,130,0.02
5094,Radicofani,A,Mid-Imperial Period,9,100,300,200,0.02
5094,Radicofani,A,Late Imperial Period,10,300,500,200,0.02
5095,Radicofani,A,Republican Period,7,-200,-30,170,0.01
5095,Radicofani,A,Early Imperial Period,8,-30,100,130,0.01
5095,Radicofani,A,Mid-Imperial Period,9,100,300,200,0.01
5095,Radicofani,A,Late Imperial Period,10,300,500,200,0.01
5096,Radicofani,A,Republican Period,7,-300,-30,270,0.02
5097,Radicofani,A,Late Iron Age,5,-600,-580,20,0.01
5097,Radicofani,A,Archaic Period,6,-580,-350,230,0.01
5097,Radicofani,A,Republican Period,7,-350,-300,50,0.01
5098,Radicofani,A,Archaic Period,6,-400,-350,50,0.01
5098,Radicofani,A,Republican Period,7,-350,-30,320,0.01
5099,Radicofani,A,Republican Period,7,-200,-30,170,0.2
5099,Radicofani,A,Early Imperial Period,8,-30,100,130,0.2
5099,Radicofani,A,Mid-Imperial Period,9,100,300,200,0.2
5099,Radicofani,A,Late Imperial Period,10,300,500,200,0.2
5100,Radicofani,A,Republican Period,7,-50,-30,20,0.1
5100,Radicofani,A,Early Imperial Period,8,-30,100,130,0.1
5101,Radicofani,A,Republican Period,7,-200,-30,170,0.050000001
5101,Radicofani,A,Early Imperial Period,8,-30,100,130,0.050000001
5101,Radicofani,A,Mid-Imperial Period,9,100,300,200,0.050000001
5101,Radicofani,A,Late Imperial Period,10,300,500,200,0.050000001
5102,Radicofani,A,Early Imperial Period,8,0,100,100,0.2
5102,Radicofani,A,Mid-Imperial Period,9,100,300,200,0.2
5102,Radicofani,A,Late Imperial Period,10,300,500,200,0.2
5103,Radicofani,A,Early Imperial Period,8,0,100,100,0.01
5103,Radicofani,A,Mid-Imperial Period,9,100,300,200,0.01
5103,Radicofani,A,Late Imperial Period,10,300,500,200,0.01
5104,Radicofani,A,Early Imperial Period,8,0,100,100,0.039999999
5104,Radicofani,A,Mid-Imperial Period,9,100,300,200,0.039999999
5104,Radicofani,A,Late Imperial Period,10,300,500,200,0.039999999
5105,Radicofani,A,Archaic Period,6,-400,-350,50,0.01
5105,Radicofani,A,Republican Period,7,-350,-30,320,0.01
5105,Radicofani,A,Early Imperial Period,8,-30,0,30,0.01
5106,Radicofani,A,Early Imperial Period,8,-20,100,120,0.02
5106,Radicofani,A,Mid-Imperial Period,9,100,300,200,0.02
5106,Radicofani,A,Late Imperial Period,10,300,500,200,0.02
5107,Radicofani,A,Archaic Period,6,-400,-350,50,0.079999998
5107,Radicofani,A,Republican Period,7,-350,-300,50,0.079999998
5108,Radicofani,A,Republican Period,7,-50,-30,20,0.050000001
5108,Radicofani,A,Early Imperial Period,8,-30,100,130,0.050000001
5109,Radicofani,A,Early Imperial Period,8,0,100,100,0.039999999
5109,Radicofani,A,Mid-Imperial Period,9,100,300,200,0.039999999
5109,Radicofani,A,Late Imperial Period,10,300,500,200,0.039999999
5110,Radicofani,A,Late Iron Age,5,-700,-580,120,0.5
5110,Radicofani,A,Archaic Period,6,-580,-350,230,0.5
5110,Radicofani,A,Republican Period,7,-350,-300,50,0.5
5116,Abbadia S. Salvatore,A,Early Bronze Age,1,-2300,-2000,300,0.01
5119,Case la Querciola-Poggibonsi,A,Early Imperial Period,8,-30,50,80,0.01
5120,Case la Querciola-Poggibonsi,A,Early Imperial Period,8,-30,50,80,0.01
5121,Casa Monticino-Poggibonsi,A,Early Imperial Period,8,-30,50,80,0.01
5122,Villole di sotto-Poggibonsi,A,Republican Period,7,-200,-30,170,0.01
5123,Verniano,A,Early Imperial Period,8,-30,100,130,0.01
5124,Sorgente di Cinciano,A,Republican Period,7,-300,-100,200,0.01
5125,San Martino,A,Republican Period,7,-50,-30,20,0.01
5125,San Martino,A,Early Imperial Period,8,-30,50,80,0.01
5126,Ellerone,A,Republican Period,7,-150,-50,100,0.01
5127,San Giorgio Vecchio,A,Early Imperial Period,8,-30,100,130,0.01
5128,San Giorgio Vecchio,A,Early Imperial Period,8,-30,100,130,0.02
5129,San Giorgio,A,Republican Period,7,-200,-30,170,0.01
5130,San Giorgio Vecchio,A,Late Imperial Period,10,400,500,100,0.01
5130,San Giorgio Vecchio,A,Late Antique Period,11,500,600,100,0.01
5131,San Giorgio Vecchio,A,Late Imperial Period,10,400,500,100,0.01
5131,San Giorgio Vecchio,A,Late Antique Period,11,500,600,100,0.01
5133,San Giorgio Vecchio,A,Republican Period,7,-150,-30,120,0.01
5134,Ellerone,A,Early Imperial Period,8,-30,100,130,0.01
5135,Ellerone,A,Republican Period,7,-200,-30,170,0.01
5136,Ellerone,A,Republican Period,7,-300,-100,200,0.01
5137,Ellerone,A,Republican Period,7,-200,-30,170,0.01
5138,Ellerone,A,Republican Period,7,-200,-30,170,0.01
5139,Ellerone,A,Late Imperial Period,10,400,500,100,0.01
5139,Ellerone,A,Late Antique Period,11,500,600,100,0.01
5140,Ellerone,A,Late Imperial Period,10,400,500,100,0.01
5140,Ellerone,A,Late Antique Period,11,500,600,100,0.01
5141,Ellerone,A,Late Imperial Period,10,400,500,100,0.01
5141,Ellerone,A,Late Antique Period,11,500,600,100,0.01
5142,Ellerone,A,Late Imperial Period,10,400,500,100,0.01
5142,Ellerone,A,Late Antique Period,11,500,600,100,0.01
5143,Ellerone,A,Early Imperial Period,8,-30,100,130,0.01
5144,Ellerone,A,Late Imperial Period,10,400,500,100,0.01
5144,Ellerone,A,Late Antique Period,11,500,600,100,0.01
5145,Ellerone,A,Republican Period,7,-200,-30,170,0.01
5146,Le Buche,A,Early Imperial Period,8,50,100,50,0.01
5146,Le Buche,A,Mid-Imperial Period,9,100,200,100,0.01
5147,Talciona,A,Mid-Imperial Period,9,100,200,100,0.01
5148,Luco,A,Early Imperial Period,8,-30,100,130,0.01
5149,Fossoli,A,Early Imperial Period,8,-30,100,130,0.01
5150,Fossoli,A,Early Imperial Period,8,-30,100,130,0.01
5151,Fontana,A,Republican Period,7,-300,-100,200,0.01
5152,Fontana,A,Republican Period,7,-300,-100,200,0.01
5153,Fontana,A,Republican Period,7,-300,-100,200,0.02
5154,San Silvestro,A,Late Imperial Period,10,400,500,100,0.01
5154,San Silvestro,A,Late Antique Period,11,500,600,100,0.01
5155,San Silvestro,A,Late Imperial Period,10,400,500,100,0.01
5155,San Silvestro,A,Late Antique Period,11,500,600,100,0.01
5156,Castelluccio,A,Republican Period,7,-200,-30,170,0.01
5157,S. Antonio al Bosco,A,Republican Period,7,-300,-100,200,0.01
5158,S. Antonio al Bosco,A,Republican Period,7,-200,-30,170,0.01
5159,S. Antonio al Bosco,A,Late Imperial Period,10,400,500,100,0.029999999
5159,S. Antonio al Bosco,A,Late Antique Period,11,500,600,100,0.029999999
5160,Mensanello,A,Republican Period,7,-300,-100,200,0.01
5161,Ceretolo,A,Republican Period,7,-100,-30,70,0.01
5162,Santinovo,A,Republican Period,7,-300,-100,200,0.1
5163,Santinovo,A,Late Iron Age,5,-700,-580,120,0.01
5163,Santinovo,A,Archaic Period,6,-580,-500,80,0.01
5164,Santinovo,A,Late Iron Age,5,-700,-580,120,0.01
5164,Santinovo,A,Archaic Period,6,-580,-500,80,0.01
5165,Santinovo,A,Republican Period,7,-300,-100,200,0.02
5166,Santinovo,A,Republican Period,7,-300,-100,200,0.01
5167,Santinovo,A,Republican Period,7,-300,-100,200,0.029999999
5168,Santinovo,A,Republican Period,7,-200,-30,170,0.30000001
5169,Santinovo,A,Early Imperial Period,8,-30,100,130,0.029999999
5170,Fabbrica,A,Republican Period,7,-300,-100,200,0.01
5171,Fabbrica,A,Republican Period,7,-300,-100,200,0.01
5172,Fabbrica,A,Republican Period,7,-300,-100,200,0.01
5173,Fabbrica,A,Republican Period,7,-300,-100,200,0.01
5174,Fabbrica,A,Early Imperial Period,8,-30,100,130,0.01
5175,Fabbrica,A,Early Imperial Period,8,-30,100,130,0.2
5176,Le Caldane,A,Early Imperial Period,8,-30,100,130,0.029999999
5177,Le Caldane,A,Early Imperial Period,8,-30,100,130,0.2
5179,Boscona,A,Late Iron Age,5,-600,-580,20,0.01
5179,Boscona,A,Archaic Period,6,-580,-400,180,0.01
5180,Boscona,A,Republican Period,7,-300,-100,200,0.01
5181,Boscona,A,Late Iron Age,5,-700,-580,120,0.01
5181,Boscona,A,Archaic Period,6,-580,-400,180,0.01
5182,Mugnano,A,Republican Period,7,-300,-100,200,0.01
5183,Borgatello,A,Republican Period,7,-150,-50,100,0.01
5184,Borgatello,A,Late Iron Age,5,-600,-580,20,0.01
5184,Borgatello,A,Archaic Period,6,-580,-450,130,0.01
5185,Montecchio,A,Republican Period,7,-300,-100,200,0.01
5186,Fabbiano di Sopra,A,Late Iron Age,5,-700,-580,120,0.01
5186,Fabbiano di Sopra,A,Archaic Period,6,-580,-500,80,0.01
5187,Fabbiano di Sopra,A,Late Iron Age,5,-700,-580,120,0.01
5187,Fabbiano di Sopra,A,Archaic Period,6,-580,-500,80,0.01
5188,Fabbiano di Sopra,A,Late Iron Age,5,-700,-580,120,0.01
5188,Fabbiano di Sopra,A,Archaic Period,6,-580,-500,80,0.01
5189,Fabbiano di Sopra,A,Republican Period,7,-150,-30,120,0.01
5190,Case la Speranza,A,Republican Period,7,-300,-100,200,0.01
5191,Taverna,A,Republican Period,7,-50,-30,20,0.01
5191,Taverna,A,Early Imperial Period,8,-30,0,30,0.01
5192,Poggio alla Staffa,A,Early Imperial Period,8,-30,100,130,0.2
5193,Montornello,A,Republican Period,7,-300,-100,200,0.01
5194,Le Buche,A,Mid-Imperial Period,9,200,300,100,0.1
5194,Le Buche,A,Late Imperial Period,10,300,500,200,0.1
5195,Fattoria Le Fonti,A,Early Imperial Period,8,-30,100,130,0.01
5196,Bagno,A,Republican Period,7,-300,-100,200,0.01
5197,Bagno,A,Republican Period,7,-250,-100,150,0.01
5198,Bagno,A,Early Imperial Period,8,-30,100,130,0.01
5199,Bagno,A,Early Imperial Period,8,-30,50,80,0.01
5200,Podere Prezzano,A,Early Imperial Period,8,0,100,100,0.01
5200,Podere Prezzano,A,Mid-Imperial Period,9,100,200,100,0.01
5201,Poggio di Macericca,A,Republican Period,7,-300,-100,200,0.01
5202,Poggio di Macericca,A,Early Imperial Period,8,0,100,100,0.02
5202,Poggio di Macericca,A,Mid-Imperial Period,9,100,200,100,0.02
5203,L'Osteria,A,Early Imperial Period,8,-30,50,80,0.01
5204,Case San Martino,A,Republican Period,7,-300,-100,200,0.01
5205,Poggio L' Allodola,A,Late Iron Age,5,-600,-580,20,0.1
5205,Poggio L' Allodola,A,Archaic Period,6,-580,-500,80,0.1
5206,Poggio L' Allodola,A,Late Iron Age,5,-600,-580,20,0.40000001
5206,Poggio L' Allodola,A,Archaic Period,6,-580,-500,80,0.40000001
5207,Poggio L' Allodola,A,Late Iron Age,5,-700,-580,120,0.01
5207,Poggio L' Allodola,A,Archaic Period,6,-580,-500,80,0.01
5208,Poggio L' Allodola,A,Late Iron Age,5,-700,-580,120,0.01
5208,Poggio L' Allodola,A,Archaic Period,6,-580,-500,80,0.01
5209,Poggio L' Allodola,A,Republican Period,7,-150,-50,100,0.059999999
5210,Podere Aiello,A,Late Iron Age,5,-650,-580,70,0.01
5210,Podere Aiello,A,Archaic Period,6,-580,-550,30,0.01
5211,Podere Aiello,A,Late Iron Age,5,-650,-580,70,0.01
5211,Podere Aiello,A,Archaic Period,6,-580,-550,30,0.01
5212,Poggio La Fornace,A,Republican Period,7,-150,-50,100,0.01
5213,Poggio La Fornace,A,Early Imperial Period,8,-30,50,80,0.029999999
5214,Poggio La Fornace,A,Early Imperial Period,8,-30,50,80,0.050000001
5215,C. Ravina,A,Republican Period,7,-300,-200,100,0.01
5216,C. Ravina,A,Republican Period,7,-300,-200,100,0.01
5217,C. Ravina,A,Republican Period,7,-300,-100,200,0.30000001
5218,C. Ravina,A,Republican Period,7,-200,-30,170,0.01
5219,Lupompesi,A,Archaic Period,6,-500,-400,100,0.01
5220,C. Montazzi,A,Republican Period,7,-300,-50,250,0.01
5221,Campriano,A,Republican Period,7,-300,-50,250,0.01
5222,Campriano,A,Late Iron Age,5,-600,-580,20,0.01
5222,Campriano,A,Archaic Period,6,-580,-400,180,0.01
5223,Campriano,A,Late Iron Age,5,-600,-580,20,0.01
5223,Campriano,A,Archaic Period,6,-580,-500,80,0.01
5224,Poggio La Fornace,A,Late Iron Age,5,-600,-580,20,0.01
5224,Poggio La Fornace,A,Archaic Period,6,-580,-500,80,0.01
5225,Crevole,A,Republican Period,7,-150,-50,100,0.01
5226,Colombaio,A,Republican Period,7,-350,-275,75,0.01
5227,Colombaio,A,Late Iron Age,5,-600,-580,20,0.01
5227,Colombaio,A,Archaic Period,6,-580,-500,80,0.01
5228,Colombaio,A,Republican Period,7,-300,-150,150,0.01
5229,Colombaio,A,Republican Period,7,-200,-30,170,0.01
5230,Colombaio,A,Early Imperial Period,8,50,100,50,0.01
5231,Tinoni,A,Late Iron Age,5,-600,-580,20,0.01
5231,Tinoni,A,Archaic Period,6,-580,-400,180,0.01
5232,Tinoni,A,Late Iron Age,5,-650,-600,50,0.01
5233,Vescovado,A,Republican Period,7,-150,-50,100,0.01
5234,Vescovado,A,Late Iron Age,5,-650,-580,70,0.01
5234,Vescovado,A,Archaic Period,6,-580,-500,80,0.01
5235,Vescovado,A,Late Iron Age,5,-650,-580,70,0.01
5235,Vescovado,A,Archaic Period,6,-580,-500,80,0.01
5236,Vescovado,A,Republican Period,7,-300,-250,50,0.01
5237,Vescovado,A,Republican Period,7,-300,-250,50,0.01
5238,Vescovado,A,Late Iron Age,5,-600,-580,20,0.01
5238,Vescovado,A,Archaic Period,6,-580,-500,80,0.01
5239,Vescovado,A,Republican Period,7,-300,-150,150,0.01
5240,Colombaio,A,Republican Period,7,-200,-30,170,0.01
5241,Monecchio,A,Republican Period,7,-300,-200,100,0.039999999
5242,Poggio Napoleone,A,Republican Period,7,-300,-50,250,0.01
5243,podere Monecchio,A,Late Iron Age,5,-650,-580,70,0.039999999
5243,podere Monecchio,A,Archaic Period,6,-580,-500,80,0.039999999
5244,podere Monecchio,A,Late Iron Age,5,-700,-580,120,0.01
5244,podere Monecchio,A,Archaic Period,6,-580,-350,230,0.01
5244,podere Monecchio,A,Republican Period,7,-350,-300,50,0.01
5245,podere Monecchio,A,Late Iron Age,5,-700,-580,120,0.01
5245,podere Monecchio,A,Archaic Period,6,-580,-350,230,0.01
5245,podere Monecchio,A,Republican Period,7,-350,-300,50,0.01
5246,Colombaio,A,Republican Period,7,-300,-50,250,0.01
5247,Colombaio,A,Late Iron Age,5,-600,-580,20,0.01
5247,Colombaio,A,Archaic Period,6,-580,-400,180,0.01
5248,Rospatoio,A,Late Iron Age,5,-700,-580,120,0.30000001
5248,Rospatoio,A,Archaic Period,6,-580,-350,230,0.30000001
5248,Rospatoio,A,Republican Period,7,-350,-300,50,0.30000001
5249,Crevole,A,Republican Period,7,-300,-50,250,0.01
5252,Poggio Civitate,A,Late Iron Age,5,-650,-580,70,0.5
5252,Poggio Civitate,A,Archaic Period,6,-580,-530,50,0.5
5253,Murlo,A,Early Imperial Period,8,0,100,100,0.1
5253,Murlo,A,Mid-Imperial Period,9,100,200,100,0.1
5254,C. Nuova,A,Republican Period,7,-300,-100,200,0.01
5255,C. Nuova,A,Late Iron Age,5,-600,-580,20,0.01
5255,C. Nuova,A,Archaic Period,6,-580,-500,80,0.01
5256,C. Nuova,A,Mid-Imperial Period,9,100,200,100,0.01
5257,C. Nuova,A,Republican Period,7,-250,-200,50,0.01
5258,C. Nuova,A,Late Iron Age,5,-650,-580,70,0.01
5258,C. Nuova,A,Archaic Period,6,-580,-550,30,0.01
5259,C. Nuova,A,Republican Period,7,-300,-50,250,0.01
5260,C. Nuova,A,Late Iron Age,5,-600,-580,20,0.01
5260,C. Nuova,A,Archaic Period,6,-580,-500,80,0.01
5261,C. Nuova,A,Mid-Imperial Period,9,100,250,150,0.01
5262,podere La Fornace,A,Republican Period,7,-300,-150,150,0.02
5263,podere La Fornace,A,Republican Period,7,-300,-200,100,0.01
5264,podere Bagnolo,A,Late Iron Age,5,-600,-580,20,0.01
5264,podere Bagnolo,A,Archaic Period,6,-580,-500,80,0.01
5265,podere Bagnolo,A,Republican Period,7,-200,-100,100,0.01
5266,podere Bagnolo,A,Republican Period,7,-300,-100,200,0.01
5267,Murlo,A,Mid-Imperial Period,9,100,250,150,0.059999999
5268,podere Teschio,A,Republican Period,7,-300,-100,200,0.02
5269,podere Caselli,A,Republican Period,7,-300,-100,200,0.01
5270,Poggio La Fornace,A,Republican Period,7,-250,-150,100,0.01
5271,podere Caselli,A,Late Iron Age,5,-600,-580,20,0.01
5271,podere Caselli,A,Archaic Period,6,-580,-500,80,0.01
5272,podere Caselli,A,Republican Period,7,-300,-30,270,0.01
5273,C. Nuova,A,Republican Period,7,-300,-200,100,0.01
5274,San Giusto,A,Archaic Period,6,-400,-350,50,0.01
5274,San Giusto,A,Republican Period,7,-350,-300,50,0.01
5275,San Giusto,A,Archaic Period,6,-550,-450,100,0.01
5276,San Giusto,A,Republican Period,7,-300,-100,200,0.01
5277,C. Nuova,A,Early Imperial Period,8,0,50,50,0.01
5278,C. Nuova,A,Republican Period,7,-250,-150,100,0.01
5279,C. Nuova,A,Late Iron Age,5,-700,-580,120,0.01
5279,C. Nuova,A,Archaic Period,6,-580,-500,80,0.01
5280,C. Nuova,A,Republican Period,7,-300,-30,270,0.01
5281,podere Il Poggio,A,Republican Period,7,-300,-100,200,0.01
5282,podere Il Poggio,A,Early Imperial Period,8,50,100,50,0.5
5282,podere Il Poggio,A,Mid-Imperial Period,9,100,300,200,0.5
5282,podere Il Poggio,A,Late Imperial Period,10,300,500,200,0.5
5283,podere Fontanelle,A,Republican Period,7,-300,-100,200,0.01
5284,podere Fontanelle,A,Republican Period,7,-50,-30,20,0.01
5284,podere Fontanelle,A,Early Imperial Period,8,-30,50,80,0.01
5285,podere Il Poggio,A,Early Imperial Period,8,0,100,100,0.01
5286,Montepascini,A,Republican Period,7,-300,-150,150,0.01
5287,Podere Querciale,A,Late Iron Age,5,-650,-580,70,0.01
5287,Podere Querciale,A,Archaic Period,6,-580,-550,30,0.01
5288,Pieve a Carli,A,Late Iron Age,5,-650,-580,70,0.01
5288,Pieve a Carli,A,Archaic Period,6,-580,-550,30,0.01
5289,Monteorgiali,A,Late Iron Age,5,-650,-580,70,0.01
5289,Monteorgiali,A,Archaic Period,6,-580,-550,30,0.01
5290,podere Pratella,A,Late Iron Age,5,-650,-580,70,0.01
5290,podere Pratella,A,Archaic Period,6,-580,-550,30,0.01
5291,Montepertuso,A,Republican Period,7,-350,-250,100,0.029999999
5292,Tinoni,A,Early Imperial Period,8,-30,100,130,0.01
5293,Tinoni,A,Republican Period,7,-300,-50,250,0.01
5294,Montepescini,A,Early Imperial Period,8,50,100,50,0.01
5295,Querciale,A,Late Iron Age,5,-600,-580,20,0.01
5295,Querciale,A,Archaic Period,6,-580,-400,180,0.01
5296,podere Querciale,A,Republican Period,7,-300,-150,150,0.01
5297,podere Arniano,A,Republican Period,7,-250,-200,50,0.01
5298,podere Arniano,A,Republican Period,7,-150,-100,50,0.01
5299,podere Arniano,A,Late Iron Age,5,-600,-580,20,0.01
5299,podere Arniano,A,Archaic Period,6,-580,-500,80,0.01
5300,podere Arniano,A,Early Imperial Period,8,0,100,100,0.01
5300,podere Arniano,A,Mid-Imperial Period,9,100,200,100,0.01
5301,poggio Casale,A,Republican Period,7,-350,-300,50,0.01
5302,poggio Casale,A,Republican Period,7,-350,-300,50,0.01
5303,Murlo,A,Republican Period,7,-300,-100,200,0.01
5304,Montepascini,A,Late Iron Age,5,-650,-580,70,0.01
5304,Montepascini,A,Archaic Period,6,-580,-500,80,0.01
5305,p. Castello,A,Republican Period,7,-350,-300,50,0.01
5306,p. Castello,A,Republican Period,7,-100,-30,70,0.01
5306,p. Castello,A,Early Imperial Period,8,-30,50,80,0.01
5307,podere la Fornace,A,Late Iron Age,5,-650,-580,70,0.01
5307,podere la Fornace,A,Archaic Period,6,-580,-550,30,0.01
5308,podere la Fornace,A,Late Iron Age,5,-650,-580,70,0.01
5308,podere la Fornace,A,Archaic Period,6,-580,-500,80,0.01
5309,podere Caggio,A,Republican Period,7,-300,-100,200,0.01
5310,Santa Margherita,A,Late Iron Age,5,-600,-580,20,0.01
5310,Santa Margherita,A,Archaic Period,6,-580,-500,80,0.01
5311,Santa Margherita,A,Late Iron Age,5,-600,-580,20,0.01
5311,Santa Margherita,A,Archaic Period,6,-580,-500,80,0.01
5312,Santa Margherita,A,Republican Period,7,-300,-100,200,0.01
5313,Poggio Castello,A,Republican Period,7,-300,-100,200,0.01
5314,Poggio Castello,A,Republican Period,7,-100,-30,70,0.01
5314,Poggio Castello,A,Early Imperial Period,8,-30,50,80,0.01
5315,Poggio Castello,A,Republican Period,7,-300,-100,200,0.01
5316,Poggio Castello,A,Republican Period,7,-100,-30,70,0.01
5316,Poggio Castello,A,Early Imperial Period,8,-30,50,80,0.01
5317,Poggio Castello,A,Late Iron Age,5,-600,-580,20,0.01
5317,Poggio Castello,A,Archaic Period,6,-580,-500,80,0.01
5318,Montepescini,A,Republican Period,7,-300,-100,200,0.01
5319,Montepescini,A,Late Iron Age,5,-600,-580,20,0.01
5319,Montepescini,A,Archaic Period,6,-580,-500,80,0.01
5320,Montepescini,A,Republican Period,7,-200,-30,170,0.01
5321,podere Fontanelle,A,Late Iron Age,5,-600,-580,20,0.01
5321,podere Fontanelle,A,Archaic Period,6,-580,-500,80,0.01
5322,podere Fontanelle,A,Archaic Period,6,-400,-350,50,0.01
5322,podere Fontanelle,A,Republican Period,7,-350,-50,300,0.01
5323,podere Fontanelle,A,Early Imperial Period,8,-30,100,130,0.02
5324,podere Fontanelle,A,Republican Period,7,-250,-200,50,0.02
5325,podere Fontanelle,A,Republican Period,7,-300,-100,200,0.02
5326,podere Fontanelle,A,Republican Period,7,-100,-30,70,0.5
5326,podere Fontanelle,A,Early Imperial Period,8,-30,100,130,0.5
5326,podere Fontanelle,A,Mid-Imperial Period,9,100,300,200,0.5
5326,podere Fontanelle,A,Late Imperial Period,10,300,500,200,0.5
5327,podere Aiello,A,Republican Period,7,-300,-100,200,0.01
5328,podere Aiello,A,Republican Period,7,-200,-30,170,0.01
5329,podere Aiello,A,Early Imperial Period,8,-30,100,130,0.01
5329,podere Aiello,A,Mid-Imperial Period,9,100,200,100,0.01
5330,santa Margherita,A,Republican Period,7,-200,-30,170,0.029999999
5331,Casa Bianca,A,Early Imperial Period,8,0,100,100,0.02
5332,Poggio Copoli,A,Republican Period,7,-100,-30,70,0.01
5332,Poggio Copoli,A,Early Imperial Period,8,-30,100,130,0.01
5333,Poggio Copoli,A,Early Imperial Period,8,-30,100,130,0.01
5334,Poggio Copoli,A,Republican Period,7,-100,-30,70,0.039999999
5334,Poggio Copoli,A,Early Imperial Period,8,-30,100,130,0.039999999
5335,Poggio Copoli,A,Republican Period,7,-300,-50,250,0.02
5336,Poggio Copoli,A,Late Iron Age,5,-600,-580,20,0.01
5336,Poggio Copoli,A,Archaic Period,6,-580,-500,80,0.01
5337,Montepascini,A,Early Imperial Period,8,-30,100,130,0.01
5338,Montepascini,A,Early Imperial Period,8,-30,100,130,0.01
5339,Montepascini,A,Republican Period,7,-300,-50,250,0.01
5340,Montepascini,A,Republican Period,7,-300,-30,270,0.01
5340,Montepascini,A,Early Imperial Period,8,-30,100,130,0.01
5341,Montepascini,A,Early Imperial Period,8,-30,100,130,0.02
5342,podere Pratella,A,Early Imperial Period,8,-30,100,130,0.029999999
5343,Poggio Cerretani,A,Republican Period,7,-300,-250,50,0.01
5344,Poggio Cerretani,A,Early Imperial Period,8,-30,100,130,0.01
5345,il Poggino,A,Republican Period,7,-300,-100,200,0.01
5346,il Poggino,A,Republican Period,7,-300,-50,250,0.01
5347,il Poggino,A,Republican Period,7,-300,-50,250,0.01
5348,il Poggino,A,Early Imperial Period,8,-30,100,130,0.01
5349,il Poggino,A,Republican Period,7,-300,-100,200,0.01
5350,il Poggino,A,Early Imperial Period,8,0,50,50,0.01
5351,Pian di Rotella,A,Early Imperial Period,8,-30,100,130,0.01
5352,Poggio Copoli,A,Late Iron Age,5,-600,-580,20,0.01
5352,Poggio Copoli,A,Archaic Period,6,-580,-550,30,0.01
5353,Poggio Copoli,A,Late Iron Age,5,-700,-580,120,0.2
5353,Poggio Copoli,A,Archaic Period,6,-580,-350,230,0.2
5353,Poggio Copoli,A,Republican Period,7,-350,-300,50,0.2
5356,Poggio Copoli,A,Late Iron Age,5,-700,-580,120,0.1
5356,Poggio Copoli,A,Archaic Period,6,-580,-350,230,0.1
5356,Poggio Copoli,A,Republican Period,7,-350,-300,50,0.1
5357,Poggio ai Leccioni,A,Republican Period,7,-300,-50,250,0.1
5358,podere la Pieve,A,Late Iron Age,5,-600,-580,20,0.1
5358,podere la Pieve,A,Archaic Period,6,-580,-500,80,0.1
5359,podere la Pieve,A,Early Imperial Period,8,-30,100,130,0.1
5360,Cava Barbieri,A,Early Bronze Age,1,-2300,-1700,600,0.5
5360,Cava Barbieri,A,Middle Bronze Age,2,-1700,-1300,400,0.5
5360,Cava Barbieri,A,Late Bronze Age,3,-1300,-1020,280,0.5
5360,Cava Barbieri,A,Early Iron Age,4,-1020,-1000,20,0.5
5362,S. Anna in Camprena,A,Early Imperial Period,8,-30,100,130,0.01
5362,S. Anna in Camprena,A,Mid-Imperial Period,9,100,300,200,0.01
5362,S. Anna in Camprena,A,Late Imperial Period,10,300,500,200,0.01
5363,S. Anna in Camprena,A,Republican Period,7,-200,-30,170,0.01
5365,Spedaletto,A,Republican Period,7,-100,-30,70,0.1
5365,Spedaletto,A,Early Imperial Period,8,-30,100,130,0.1
5366,Spedaletto,A,Early Imperial Period,8,0,100,100,0.01
5366,Spedaletto,A,Mid-Imperial Period,9,100,200,100,0.01
5367,Spedaletto,A,Republican Period,7,-300,-30,270,0.01
5369,Podere Porciano,A,Early Bronze Age,1,-2300,-1700,600,0.01
5369,Podere Porciano,A,Middle Bronze Age,2,-1700,-1300,400,0.01
5369,Podere Porciano,A,Late Bronze Age,3,-1300,-1020,280,0.01
5369,Podere Porciano,A,Early Iron Age,4,-1020,-1000,20,0.01
5370,Sassaie,A,Republican Period,7,-100,-30,70,0.1
5370,Sassaie,A,Early Imperial Period,8,-30,100,130,0.1
5371,Costone di Pienza,A,Early Bronze Age,1,-2300,-1700,600,0.01
5371,Costone di Pienza,A,Middle Bronze Age,2,-1700,-1300,400,0.01
5371,Costone di Pienza,A,Late Bronze Age,3,-1300,-1020,280,0.01
5371,Costone di Pienza,A,Early Iron Age,4,-1020,-1000,20,0.01
5372,Campi Rutiliani,A,Early Imperial Period,8,-30,100,130,0.5
5372,Campi Rutiliani,A,Mid-Imperial Period,9,100,300,200,0.5
5372,Campi Rutiliani,A,Late Imperial Period,10,300,500,200,0.5
5373,Pian delle Checche,A,Republican Period,7,-100,-30,70,0.5
5373,Pian delle Checche,A,Early Imperial Period,8,-30,100,130,0.5
5375,Colle Tolla,A,Early Bronze Age,1,-2300,-1700,600,0.01
5375,Colle Tolla,A,Middle Bronze Age,2,-1700,-1300,400,0.01
5375,Colle Tolla,A,Late Bronze Age,3,-1300,-1020,280,0.01
5375,Colle Tolla,A,Early Iron Age,4,-1020,-1000,20,0.01
5376,San Gregorio,A,Republican Period,7,-100,-30,70,0.5
5376,San Gregorio,A,Early Imperial Period,8,-30,100,130,0.5
5376,San Gregorio,B,Late Imperial Period,10,400,500,100,0.5
5378,Casa al Vento,A,Republican Period,7,-300,-30,270,0.5
5379,Casa al Vento,A,Early Imperial Period,8,-30,100,130,0.30000001
5379,Casa al Vento,A,Mid-Imperial Period,9,100,300,200,0.30000001
5379,Casa al Vento,A,Late Imperial Period,10,300,500,200,0.30000001
5380,Podere Casa Nuova,A,Republican Period,7,-100,-30,70,0.5
5380,Podere Casa Nuova,A,Early Imperial Period,8,-30,100,130,0.5
5380,Podere Casa Nuova,A,Mid-Imperial Period,9,100,300,200,0.5
5380,Podere Casa Nuova,A,Late Imperial Period,10,300,500,200,0.5
5381,Podere Torricelle,A,Republican Period,7,-100,-30,70,0.1
5381,Podere Torricelle,A,Early Imperial Period,8,-30,100,130,0.1
5382,Podere Lamone,A,Early Imperial Period,8,-30,100,130,0.1
5382,Podere Lamone,A,Mid-Imperial Period,9,100,300,200,0.1
5382,Podere Lamone,A,Late Imperial Period,10,300,500,200,0.1
5383,Podere Montello,A,Republican Period,7,-300,-30,270,0.5
5383,Podere Montello,A,Early Imperial Period,8,-30,100,130,0.5
5383,Podere Montello,A,Mid-Imperial Period,9,100,300,200,0.5
5383,Podere Montello,A,Late Imperial Period,10,300,500,200,0.5
5384,Podere Le Chiassaie,A,Republican Period,7,-100,-30,70,0.1
5384,Podere Le Chiassaie,A,Early Imperial Period,8,-30,100,130,0.1
5385,Podere Le Chiassaie,A,Republican Period,7,-100,-30,70,0.059999999
5385,Podere Le Chiassaie,A,Early Imperial Period,8,-30,100,130,0.059999999
5385,Podere Le Chiassaie,B,Late Imperial Period,10,350,500,150,0.059999999
5386,Podere Fonte Senese,A,Republican Period,7,-100,-30,70,0.029999999
5386,Podere Fonte Senese,A,Early Imperial Period,8,-30,100,130,0.029999999
5387,Agriturismo Barbi,A,Republican Period,7,-100,-30,70,0.01
5388,Agriturismo Barbi,A,Republican Period,7,-100,-30,70,0.01
5388,Agriturismo Barbi,A,Early Imperial Period,8,-30,100,130,0.01
5389,Podere Lamone,A,Late Iron Age,5,-700,-580,120,0.01
5389,Podere Lamone,A,Archaic Period,6,-580,-350,230,0.01
5389,Podere Lamone,A,Republican Period,7,-350,-300,50,0.01
5390,Podere Santa Maria,A,Republican Period,7,-200,-30,170,0.01
5390,Podere Santa Maria,A,Early Imperial Period,8,-30,100,130,0.01
5391,S. Maria dello Spino,A,Republican Period,7,-300,-30,270,0.01
5392,S. Maria dello Spino,A,Republican Period,7,-200,-100,100,0.30000001
5392,S. Maria dello Spino,B,Mid-Imperial Period,9,200,300,100,0.30000001
5392,S. Maria dello Spino,C,Late Imperial Period,10,400,500,100,0.30000001
5393,Podere Lucia,A,Republican Period,7,-200,-100,100,0.01
5393,Podere Lucia,B,Early Imperial Period,8,0,100,100,0.01
5394,Podere Lucia,A,Archaic Period,6,-400,-350,50,0.01
5394,Podere Lucia,A,Republican Period,7,-350,-50,300,0.01
5395,Podere Querci,A,Archaic Period,6,-400,-350,50,0.01
5395,Podere Querci,A,Republican Period,7,-350,-50,300,0.01
5396,Podere Piave,A,Archaic Period,6,-400,-350,50,0.01
5396,Podere Piave,A,Republican Period,7,-350,-50,300,0.01
5397,Podere Prugnole,A,Archaic Period,6,-400,-350,50,0.01
5397,Podere Prugnole,A,Republican Period,7,-350,-50,300,0.01
5398,Podere Mandorlo,A,Republican Period,7,-300,-200,100,0.30000001
5398,Podere Mandorlo,B,Early Imperial Period,8,0,100,100,0.30000001
5398,Podere Mandorlo,C,Late Imperial Period,10,300,500,200,0.30000001
5399,Podere Mandorlo,A,Late Iron Age,5,-600,-580,20,0.01
5399,Podere Mandorlo,A,Archaic Period,6,-580,-500,80,0.01
5399,Podere Mandorlo,B,Republican Period,7,-300,-30,270,0.01
5400,Podere La Bandita,A,Late Iron Age,5,-600,-580,20,0.02
5400,Podere La Bandita,A,Archaic Period,6,-580,-550,30,0.02
5401,Podere La Bandita,A,Late Iron Age,5,-600,-580,20,0.029999999
5401,Podere La Bandita,A,Archaic Period,6,-580,-500,80,0.029999999
5401,Podere La Bandita,B,Republican Period,7,-200,-100,100,0.029999999
5401,Podere La Bandita,C,Early Imperial Period,8,0,100,100,0.029999999
5401,Podere La Bandita,D,Late Imperial Period,10,300,500,200,0.029999999
5402,Podere Sorbelle,A,Republican Period,7,-100,-30,70,0.01
5402,Podere Sorbelle,A,Early Imperial Period,8,-30,100,130,0.01
5403,Podere Montertine,A,Republican Period,7,-100,-30,70,0.01
5403,Podere Montertine,A,Early Imperial Period,8,-30,100,130,0.01
5404,Podere Montertine,A,Archaic Period,6,-400,-350,50,0.01
5404,Podere Montertine,A,Republican Period,7,-350,-50,300,0.01
5405,Castelluccio,A,Republican Period,7,-100,-30,70,0.30000001
5405,Castelluccio,A,Early Imperial Period,8,-30,100,130,0.30000001
5405,Castelluccio,A,Late Imperial Period,10,300,500,200,0.30000001
5406,Podere Ragnuzzi,A,Republican Period,7,-100,-30,70,0.01
5406,Podere Ragnuzzi,A,Early Imperial Period,8,-30,100,130,0.01
5407,Podere Ragnuzzi,A,Late Iron Age,5,-600,-580,20,0.01
5407,Podere Ragnuzzi,B,Archaic Period,6,-580,-350,230,0.01
5407,Podere Ragnuzzi,B,Republican Period,7,-350,-50,300,0.01
5408,Podere Ragnuzzi,A,Republican Period,7,-300,-100,200,0.01
5409,Podere Fonte Bertusi di Sotto,A,Late Iron Age,5,-600,-580,20,0.050000001
5409,Podere Fonte Bertusi di Sotto,A,Archaic Period,6,-580,-500,80,0.050000001
5410,Podere Fonte Bertusi di Sotto,A,Late Iron Age,5,-600,-580,20,0.02
5410,Podere Fonte Bertusi di Sotto,A,Archaic Period,6,-580,-500,80,0.02
5411,Podere Bonellino,A,Late Imperial Period,10,300,500,200,0.02
5411,Podere Bonellino,A,Late Antique Period,11,500,600,100,0.02
5412,Palazzo Massaini,A,Late Iron Age,5,-600,-580,20,0.2
5412,Palazzo Massaini,A,Archaic Period,6,-580,-500,80,0.2
5412,Palazzo Massaini,B,Republican Period,7,-300,-30,270,0.2
5412,Palazzo Massaini,B,Early Imperial Period,8,-30,100,130,0.2
5413,Palazzo Massaini,A,Republican Period,7,-100,-30,70,0.01
5413,Palazzo Massaini,A,Early Imperial Period,8,-30,100,130,0.01
5414,Podere Cipressino,A,Late Iron Age,5,-600,-580,20,0.01
5414,Podere Cipressino,A,Archaic Period,6,-580,-500,80,0.01
5415,Podere Macchione,A,Republican Period,7,-100,-30,70,0.02
5415,Podere Macchione,A,Early Imperial Period,8,-30,100,130,0.02
5416,Podere Macchione,A,Archaic Period,6,-400,-350,50,0.01
5416,Podere Macchione,A,Republican Period,7,-350,-50,300,0.01
5417,Pian del Re,A,Republican Period,7,-200,-100,100,0.02
5417,Pian del Re,B,Early Imperial Period,8,0,100,100,0.02
5418,Podere San Piero in Campo,A,Republican Period,7,-300,-100,200,0.02
5419,Podere Peschiera,A,Late Imperial Period,10,300,500,200,0.02
5420,Podere Telle,A,Late Iron Age,5,-600,-580,20,0.02
5420,Podere Telle,A,Archaic Period,6,-580,-500,80,0.02
5420,Podere Telle,B,Republican Period,7,-350,-250,100,0.02
5421,Podere Telle,A,Late Iron Age,5,-600,-580,20,0.02
5421,Podere Telle,A,Archaic Period,6,-580,-500,80,0.02
5421,Podere Telle,B,Republican Period,7,-300,-100,200,0.02
5422,Podere San Giorgio,A,Republican Period,7,-100,-30,70,0.059999999
5422,Podere San Giorgio,A,Early Imperial Period,8,-30,100,130,0.059999999
5423,Podere San Giorgio,A,Early Imperial Period,8,0,100,100,0.02
5423,Podere San Giorgio,A,Mid-Imperial Period,9,100,300,200,0.02
5423,Podere San Giorgio,A,Late Imperial Period,10,300,400,100,0.02
5424,Podere Fraternita,A,Republican Period,7,-300,-30,270,0.1
5424,Podere Fraternita,A,Early Imperial Period,8,-30,100,130,0.1
5425,Podere Fonte all'Oppio,A,Republican Period,7,-100,-30,70,0.1
5425,Podere Fonte all'Oppio,A,Early Imperial Period,8,-30,100,130,0.1
5426,Podere Fonte all'Oppio,A,Late Iron Age,5,-600,-580,20,0.01
5426,Podere Fonte all'Oppio,B,Archaic Period,6,-580,-350,230,0.01
5426,Podere Fonte all'Oppio,B,Republican Period,7,-350,-50,300,0.01
5427,Poggio Villanova,A,Republican Period,7,-300,-30,270,0.02
5428,Poggio Villanova,A,Republican Period,7,-300,-200,100,0.1
5429,Poggio Villanova,A,Republican Period,7,-100,-30,70,0.01
5429,Poggio Villanova,A,Early Imperial Period,8,-30,100,130,0.01
5429,Poggio Villanova,B,Late Imperial Period,10,350,500,150,0.01
5429,Poggio Villanova,B,Late Antique Period,11,500,600,100,0.01
5430,Poggio Villanova,A,Republican Period,7,-300,-100,200,0.01
5431,Poggio Villanova,A,Republican Period,7,-200,-100,100,0.1
5432,Poggio Villanova,A,Late Bronze Age,3,-1200,-1020,180,0.02
5432,Poggio Villanova,A,Early Iron Age,4,-1020,-1000,20,0.02
5432,Poggio Villanova,B,Late Iron Age,5,-600,-580,20,0.02
5432,Poggio Villanova,B,Archaic Period,6,-580,-500,80,0.02
5433,Podere Scuola,A,Republican Period,7,-200,-30,170,0.01
5434,Podere in Campo,A,Late Iron Age,5,-600,-580,20,0.059999999
5434,Podere in Campo,A,Archaic Period,6,-580,-500,80,0.059999999
5434,Podere in Campo,B,Republican Period,7,-200,-100,100,0.059999999
5434,Podere in Campo,C,Mid-Imperial Period,9,100,200,100,0.059999999
5435,Podere in Campo,A,Late Imperial Period,10,300,500,200,0.029999999
5436,Podere Mandorlo,A,Archaic Period,6,-400,-350,50,0.01
5436,Podere Mandorlo,A,Republican Period,7,-350,-30,320,0.01
5437,Podere Poderuccio,A,Republican Period,7,-300,-100,200,0.01
5438,Podere Poderuccio,A,Late Iron Age,5,-600,-580,20,0.059999999
5438,Podere Poderuccio,A,Archaic Period,6,-580,-500,80,0.059999999
5439,Podere Tribbioli,A,Republican Period,7,-300,-30,270,0.050000001
5440,Podere Tribbioli,A,Archaic Period,6,-400,-350,50,0.029999999
5440,Podere Tribbioli,A,Republican Period,7,-350,-50,300,0.029999999
5441,Podere Tribbioli,A,Mid-Imperial Period,9,200,300,100,0.029999999
5442,Podere Casella,A,Late Iron Age,5,-600,-580,20,0.1
5442,Podere Casella,A,Archaic Period,6,-580,-500,80,0.1
5442,Podere Casella,B,Republican Period,7,-300,-100,200,0.1
5443,Podere Casella,A,Archaic Period,6,-400,-350,50,0.039999999
5443,Podere Casella,A,Republican Period,7,-350,-50,300,0.039999999
5444,Podere S. Antonio,A,Republican Period,7,-100,-30,70,0.039999999
5444,Podere S. Antonio,A,Early Imperial Period,8,-30,100,130,0.039999999
5444,Podere S. Antonio,B,Late Imperial Period,10,400,500,100,0.039999999
5446,Podere S. Antonio,A,Republican Period,7,-300,-30,270,0.5
5446,Podere S. Antonio,A,Early Imperial Period,8,-30,100,130,0.5
5446,Podere S. Antonio,B,Late Imperial Period,10,400,500,100,0.5
5447,Podere Fonte al Gozzo,A,Mid-Imperial Period,9,200,300,100,0.01
5448,Podere Fonte al Gozzo,A,Republican Period,7,-100,-30,70,0.01
5448,Podere Fonte al Gozzo,A,Early Imperial Period,8,-30,100,130,0.01
5450,Podere Fornace,A,Republican Period,7,-200,-100,100,0.079999998
5450,Podere Fornace,B,Early Imperial Period,8,0,100,100,0.079999998
5450,Podere Fornace,C,Late Imperial Period,10,400,500,100,0.079999998
5451,Podere Casa al Savio,A,Republican Period,7,-100,-30,70,0.01
5451,Podere Casa al Savio,A,Early Imperial Period,8,-30,100,130,0.01
5452,Podere Pian di Pigliardo,A,Republican Period,7,-300,-100,200,0.01
5453,Giuncheto,A,Archaic Period,6,-400,-350,50,0.01
5453,Giuncheto,A,Republican Period,7,-350,-300,50,0.01
5454,Il Palazzone,A,Republican Period,7,-100,-30,70,0.40000001
5454,Il Palazzone,A,Early Imperial Period,8,-30,100,130,0.40000001
5455,Podere Casato,A,Late Imperial Period,10,300,500,200,0.02
5455,Podere Casato,A,Late Antique Period,11,500,600,100,0.02
5456,Podere Sant'Antonio,A,Republican Period,7,-100,-30,70,0.01
5456,Podere Sant'Antonio,B,Late Imperial Period,10,300,400,100,0.01
5457,Podere Sant'Antonio,A,Late Iron Age,5,-600,-580,20,0.01
5457,Podere Sant'Antonio,A,Archaic Period,6,-580,-500,80,0.01
5457,Podere Sant'Antonio,B,Republican Period,7,-100,-30,70,0.01
5457,Podere Sant'Antonio,C,Mid-Imperial Period,9,100,200,100,0.01
5458,Il Palazzone,A,Late Imperial Period,10,300,500,200,0.01
5459,Podere Casato,A,Late Iron Age,5,-600,-580,20,0.029999999
5459,Podere Casato,A,Archaic Period,6,-580,-500,80,0.029999999
5460,Podere Casato,A,Late Iron Age,5,-600,-580,20,0.029999999
5460,Podere Casato,A,Archaic Period,6,-580,-500,80,0.029999999
5461,Podere Casato,A,Republican Period,7,-300,-100,200,0.059999999
5462,Podere Camprena,A,Republican Period,7,-100,-30,70,0.30000001
5462,Podere Camprena,A,Early Imperial Period,8,-30,100,130,0.30000001
5462,Podere Camprena,B,Late Imperial Period,10,300,500,200,0.30000001
5462,Podere Camprena,B,Late Antique Period,11,500,600,100,0.30000001
5463,Il Mosca,A,Republican Period,7,-300,-30,270,0.30000001
5463,Il Mosca,A,Early Imperial Period,8,-30,100,130,0.30000001
5463,Il Mosca,A,Mid-Imperial Period,9,100,300,200,0.30000001
5463,Il Mosca,A,Late Imperial Period,10,300,500,200,0.30000001
5464,Podere Mandorlo,A,Republican Period,7,-100,-30,70,0.40000001
5464,Podere Mandorlo,A,Early Imperial Period,8,-30,100,130,0.40000001
5464,Podere Mandorlo,B,Late Imperial Period,10,300,500,200,0.40000001
5465,Podere Mandorlo,A,Republican Period,7,-100,-30,70,0.2
5465,Podere Mandorlo,A,Early Imperial Period,8,-30,100,130,0.2
5466,Podere la Pieve,A,Archaic Period,6,-400,-350,50,0.02
5466,Podere la Pieve,A,Republican Period,7,-350,-50,300,0.02
5467,Porciano,A,Republican Period,7,-100,-30,70,0.69999999
5467,Porciano,A,Early Imperial Period,8,-30,100,130,0.69999999
5467,Porciano,B,Late Imperial Period,10,400,500,100,0.69999999
5468,Podere Arpicella,A,Archaic Period,6,-400,-350,50,0.02
5468,Podere Arpicella,A,Republican Period,7,-350,-50,300,0.02
5469,Podere Arpicella,A,Archaic Period,6,-400,-350,50,0.02
5469,Podere Arpicella,A,Republican Period,7,-350,-50,300,0.02
5470,Podere Arpicella,A,Archaic Period,6,-400,-350,50,0.02
5470,Podere Arpicella,A,Republican Period,7,-350,-50,300,0.02
5471,Cosona,A,Late Imperial Period,10,400,500,100,0.01
5472,Cosona,A,Late Imperial Period,10,400,500,100,0.01
5473,Cosona,A,Republican Period,7,-100,-30,70,0.01
5473,Cosona,A,Early Imperial Period,8,-30,100,130,0.01
5474,Cosona,A,Republican Period,7,-100,-30,70,0.01
5474,Cosona,A,Early Imperial Period,8,-30,100,130,0.01
5475,Cosona,A,Republican Period,7,-100,-30,70,0.01
5475,Cosona,A,Early Imperial Period,8,-30,100,130,0.01
5476,Cosona,A,Republican Period,7,-100,-30,70,0.01
5476,Cosona,A,Early Imperial Period,8,-30,100,130,0.01
5477,Cosona,A,Republican Period,7,-100,-30,70,0.01
5477,Cosona,A,Early Imperial Period,8,-30,100,130,0.01
5478,Cosona,A,Republican Period,7,-100,-30,70,0.2
5478,Cosona,A,Early Imperial Period,8,-30,100,130,0.2
5479,Cosona,A,Republican Period,7,-100,-30,70,0.1
5479,Cosona,A,Early Imperial Period,8,-30,100,130,0.1
5480,Podere La Guardia,A,Republican Period,7,-100,-30,70,0.01
5480,Podere La Guardia,A,Early Imperial Period,8,-30,100,130,0.01
5481,Podere La Guardia,A,Republican Period,7,-200,-100,100,0.050000001
5482,Podere La Guardia,A,Republican Period,7,-200,-100,100,0.01
5483,Podere La Guardia,A,Republican Period,7,-200,-100,100,0.01
5484,Podere Olmino,A,Republican Period,7,-100,-30,70,0.029999999
5484,Podere Olmino,A,Early Imperial Period,8,-30,100,130,0.029999999
5485,Le Pianacce,A,Early Bronze Age,1,-2300,-1700,600,0.02
5485,Le Pianacce,A,Middle Bronze Age,2,-1700,-1300,400,0.02
5485,Le Pianacce,A,Late Bronze Age,3,-1300,-1020,280,0.02
5485,Le Pianacce,A,Early Iron Age,4,-1020,-1000,20,0.02
5486,I Cappuccini,A,Republican Period,7,-300,-30,270,0.039999999
5486,I Cappuccini,A,Early Imperial Period,8,-30,100,130,0.039999999
5486,I Cappuccini,A,Mid-Imperial Period,9,100,300,200,0.039999999
5486,I Cappuccini,A,Late Imperial Period,10,300,500,200,0.039999999
5487,La Posta,A,Republican Period,7,-300,-30,270,0.039999999
5487,La Posta,A,Early Imperial Period,8,-30,100,130,0.039999999
5487,La Posta,A,Mid-Imperial Period,9,100,300,200,0.039999999
5487,La Posta,A,Late Imperial Period,10,300,500,200,0.039999999
5488,Le Conie,A,Republican Period,7,-300,-30,270,0.039999999
5488,Le Conie,A,Early Imperial Period,8,-30,100,130,0.039999999
5488,Le Conie,A,Mid-Imperial Period,9,100,300,200,0.039999999
5488,Le Conie,A,Late Imperial Period,10,300,500,200,0.039999999
5489,Le Conie,A,Republican Period,7,-300,-30,270,0.029999999
5489,Le Conie,A,Early Imperial Period,8,-30,100,130,0.029999999
5489,Le Conie,A,Mid-Imperial Period,9,100,300,200,0.029999999
5489,Le Conie,A,Late Imperial Period,10,300,500,200,0.029999999
5490,Le Conie,A,Republican Period,7,-300,-30,270,0.039999999
5490,Le Conie,A,Early Imperial Period,8,-30,100,130,0.039999999
5490,Le Conie,A,Mid-Imperial Period,9,100,300,200,0.039999999
5490,Le Conie,A,Late Imperial Period,10,300,500,200,0.039999999
5491,Le Conie,A,Late Iron Age,5,-700,-580,120,0.039999999
5491,Le Conie,A,Archaic Period,6,-580,-500,80,0.039999999
5492,Le Conie,A,Republican Period,7,-300,-30,270,0.02
5492,Le Conie,A,Early Imperial Period,8,-30,100,130,0.02
5492,Le Conie,A,Mid-Imperial Period,9,100,300,200,0.02
5492,Le Conie,A,Late Imperial Period,10,300,500,200,0.02
5493,Le Conie,A,Republican Period,7,-300,-30,270,0.039999999
5493,Le Conie,A,Early Imperial Period,8,-30,100,130,0.039999999
5493,Le Conie,A,Mid-Imperial Period,9,100,300,200,0.039999999
5493,Le Conie,A,Late Imperial Period,10,300,500,200,0.039999999
5494,Le Conie,A,Republican Period,7,-300,-30,270,0.039999999
5494,Le Conie,A,Early Imperial Period,8,-30,100,130,0.039999999
5494,Le Conie,A,Mid-Imperial Period,9,100,300,200,0.039999999
5494,Le Conie,A,Late Imperial Period,10,300,500,200,0.039999999
5495,Le Conie,A,Republican Period,7,-300,-30,270,0.039999999
5496,Le Conie,A,Early Imperial Period,8,-30,100,130,0.5
5497,Podere Paiccia,A,Republican Period,7,-300,-30,270,0.029999999
5497,Podere Paiccia,A,Early Imperial Period,8,-30,100,130,0.029999999
5497,Podere Paiccia,A,Mid-Imperial Period,9,100,300,200,0.029999999
5497,Podere Paiccia,A,Late Imperial Period,10,300,500,200,0.029999999
5498,Podere Paiccia,A,Early Imperial Period,8,-30,100,130,0.039999999
5499,Le Bandite,A,Republican Period,7,-300,-30,270,0.2
5500,La Bisarca,A,Early Imperial Period,8,-30,100,130,0.5
5501,La Bisarca,A,Late Iron Age,5,-700,-580,120,0.1
5501,La Bisarca,A,Archaic Period,6,-580,-500,80,0.1
5501,La Bisarca,B,Republican Period,7,-300,-30,270,0.1
5501,La Bisarca,C,Late Imperial Period,10,300,500,200,0.1
5502,Castellare,A,Republican Period,7,-300,-30,270,0.02
5502,Castellare,A,Early Imperial Period,8,-30,100,130,0.02
5502,Castellare,A,Mid-Imperial Period,9,100,300,200,0.02
5502,Castellare,A,Late Imperial Period,10,300,500,200,0.02
5503,Castellare,A,Republican Period,7,-300,-30,270,0.1
5504,Castellare,A,Republican Period,7,-300,-30,270,0.039999999
5504,Castellare,A,Early Imperial Period,8,-30,100,130,0.039999999
5504,Castellare,A,Mid-Imperial Period,9,100,300,200,0.039999999
5504,Castellare,A,Late Imperial Period,10,300,500,200,0.039999999
5505,Podere Favorito,A,Republican Period,7,-300,-30,270,0.059999999
5506,Podere la Pioggia,A,Republican Period,7,-300,-30,270,0.079999998
5506,Podere la Pioggia,A,Early Imperial Period,8,-30,100,130,0.079999998
5506,Podere la Pioggia,A,Mid-Imperial Period,9,100,300,200,0.079999998
5506,Podere la Pioggia,A,Late Imperial Period,10,300,500,200,0.079999998
5507,Podere Sant'Antonio,A,Republican Period,7,-300,-30,270,0.02
5508,Podere Poderuccio,A,Republican Period,7,-300,-30,270,0.02
5508,Podere Poderuccio,A,Early Imperial Period,8,-30,100,130,0.02
5508,Podere Poderuccio,A,Mid-Imperial Period,9,100,300,200,0.02
5508,Podere Poderuccio,A,Late Imperial Period,10,300,500,200,0.02
5509,Podere Pianaccio,A,Republican Period,7,-300,-30,270,0.039999999
5510,Poggio Bandinelli,A,Republican Period,7,-300,-30,270,0.029999999
5510,Poggio Bandinelli,A,Early Imperial Period,8,-30,100,130,0.029999999
5510,Poggio Bandinelli,A,Mid-Imperial Period,9,100,300,200,0.029999999
5510,Poggio Bandinelli,A,Late Imperial Period,10,300,500,200,0.029999999
5511,La Bisarca,A,Republican Period,7,-100,-30,70,0.5
5511,La Bisarca,A,Early Imperial Period,8,-30,100,130,0.5
5512,La Sterposa,A,Middle Bronze Age,2,-1700,-1300,400,0.050000001
5512,La Sterposa,B,Republican Period,7,-100,-30,70,0.050000001
5512,La Sterposa,B,Early Imperial Period,8,-30,100,130,0.050000001
5512,La Sterposa,C,Late Imperial Period,10,300,500,200,0.050000001
5513,La Sterposa,A,Republican Period,7,-300,-30,270,0.2
5514,Podere Poggiolo,A,Middle Bronze Age,2,-1700,-1300,400,0.60000002
5514,Podere Poggiolo,B,Republican Period,7,-100,-30,70,0.60000002
5514,Podere Poggiolo,B,Early Imperial Period,8,-30,100,130,0.60000002
5514,Podere Poggiolo,C,Late Imperial Period,10,300,500,200,0.60000002
5515,Poggio Grillo,A,Republican Period,7,-300,-30,270,0.02
5515,Poggio Grillo,A,Early Imperial Period,8,-30,100,130,0.02
5515,Poggio Grillo,A,Mid-Imperial Period,9,100,300,200,0.02
5515,Poggio Grillo,A,Late Imperial Period,10,300,500,200,0.02
5516,Podere Capannelle,A,Republican Period,7,-300,-30,270,0.059999999
5516,Podere Capannelle,A,Early Imperial Period,8,-30,100,130,0.059999999
5516,Podere Capannelle,A,Mid-Imperial Period,9,100,300,200,0.059999999
5516,Podere Capannelle,A,Late Imperial Period,10,300,500,200,0.059999999
5517,Podere Capannelle,A,Republican Period,7,-200,-30,170,0.30000001
5517,Podere Capannelle,A,Early Imperial Period,8,-30,100,130,0.30000001
5517,Podere Capannelle,A,Mid-Imperial Period,9,100,300,200,0.30000001
5517,Podere Capannelle,A,Late Imperial Period,10,300,500,200,0.30000001
5518,Poggio Grillo,A,Republican Period,7,-300,-30,270,0.079999998
5519,Podere Sant'Antonio,A,Republican Period,7,-300,-30,270,0.079999998
5519,Podere Sant'Antonio,A,Early Imperial Period,8,-30,100,130,0.079999998
5519,Podere Sant'Antonio,A,Mid-Imperial Period,9,100,300,200,0.079999998
5519,Podere Sant'Antonio,A,Late Imperial Period,10,300,500,200,0.079999998
5520,Poggio Villanova,A,Republican Period,7,-300,-30,270,0.079999998
5520,Poggio Villanova,A,Early Imperial Period,8,-30,100,130,0.079999998
5520,Poggio Villanova,A,Mid-Imperial Period,9,100,300,200,0.079999998
5520,Poggio Villanova,A,Late Imperial Period,10,300,500,200,0.079999998
5521,Poggio Villanova,A,Republican Period,7,-300,-30,270,0.090000004
5521,Poggio Villanova,A,Early Imperial Period,8,-30,100,130,0.090000004
5521,Poggio Villanova,A,Mid-Imperial Period,9,100,300,200,0.090000004
5521,Poggio Villanova,A,Late Imperial Period,10,300,500,200,0.090000004
5522,Poggio Gello,A,Late Iron Age,5,-700,-580,120,0.039999999
5522,Poggio Gello,A,Archaic Period,6,-580,-500,80,0.039999999
5522,Poggio Gello,B,Republican Period,7,-300,-30,270,0.039999999
5522,Poggio Gello,B,Early Imperial Period,8,-30,100,130,0.039999999
5522,Poggio Gello,B,Mid-Imperial Period,9,100,300,200,0.039999999
5522,Poggio Gello,B,Late Imperial Period,10,300,500,200,0.039999999
5523,Casa Tognetti,A,Republican Period,7,-300,-30,270,0.2
5523,Casa Tognetti,A,Early Imperial Period,8,-30,100,130,0.2
5523,Casa Tognetti,A,Mid-Imperial Period,9,100,300,200,0.2
5523,Casa Tognetti,A,Late Imperial Period,10,300,500,200,0.2
5524,Casa Tognetti,A,Republican Period,7,-300,-30,270,0.07
5524,Casa Tognetti,A,Early Imperial Period,8,-30,100,130,0.07
5524,Casa Tognetti,A,Mid-Imperial Period,9,100,300,200,0.07
5524,Casa Tognetti,A,Late Imperial Period,10,300,500,200,0.07
5525,Podere Scagnolino,A,Republican Period,7,-300,-30,270,0.050000001
5525,Podere Scagnolino,A,Early Imperial Period,8,-30,100,130,0.050000001
5525,Podere Scagnolino,A,Mid-Imperial Period,9,100,300,200,0.050000001
5525,Podere Scagnolino,A,Late Imperial Period,10,300,500,200,0.050000001
5526,I Morettoni,A,Late Bronze Age,3,-1300,-1020,280,0.029999999
5526,I Morettoni,A,Early Iron Age,4,-1020,-1000,20,0.029999999
5527,Podere Spagnolo,A,Republican Period,7,-300,-30,270,0.02
5528,Poderi Casella e Palazzetta,A,Republican Period,7,-100,-30,70,1
5528,Poderi Casella e Palazzetta,A,Early Imperial Period,8,-30,100,130,1
5529,Podere San Luigi,A,Republican Period,7,-100,-30,70,0.1
5530,Casa al Treggia,A,Republican Period,7,-300,-30,270,0.090000004
5530,Casa al Treggia,A,Early Imperial Period,8,-30,100,130,0.090000004
5530,Casa al Treggia,A,Mid-Imperial Period,9,100,300,200,0.090000004
5530,Casa al Treggia,A,Late Imperial Period,10,300,500,200,0.090000004
5531,Podere Selvella Fondi,A,Republican Period,7,-100,-30,70,0.029999999
5532,Piano Fondi,A,Republican Period,7,-300,-30,270,0.01
5533,Piano Fondi,A,Republican Period,7,-300,-30,270,0.01
5534,Piano Fondi,A,Republican Period,7,-300,-30,270,0.02
5535,La Palazzetta,A,Late Bronze Age,3,-1300,-1020,280,0.02
5535,La Palazzetta,A,Early Iron Age,4,-1020,-1000,20,0.02
5536,La Palazzetta,A,Republican Period,7,-300,-30,270,0.02
5536,La Palazzetta,A,Early Imperial Period,8,-30,100,130,0.02
5536,La Palazzetta,A,Mid-Imperial Period,9,100,300,200,0.02
5536,La Palazzetta,A,Late Imperial Period,10,300,500,200,0.02
5537,La Palazzetta,A,Republican Period,7,-300,-30,270,0.01
5537,La Palazzetta,A,Early Imperial Period,8,-30,100,130,0.01
5537,La Palazzetta,A,Mid-Imperial Period,9,100,300,200,0.01
5537,La Palazzetta,A,Late Imperial Period,10,300,500,200,0.01
5538,La Palazzetta,A,Republican Period,7,-300,-30,270,0.01
5538,La Palazzetta,A,Early Imperial Period,8,-30,100,130,0.01
5538,La Palazzetta,A,Mid-Imperial Period,9,100,300,200,0.01
5538,La Palazzetta,A,Late Imperial Period,10,300,500,200,0.01
5539,La Palazzetta,A,Republican Period,7,-300,-30,270,0.01
5539,La Palazzetta,A,Early Imperial Period,8,-30,100,130,0.01
5539,La Palazzetta,A,Mid-Imperial Period,9,100,300,200,0.01
5539,La Palazzetta,A,Late Imperial Period,10,300,500,200,0.01
5540,La Palazzetta,A,Republican Period,7,-300,-30,270,0.01
5540,La Palazzetta,A,Early Imperial Period,8,-30,100,130,0.01
5540,La Palazzetta,A,Mid-Imperial Period,9,100,300,200,0.01
5540,La Palazzetta,A,Late Imperial Period,10,300,500,200,0.01
5541,La Palazzetta,A,Republican Period,7,-300,-30,270,0.01
5541,La Palazzetta,A,Early Imperial Period,8,-30,100,130,0.01
5541,La Palazzetta,A,Mid-Imperial Period,9,100,300,200,0.01
5541,La Palazzetta,A,Late Imperial Period,10,300,500,200,0.01
5542,Molino della Vignaccia,A,Late Bronze Age,3,-1300,-1020,280,0.01
5542,Molino della Vignaccia,A,Early Iron Age,4,-1020,-1000,20,0.01
5543,Molino della Vignaccia,A,Late Bronze Age,3,-1300,-1020,280,0.01
5543,Molino della Vignaccia,A,Early Iron Age,4,-1020,-1000,20,0.01
5544,Molino della Vignaccia,A,Late Bronze Age,3,-1300,-1020,280,0.01
5544,Molino della Vignaccia,A,Early Iron Age,4,-1020,-1000,20,0.01
5545,Podere Palazzo Melano,A,Republican Period,7,-300,-30,270,0.01
5545,Podere Palazzo Melano,A,Early Imperial Period,8,-30,100,130,0.01
5545,Podere Palazzo Melano,A,Mid-Imperial Period,9,100,300,200,0.01
5545,Podere Palazzo Melano,A,Late Imperial Period,10,300,500,200,0.01
5546,Palazzuolo,A,Late Bronze Age,3,-1300,-1020,280,0.050000001
5546,Palazzuolo,A,Early Iron Age,4,-1020,-1000,20,0.050000001
5546,Palazzuolo,B,Late Iron Age,5,-700,-580,120,0.050000001
5546,Palazzuolo,B,Archaic Period,6,-580,-500,80,0.050000001
5546,Palazzuolo,C,Republican Period,7,-300,-30,270,0.050000001
5546,Palazzuolo,C,Early Imperial Period,8,-30,100,130,0.050000001
5546,Palazzuolo,C,Mid-Imperial Period,9,100,300,200,0.050000001
5546,Palazzuolo,C,Late Imperial Period,10,300,500,200,0.050000001
5547,Palazzuolo,A,Late Iron Age,5,-700,-580,120,0.02
5547,Palazzuolo,A,Archaic Period,6,-580,-500,80,0.02
5548,Palazzuolo,A,Republican Period,7,-100,-30,70,0.050000001
5548,Palazzuolo,A,Early Imperial Period,8,-30,100,130,0.050000001
5549,Palazzuolo,A,Early Imperial Period,8,-30,100,130,0.1
5549,Palazzuolo,B,Late Imperial Period,10,300,500,200,0.1
5550,Palazzuolo,A,Republican Period,7,-300,-30,270,0.01
5551,Casano,A,Late Iron Age,5,-700,-580,120,0.02
5551,Casano,A,Archaic Period,6,-580,-500,80,0.02
5552,Casano,A,Republican Period,7,-300,-30,270,0.02
5553,Casano,A,Republican Period,7,-300,-30,270,0.02
5554,Casano,A,Republican Period,7,-300,-30,270,0.02
5555,Casano,A,Republican Period,7,-100,-30,70,0.01
5555,Casano,A,Early Imperial Period,8,-30,100,130,0.01
5556,Casano,A,Republican Period,7,-300,-30,270,0.01
5557,Casano,A,Republican Period,7,-300,-30,270,0.02
5558,Casano,A,Republican Period,7,-300,-30,270,0.01
5559,Casano,A,Republican Period,7,-300,-30,270,0.02
5560,Casano,A,Republican Period,7,-300,-30,270,0.01
5560,Casano,A,Early Imperial Period,8,-30,100,130,0.01
5560,Casano,A,Mid-Imperial Period,9,100,300,200,0.01
5560,Casano,A,Late Imperial Period,10,300,500,200,0.01
5561,Casano,A,Republican Period,7,-300,-30,270,0.01
5561,Casano,A,Early Imperial Period,8,-30,100,130,0.01
5561,Casano,A,Mid-Imperial Period,9,100,300,200,0.01
5561,Casano,A,Late Imperial Period,10,300,500,200,0.01
5562,Poggio Piagge Rosse,A,Republican Period,7,-300,-30,270,0.02
5562,Poggio Piagge Rosse,A,Early Imperial Period,8,-30,100,130,0.02
5562,Poggio Piagge Rosse,A,Mid-Imperial Period,9,100,300,200,0.02
5562,Poggio Piagge Rosse,A,Late Imperial Period,10,300,500,200,0.02
5563,Podere Galichino,A,Late Iron Age,5,-700,-580,120,0.02
5563,Podere Galichino,A,Archaic Period,6,-580,-500,80,0.02
5564,Podere Galichino,A,Republican Period,7,-300,-30,270,0.02
5564,Podere Galichino,A,Early Imperial Period,8,-30,100,130,0.02
5564,Podere Galichino,A,Mid-Imperial Period,9,100,300,200,0.02
5564,Podere Galichino,A,Late Imperial Period,10,300,500,200,0.02
5565,Casetta dell'Arciprete,A,Republican Period,7,-300,-30,270,0.02
5565,Casetta dell'Arciprete,A,Early Imperial Period,8,-30,100,130,0.02
5565,Casetta dell'Arciprete,A,Mid-Imperial Period,9,100,300,200,0.02
5565,Casetta dell'Arciprete,A,Late Imperial Period,10,300,500,200,0.02
5566,Casetta dell'Arciprete,A,Republican Period,7,-300,-30,270,0.02
5567,Corniolino,A,Republican Period,7,-300,-30,270,0.02
5568,Corniolino,A,Mid-Imperial Period,9,100,300,200,0.050000001
5569,Podere Caselle,A,Republican Period,7,-300,-30,270,0.01
5570,Podere Caselle,A,Late Bronze Age,3,-1300,-1020,280,0.039999999
5570,Podere Caselle,A,Early Iron Age,4,-1020,-1000,20,0.039999999
5570,Podere Caselle,B,Late Iron Age,5,-700,-580,120,0.039999999
5570,Podere Caselle,B,Archaic Period,6,-580,-500,80,0.039999999
5571,Podere Caselle,A,Republican Period,7,-300,-30,270,0.01
5572,La Castellina 3,A,Republican Period,7,-100,-30,70,0.029999999
5572,La Castellina 3,A,Early Imperial Period,8,-30,100,130,0.029999999
5572,La Castellina 3,A,Mid-Imperial Period,9,100,300,200,0.029999999
5572,La Castellina 3,A,Late Imperial Period,10,300,500,200,0.029999999
5573,La Castellina 3,A,Republican Period,7,-100,-30,70,0.029999999
5574,Podere Caldaiolo,A,Early Imperial Period,8,-30,100,130,0.029999999
5575,Casa al Maestro,A,Early Imperial Period,8,-30,100,130,0.02
5576,Radicofani,A,Middle Bronze Age,2,-1700,-1300,400,0.1
5576,Radicofani,A,Late Bronze Age,3,-1300,-1020,280,0.1
5576,Radicofani,A,Early Iron Age,4,-1020,-1000,20,0.1
5577,Radicofani,A,Early Imperial Period,8,-30,100,130,0.01
5577,Radicofani,B,Late Imperial Period,10,300,500,200,0.01
5578,Gonzeto,A,Late Iron Age,5,-700,-580,120,0.050000001
5578,Gonzeto,A,Archaic Period,6,-580,-500,80,0.050000001
5578,Gonzeto,B,Republican Period,7,-300,-30,270,0.050000001
5579,Podere Scotto Morto,A,Republican Period,7,-300,-30,270,0.02
5579,Podere Scotto Morto,A,Early Imperial Period,8,-30,100,130,0.02
5579,Podere Scotto Morto,A,Mid-Imperial Period,9,100,300,200,0.02
5579,Podere Scotto Morto,A,Late Imperial Period,10,300,500,200,0.02
5580,Podere Scotto Morto,A,Late Iron Age,5,-700,-580,120,0.090000004
5580,Podere Scotto Morto,A,Archaic Period,6,-580,-500,80,0.090000004
5580,Podere Scotto Morto,B,Republican Period,7,-300,-30,270,0.090000004
5580,Podere Scotto Morto,B,Early Imperial Period,8,-30,100,130,0.090000004
5580,Podere Scotto Morto,B,Mid-Imperial Period,9,100,300,200,0.090000004
5580,Podere Scotto Morto,B,Late Imperial Period,10,300,500,200,0.090000004
5581,Podere Scotto Morto,A,Late Iron Age,5,-700,-580,120,0.039999999
5581,Podere Scotto Morto,A,Archaic Period,6,-580,-500,80,0.039999999
5581,Podere Scotto Morto,B,Early Imperial Period,8,-30,100,130,0.039999999
5582,Podere la Pioggia,A,Early Imperial Period,8,-30,100,130,0.079999998
5582,Podere la Pioggia,A,Mid-Imperial Period,9,100,300,200,0.079999998
5583,Podere Scagnolo,A,Republican Period,7,-300,-30,270,0.090000004
5584,La Befa,A,Early Imperial Period,8,0,100,100,0.2
5584,La Befa,A,Mid-Imperial Period,9,100,300,200,0.5
5584,La Befa,A,Late Imperial Period,10,300,500,200,1
5585,Le Carcerelle,A,Early Imperial Period,8,-30,100,130,0.029999999
5585,Le Carcerelle,A,Mid-Imperial Period,9,100,300,200,0.029999999
5585,Le Carcerelle,A,Late Imperial Period,10,300,500,200,0.029999999
5586,Le Carcerelle,A,Early Imperial Period,8,-30,100,130,0.01
5586,Le Carcerelle,A,Mid-Imperial Period,9,100,300,200,0.01
5586,Le Carcerelle,A,Late Imperial Period,10,300,500,200,0.01
5587,Le Carcerelle,A,Early Imperial Period,8,-30,100,130,0.01
5588,Le Carcerelle,A,Early Imperial Period,8,-30,100,130,0.01
5589,Le Carcerelle,A,Early Imperial Period,8,-30,100,130,0.01
5589,Le Carcerelle,A,Mid-Imperial Period,9,100,300,200,0.01
5589,Le Carcerelle,A,Late Imperial Period,10,300,500,200,0.01
5590,podere Giuncheto,A,Early Imperial Period,8,-30,100,130,0.01
5591,podere Giuncheto,A,Early Imperial Period,8,-30,100,130,0.01
5592,Poggio Perignano,A,Archaic Period,6,-500,-350,150,0.02
5592,Poggio Perignano,A,Republican Period,7,-350,-300,50,0.02
5593,Poggio Perignano,A,Republican Period,7,-300,-100,200,0.01
5594,Poggio Perignano,A,Republican Period,7,-300,-200,100,0.01
5595,Poggio Perignano,A,Republican Period,7,-300,-30,270,0.01
5596,Poggio Perignano,A,Republican Period,7,-300,-30,270,0.01
5597,Poggio Perignano,A,Republican Period,7,-200,-50,150,0.01
5598,Poggio Perignano,A,Republican Period,7,-150,-50,100,0.01
5599,Poggio Perignano,A,Republican Period,7,-200,-100,100,0.1
5600,Poggio Perignano,A,Republican Period,7,-100,-30,70,0.1
5601,Poggio Perignano,A,Late Bronze Age,3,-1300,-1020,280,0.01
5601,Poggio Perignano,A,Early Iron Age,4,-1020,-800,220,0.01
5602,Poggio Perignano,A,Middle Bronze Age,2,-1700,-1300,400,0.01
5602,Poggio Perignano,A,Late Bronze Age,3,-1300,-1020,280,0.01
5602,Poggio Perignano,A,Early Iron Age,4,-1020,-1000,20,0.01
5603,Poggio Perignano,A,Republican Period,7,-300,-100,200,0.01
5604,Podere Castelrotto,A,Republican Period,7,-150,-100,50,0.01
5605,Podere Beccatiquello,A,Late Iron Age,5,-600,-580,20,0.01
5605,Podere Beccatiquello,A,Archaic Period,6,-580,-500,80,0.01
5606,Podere Beccatiquello,A,Late Iron Age,5,-600,-580,20,0.01
5606,Podere Beccatiquello,A,Archaic Period,6,-580,-500,80,0.01
5607,Podere Beccatiquello,A,Early Imperial Period,8,0,100,100,0.01
5608,Podere Casa Nuova,A,Early Imperial Period,8,0,100,100,0.029999999
5608,Podere Casa Nuova,A,Mid-Imperial Period,9,100,200,100,0.029999999
5609,Podere Casalone,A,Early Imperial Period,8,0,100,100,0.5
5609,Podere Casalone,A,Mid-Imperial Period,9,100,300,200,0.5
5609,Podere Casalone,A,Late Imperial Period,10,300,500,200,0.5
5609,Podere Casalone,A,Late Antique Period,11,500,600,100,0.5
5610,Podere Casalone,A,Late Iron Age,5,-650,-580,70,0.30000001
5610,Podere Casalone,A,Archaic Period,6,-580,-500,80,0.30000001
5611,Podere Casalone,A,Early Imperial Period,8,0,100,100,0.02
5611,Podere Casalone,A,Mid-Imperial Period,9,100,200,100,0.02
5612,podere Quaglia,A,Early Imperial Period,8,0,100,100,0.01
5613,podere Quaglia,A,Early Imperial Period,8,-30,100,130,0.050000001
5614,Segalari,A,Republican Period,7,-300,-30,270,0.01
5615,Segalari,A,Early Imperial Period,8,0,100,100,0.029999999
5615,Segalari,A,Mid-Imperial Period,9,100,200,100,0.029999999
5616,Segalari,A,Early Imperial Period,8,0,100,100,0.01
5617,Fonte al Santo,A,Early Imperial Period,8,0,100,100,0.30000001
5617,Fonte al Santo,A,Mid-Imperial Period,9,100,200,100,0.30000001
5617,Fonte al Santo,B,Late Imperial Period,10,300,500,200,0.30000001
5617,Fonte al Santo,B,Late Antique Period,11,500,550,50,0.30000001
5618,Fonte al Santo,A,Late Iron Age,5,-600,-580,20,0.02
5618,Fonte al Santo,A,Archaic Period,6,-580,-500,80,0.02
5619,Galardino,A,Republican Period,7,-200,-100,100,0.039999999
5620,podere Querce,A,Republican Period,7,-100,-30,70,0.2
5621,podere Querce,A,Late Imperial Period,10,300,500,200,0.01
5622,podere Querce,A,Republican Period,7,-100,-30,70,0.079999998
5623,podere la Fornace,A,Late Iron Age,5,-600,-580,20,0.01
5623,podere la Fornace,A,Archaic Period,6,-580,-500,80,0.01
5624,podere la Fornace,A,Late Iron Age,5,-650,-580,70,0.029999999
5624,podere la Fornace,A,Archaic Period,6,-580,-500,80,0.029999999
5625,podere la Fornace,A,Late Iron Age,5,-600,-580,20,0.02
5625,podere la Fornace,A,Archaic Period,6,-580,-500,80,0.02
5626,podere la Fornace,A,Late Iron Age,5,-600,-580,20,0.01
5626,podere la Fornace,A,Archaic Period,6,-580,-500,80,0.01
5627,podere la Fornace,A,Republican Period,7,-200,-30,170,0.059999999
5628,podere la Fornace,A,Republican Period,7,-300,-30,270,0.01
5629,podere la Fornace,A,Late Iron Age,5,-700,-580,120,0.01
5629,podere la Fornace,A,Archaic Period,6,-580,-350,230,0.01
5629,podere la Fornace,A,Republican Period,7,-350,-300,50,0.01
5630,podere la Fornace,A,Late Iron Age,5,-600,-580,20,0.01
5630,podere la Fornace,A,Archaic Period,6,-580,-500,80,0.01
5631,Castelnuovo Tancredi,A,Republican Period,7,-300,-30,270,0.01
5632,Castelnuovo Tancredi,A,Archaic Period,6,-500,-350,150,0.01
5632,Castelnuovo Tancredi,A,Republican Period,7,-350,-300,50,0.01
5633,Podere S. Luigi,A,Late Iron Age,5,-600,-580,20,0.01
5633,Podere S. Luigi,A,Archaic Period,6,-580,-500,80,0.01
5633,Podere S. Luigi,B,Republican Period,7,-300,-30,270,0.01
5634,Podere S. Luigi,A,Republican Period,7,-200,-30,170,0.1
5635,Podere S. Luigi,A,Republican Period,7,-100,-30,70,0.1
5635,Podere S. Luigi,A,Early Imperial Period,8,-30,100,130,0.1
5636,Podere S. Luigi,A,Republican Period,7,-300,-30,270,0.050000001
5637,Podere S. Luigi,A,Republican Period,7,-200,-50,150,0.01
5638,le Dogane,A,Late Iron Age,5,-600,-580,20,0.01
5638,le Dogane,A,Archaic Period,6,-580,-500,80,0.01
5639,le Dogane,A,Late Iron Age,5,-600,-580,20,0.029999999
5639,le Dogane,A,Archaic Period,6,-580,-500,80,0.029999999
5640,le Dogane,A,Republican Period,7,-300,-30,270,0.079999998
5641,Santa Marcella,A,Republican Period,7,-300,-100,200,0.2
5642,Poderi S. Luigi-Querciola,A,Republican Period,7,-300,-30,270,0.1
5643,Poderi S. Luigi-Querciola,A,Republican Period,7,-300,-30,270,0.5
5644,Querciola,A,Republican Period,7,-150,-50,100,0.029999999
5645,Querciola,A,Republican Period,7,-200,-30,170,0.029999999
5646,Querciola,A,Republican Period,7,-250,-100,150,0.02
5647,Querciola,A,Republican Period,7,-200,-30,170,0.059999999
5648,Querciola,A,Early Imperial Period,8,0,50,50,0.02
5649,podere Querciola,A,Early Imperial Period,8,-30,100,130,0.02
5650,podere Querciola,A,Republican Period,7,-300,-30,270,0.02
5651,podere Querciola,A,Republican Period,7,-200,-100,100,0.01
5652,Pieve di Piana,A,Late Iron Age,5,-600,-580,20,0.01
5652,Pieve di Piana,A,Archaic Period,6,-580,-500,80,0.01
5653,Podere San Giuseppe,A,Republican Period,7,-300,-100,200,0.1
5654,Podere San Giuseppe,A,Late Iron Age,5,-600,-580,20,0.02
5654,Podere San Giuseppe,A,Archaic Period,6,-580,-500,80,0.02
5655,Podere San Giuseppe,A,Republican Period,7,-300,-100,200,0.2
5656,Pieve di Piana,A,Early Imperial Period,8,-30,100,130,0.1
5656,Pieve di Piana,A,Mid-Imperial Period,9,100,300,200,0.1
5656,Pieve di Piana,A,Late Imperial Period,10,300,400,100,0.1
5657,Ripolone,A,Republican Period,7,-300,-100,200,0.30000001
5658,Ripolone,A,Republican Period,7,-200,-50,150,0.029999999
5659,Ripolone,A,Early Imperial Period,8,-30,100,130,0.01
5660,Ripoli,A,Republican Period,7,-100,-30,70,0.029999999
5660,Ripoli,A,Early Imperial Period,8,-30,100,130,0.029999999
5661,Terrinciano,A,Republican Period,7,-250,-150,100,0.01
5662,Terrinciano,A,Early Imperial Period,8,50,100,50,0.01
5662,Terrinciano,A,Mid-Imperial Period,9,100,150,50,0.01
5663,Quarantalla,A,Republican Period,7,-150,-30,120,0.01
5663,Quarantalla,A,Early Imperial Period,8,-30,100,130,0.01
5663,Quarantalla,A,Mid-Imperial Period,9,100,200,100,0.01
5664,podere Quarantalla,A,Republican Period,7,-300,-100,200,0.01
5665,podere Quarantalla,A,Republican Period,7,-200,-30,170,0.02
5665,podere Quarantalla,A,Early Imperial Period,8,-30,100,130,0.02
5666,Il Palazzetto,A,Republican Period,7,-200,-50,150,0.01
5667,Il Palazzetto,A,Republican Period,7,-100,-30,70,0.01
5668,Il Palazzetto,A,Early Imperial Period,8,-30,100,130,0.01
5669,Il Palazzetto,A,Early Imperial Period,8,-30,100,130,0.02
5670,podere Pieberti,A,Early Imperial Period,8,-30,100,130,0.02
5671,podere Pieberti,A,Middle Bronze Age,2,-1700,-1300,400,0.02
5671,podere Pieberti,A,Late Bronze Age,3,-1300,-1020,280,0.02
5671,podere Pieberti,A,Early Iron Age,4,-1020,-1000,20,0.02
5672,podere Pieberti,A,Middle Bronze Age,2,-1700,-1300,400,0.02
5672,podere Pieberti,A,Late Bronze Age,3,-1300,-1020,280,0.02
5672,podere Pieberti,A,Early Iron Age,4,-1020,-1000,20,0.02
5673,podere Pieberti,A,Republican Period,7,-100,-30,70,0.01
5673,podere Pieberti,A,Early Imperial Period,8,-30,100,130,0.01
5674,Poggettone,A,Early Imperial Period,8,0,100,100,0.02
5674,Poggettone,A,Mid-Imperial Period,9,100,200,100,0.02
5675,Poggettone,A,Early Imperial Period,8,0,100,100,0.02
5676,Pian di Rotella,A,Early Imperial Period,8,-30,100,130,0.01
5677,Pian di Rotella,A,Late Iron Age,5,-600,-580,20,0.01
5677,Pian di Rotella,A,Archaic Period,6,-580,-500,80,0.01
5678,Podere Cerretani,A,Republican Period,7,-100,-30,70,0.01
5679,il Poggino,A,Republican Period,7,-300,-100,200,0.02
5680,Torre di Bibbiano,A,Late Iron Age,5,-650,-580,70,0.01
5680,Torre di Bibbiano,A,Archaic Period,6,-580,-500,80,0.01
5680,Torre di Bibbiano,B,Republican Period,7,-300,-100,200,0.01
5681,Torre di Bibbiano,A,Early Imperial Period,8,0,100,100,0.02
5682,Finocchietto,A,Republican Period,7,-300,-30,270,0.01
5683,podere Rodegatti,A,Republican Period,7,-300,-150,150,0.01
5684,podere Immacolata,A,Early Imperial Period,8,-30,100,130,0.02
5684,podere Immacolata,A,Mid-Imperial Period,9,100,200,100,0.02
5685,podere Guado,A,Late Iron Age,5,-650,-580,70,0.01
5685,podere Guado,A,Archaic Period,6,-580,-500,80,0.01
5686,S. Cristina in Caio,A,Early Imperial Period,8,-30,100,130,0.5
5686,S. Cristina in Caio,A,Mid-Imperial Period,9,100,300,200,0.5
5686,S. Cristina in Caio,A,Late Imperial Period,10,300,400,100,0.5
5687,S. Cristina,A,Early Imperial Period,8,0,100,100,0.01
5687,S. Cristina,A,Mid-Imperial Period,9,100,200,100,0.01
5688,S. Cristina,A,Early Imperial Period,8,0,100,100,0.079999998
5689,podere Ponzecco,A,Republican Period,7,-100,-30,70,0.079999998
5689,podere Ponzecco,A,Early Imperial Period,8,-30,100,130,0.079999998
5690,podere Ponzecco,A,Early Imperial Period,8,0,100,100,0.039999999
5690,podere Ponzecco,A,Mid-Imperial Period,9,100,300,200,0.039999999
5691,casello di Campolandi,A,Middle Bronze Age,2,-1700,-1300,400,0.01
5691,casello di Campolandi,A,Late Bronze Age,3,-1300,-1020,280,0.01
5691,casello di Campolandi,A,Early Iron Age,4,-1020,-1000,20,0.01
5692,casello di Campolandi,A,Late Bronze Age,3,-1300,-1020,280,0.01
5692,casello di Campolandi,A,Early Iron Age,4,-1020,-800,220,0.01
5693,podere Ponzecco,A,Republican Period,7,-300,-100,200,0.029999999
5694,Poggio Mazzi,A,Early Imperial Period,8,0,100,100,0.02
5694,Poggio Mazzi,A,Mid-Imperial Period,9,100,200,100,0.02
5695,poderi Palazzone-Fornace,A,Late Iron Age,5,-600,-580,20,0.01
5695,poderi Palazzone-Fornace,A,Archaic Period,6,-580,-500,80,0.01
5696,poderi Palazzone-Fornace,A,Late Iron Age,5,-600,-580,20,0.01
5696,poderi Palazzone-Fornace,A,Archaic Period,6,-580,-500,80,0.01
5697,poderi Palazzone-Fornace,A,Republican Period,7,-200,-30,170,0.1
5697,poderi Palazzone-Fornace,A,Early Imperial Period,8,-30,100,130,0.1
5698,podere Saletta,A,Early Imperial Period,8,0,100,100,0.01
5699,podere Saletta,A,Republican Period,7,-100,-30,70,0.01
5699,podere Saletta,A,Early Imperial Period,8,-30,100,130,0.01
5700,Palazzina delle Sale,A,Republican Period,7,-200,-100,100,0.01
5701,Palazzina delle Sale,A,Republican Period,7,-300,-30,270,0.02
5702,Palazzina delle Sale,A,Republican Period,7,-300,-30,270,0.02
5703,Palazzina delle Sale,A,Republican Period,7,-300,-100,200,0.01
5704,Palazzina delle Sale,A,Republican Period,7,-100,-30,70,0.01
5704,Palazzina delle Sale,A,Early Imperial Period,8,-30,100,130,0.01
5705,podere le Sale,A,Republican Period,7,-300,-50,250,0.01
5706,podere le Sale,A,Republican Period,7,-300,-100,200,0.050000001
5707,podere le Sale,A,Republican Period,7,-300,-100,200,0.01
5708,podere le Sale,A,Archaic Period,6,-400,-350,50,0.01
5708,podere le Sale,A,Republican Period,7,-350,-150,200,0.01
5709,podere la Selva,A,Late Iron Age,5,-600,-580,20,0.02
5709,podere la Selva,A,Archaic Period,6,-580,-500,80,0.02
5710,Monterotondo,A,Early Imperial Period,8,-30,100,130,0.029999999
5711,Monterotondo,A,Early Imperial Period,8,-30,100,130,0.02
5711,Monterotondo,A,Mid-Imperial Period,9,100,300,200,0.02
5711,Monterotondo,A,Late Imperial Period,10,300,500,200,0.02
5712,Monterotondo,A,Early Imperial Period,8,0,100,100,0.02
5712,Monterotondo,A,Mid-Imperial Period,9,100,200,100,0.02
5713,Gamosa,A,Early Imperial Period,8,0,100,100,0.01
5713,Gamosa,A,Mid-Imperial Period,9,100,300,200,0.01
5714,podere Raffaello,A,Middle Bronze Age,2,-1700,-1300,400,0.01
5715,podere Raffaello,A,Republican Period,7,-100,-30,70,0.02
5715,podere Raffaello,A,Early Imperial Period,8,-30,100,130,0.02
5716,podere Belvedere,A,Middle Bronze Age,2,-1700,-1300,400,0.01
5717,podere Belvedere,A,Late Imperial Period,10,400,500,100,0.050000001
5717,podere Belvedere,A,Late Antique Period,11,500,600,100,0.050000001
5718,Poggioncione,A,Republican Period,7,-300,-30,270,0.039999999
5719,Poggioncione,A,Mid-Imperial Period,9,250,300,50,0.2
5719,Poggioncione,A,Late Imperial Period,10,300,500,200,0.2
5719,Poggioncione,A,Late Antique Period,11,500,650,150,0.2
5720,Poggioncione,A,Early Imperial Period,8,50,100,50,0.02
5720,Poggioncione,A,Mid-Imperial Period,9,100,300,200,0.02
5720,Poggioncione,A,Late Imperial Period,10,300,400,100,0.02
5721,Bellaria,A,Republican Period,7,-300,-100,200,0.01
5722,la Villa,A,Late Imperial Period,10,300,500,200,0.059999999
5723,Il Paradiso,A,Republican Period,7,-200,-30,170,0.02
5723,Il Paradiso,A,Early Imperial Period,8,-30,100,130,0.02
5724,Casina,A,Early Imperial Period,8,0,100,100,0.029999999
5724,Casina,A,Mid-Imperial Period,9,100,200,100,0.029999999
5725,Podere Gello,A,Republican Period,7,-300,-30,270,0.1
5725,Podere Gello,A,Early Imperial Period,8,-30,100,130,0.1
5726,Podere Gello,A,Republican Period,7,-200,-100,100,0.1
5727,Poggio all'Abate,A,Republican Period,7,-200,-30,170,0.30000001
5727,Poggio all'Abate,A,Early Imperial Period,8,-30,100,130,0.30000001
5727,Poggio all'Abate,A,Mid-Imperial Period,9,100,200,100,0.30000001
5728,Camponibbio,A,Republican Period,7,-100,-30,70,0.1
5730,I Piani,A,Mid-Imperial Period,9,100,200,100,0.1
5731,La Fornace,A,Early Imperial Period,8,0,100,100,0.1
5732,Podere Fornace,A,Republican Period,7,-100,-30,70,0.1
5732,Podere Fornace,A,Early Imperial Period,8,-30,100,130,0.1
5733,Podere Gabbiano,A,Republican Period,7,-100,-30,70,0.30000001
5733,Podere Gabbiano,A,Early Imperial Period,8,-30,100,130,0.30000001
5734,Gabbiano,A,Middle Bronze Age,2,-1700,-1500,200,1
5735,Maglianella,A,Republican Period,7,-200,-30,170,0.1
5735,Maglianella,A,Early Imperial Period,8,-30,100,130,0.1
5736,San Giusto,A,Republican Period,7,-200,-30,170,0.5
5736,San Giusto,A,Early Imperial Period,8,-30,50,80,0.5
5737,Palazzo Bandino,A,Republican Period,7,-100,-30,70,0.2
5737,Palazzo Bandino,A,Early Imperial Period,8,-30,100,130,0.2
5737,Palazzo Bandino,A,Mid-Imperial Period,9,100,200,100,0.2
5738,Campo Grande,A,Republican Period,7,-150,-30,120,0.60000002
5738,Campo Grande,A,Early Imperial Period,8,-30,100,130,0.60000002
5739,Morelli,A,Republican Period,7,-100,-30,70,1
5739,Morelli,A,Early Imperial Period,8,-30,100,130,1
5740,Morello,A,Republican Period,7,-100,-30,70,0.2
5740,Morello,A,Early Imperial Period,8,-30,100,130,0.2
5741,Castagnolo,A,Republican Period,7,-200,-30,170,0.01
5741,Castagnolo,A,Early Imperial Period,8,-30,100,130,0.01
5742,Morellino,A,Mid-Imperial Period,9,200,300,100,0.01
5742,Morellino,A,Late Imperial Period,10,300,400,100,0.01
5743,Astrone,A,Republican Period,7,-100,-30,70,0.1
5743,Astrone,A,Early Imperial Period,8,-30,100,130,0.1
5744,Astrone,A,Republican Period,7,-100,-30,70,0.1
5744,Astrone,A,Early Imperial Period,8,-30,100,130,0.1
5745,Poggio Bacherina,A,Republican Period,7,-150,-50,100,0.029999999
5746,Casanuova,A,Republican Period,7,-150,-30,120,0.2
5747,Piane Pucci,A,Republican Period,7,-200,-100,100,0.1
5749,Grencaia,A,Early Imperial Period,8,0,100,100,0.01
5749,Grencaia,A,Mid-Imperial Period,9,100,200,100,0.01
5750,Chiarentana,A,Republican Period,7,-200,-30,170,0.2
5750,Chiarentana,A,Early Imperial Period,8,-30,100,130,0.2
5750,Chiarentana,A,Mid-Imperial Period,9,100,300,200,0.2
5750,Chiarentana,A,Late Imperial Period,10,300,500,200,0.2
5753,Chiarentana,A,Middle Bronze Age,2,-1700,-1500,200,0.1
5755,Morelli,A,Archaic Period,6,-400,-350,50,1.2
5755,Morelli,A,Republican Period,7,-350,-30,320,1.2
5756,Podere I Prati,A,Republican Period,7,-100,-30,70,0.07
5757,Podere I Prati,A,Republican Period,7,-350,-150,200,0.059999999
5758,Podere Montauto,A,Early Imperial Period,8,0,100,100,1.2
5758,Podere Montauto,A,Mid-Imperial Period,9,100,200,100,1.2
5759,Tolle,A,Middle Bronze Age,2,-1700,-1300,400,0.1
5760,Sassaia,A,Republican Period,7,-200,-30,170,1.5
5760,Sassaia,A,Early Imperial Period,8,-30,100,130,1.5
5760,Sassaia,A,Mid-Imperial Period,9,100,300,200,1.5
5760,Sassaia,A,Late Imperial Period,10,300,500,200,1.5
5761,Podere Casella,A,Archaic Period,6,-400,-350,50,0.01
5761,Podere Casella,A,Republican Period,7,-350,-100,250,0.01
5762,Il Poggione,A,Archaic Period,6,-400,-350,50,0.5
5762,Il Poggione,A,Republican Period,7,-350,-100,250,0.5
5763,Podere Fuga,A,Late Iron Age,5,-700,-580,120,0.01
5763,Podere Fuga,A,Archaic Period,6,-580,-350,230,0.01
5763,Podere Fuga,A,Republican Period,7,-350,-100,250,0.01
5764,Podere Casano di Sotto,A,Early Imperial Period,8,-30,100,130,0.039999999
5764,Podere Casano di Sotto,A,Mid-Imperial Period,9,100,300,200,0.039999999
5764,Podere Casano di Sotto,A,Late Imperial Period,10,300,500,200,0.039999999
5765,Podere Casano di Sotto,A,Late Imperial Period,10,300,500,200,0.01
5765,Podere Casano di Sotto,A,Late Antique Period,11,500,600,100,0.01
5766,Podere Casano di Sotto,A,Republican Period,7,-100,-30,70,0.01
5766,Podere Casano di Sotto,A,Early Imperial Period,8,-30,100,130,0.01
5767,Podere Casa Bruciata,A,Republican Period,7,-100,-30,70,0.01
5767,Podere Casa Bruciata,A,Early Imperial Period,8,-30,100,130,0.01
5768,Podere Salviano,A,Archaic Period,6,-400,-350,50,0.01
5768,Podere Salviano,A,Republican Period,7,-350,-100,250,0.01
5769,Lucignano d'Asso,A,Republican Period,7,-100,-30,70,0.01
5769,Lucignano d'Asso,A,Early Imperial Period,8,-30,100,130,0.01
5770,Lucignano d'Asso,A,Republican Period,7,-200,-30,170,0.01
5770,Lucignano d'Asso,A,Early Imperial Period,8,-30,100,130,0.01
5770,Lucignano d'Asso,A,Mid-Imperial Period,9,100,300,200,0.01
5770,Lucignano d'Asso,A,Late Imperial Period,10,300,500,200,0.01
5771,Lucignano d'Asso,A,Republican Period,7,-200,-30,170,0.02
5771,Lucignano d'Asso,A,Early Imperial Period,8,-30,100,130,0.02
5771,Lucignano d'Asso,A,Mid-Imperial Period,9,100,300,200,0.02
5771,Lucignano d'Asso,A,Late Imperial Period,10,300,500,200,0.02
5772,Podere S. Alessandro,A,Archaic Period,6,-400,-350,50,0.01
5772,Podere S. Alessandro,A,Republican Period,7,-350,-100,250,0.01
5773,Podere S. Alessandro,A,Archaic Period,6,-400,-350,50,0.01
5773,Podere S. Alessandro,A,Republican Period,7,-350,-100,250,0.01
5774,Podere S. Alessandro,A,Archaic Period,6,-400,-350,50,0.01
5774,Podere S. Alessandro,A,Republican Period,7,-350,-100,250,0.01
5775,Lucignano d'Asso,A,Republican Period,7,-100,-30,70,0.5
5775,Lucignano d'Asso,A,Early Imperial Period,8,-30,100,130,0.5
5775,Lucignano d'Asso,A,Mid-Imperial Period,9,100,300,200,0.5
5775,Lucignano d'Asso,A,Late Imperial Period,10,300,500,200,0.5
5775,Lucignano d'Asso,A,Late Antique Period,11,500,600,100,0.5
5776,Podere La Fonte,A,Archaic Period,6,-400,-350,50,0.01
5776,Podere La Fonte,A,Republican Period,7,-350,-100,250,0.01
5777,Podere La Fonte,A,Republican Period,7,-100,-30,70,0.02
5777,Podere La Fonte,A,Early Imperial Period,8,-30,100,130,0.02
5777,Podere La Fonte,B,Late Imperial Period,10,300,500,200,0.02
5777,Podere La Fonte,B,Late Antique Period,11,500,600,100,0.02
5778,Podere La Fonte,A,Late Imperial Period,10,300,500,200,0.01
5778,Podere La Fonte,A,Late Antique Period,11,500,600,100,0.01
5779,Podere La Fonte,A,Republican Period,7,-200,-30,170,0.01
5779,Podere La Fonte,A,Early Imperial Period,8,-30,100,130,0.01
5779,Podere La Fonte,A,Mid-Imperial Period,9,100,300,200,0.01
5779,Podere La Fonte,A,Late Imperial Period,10,300,500,200,0.01
5780,Podere Vernine Vecchie,A,Archaic Period,6,-400,-350,50,0.01
5780,Podere Vernine Vecchie,A,Republican Period,7,-350,-100,250,0.01
5781,Podere Vernine Vecchie,A,Archaic Period,6,-400,-350,50,0.01
5781,Podere Vernine Vecchie,A,Republican Period,7,-350,-100,250,0.01
5782,Podere Vernine Vecchie,A,Archaic Period,6,-400,-350,50,0.029999999
5782,Podere Vernine Vecchie,A,Republican Period,7,-350,-100,250,0.029999999
5783,Podere Verninelle,A,Late Iron Age,5,-600,-580,20,0.01
5783,Podere Verninelle,A,Archaic Period,6,-580,-500,80,0.01
5784,Podere Chiuso,A,Republican Period,7,-200,-30,170,0.01
5784,Podere Chiuso,A,Early Imperial Period,8,-30,100,130,0.01
5785,Podere Porronella,A,Late Iron Age,5,-700,-580,120,0.01
5785,Podere Porronella,A,Archaic Period,6,-580,-350,230,0.01
5785,Podere Porronella,A,Republican Period,7,-350,-100,250,0.01
5786,Podere Casella,A,Archaic Period,6,-400,-350,50,0.1
5786,Podere Casella,A,Republican Period,7,-350,-100,250,0.1
5787,Podere Casella,A,Archaic Period,6,-400,-350,50,0.01
5787,Podere Casella,A,Republican Period,7,-350,-100,250,0.01
5788,Podere Casella,A,Archaic Period,6,-400,-350,50,0.01
5788,Podere Casella,A,Republican Period,7,-350,-100,250,0.01
5789,Podere S. Antonio,A,Archaic Period,6,-400,-350,50,0.01
5789,Podere S. Antonio,A,Republican Period,7,-350,-100,250,0.01
5790,Podere Poggio,A,Archaic Period,6,-400,-350,50,0.01
5790,Podere Poggio,A,Republican Period,7,-350,-100,250,0.01
5791,Podere S. Alessandro,A,Archaic Period,6,-400,-350,50,0.01
5791,Podere S. Alessandro,A,Republican Period,7,-350,-100,250,0.01
5792,Podere S. Alessandro,A,Archaic Period,6,-400,-350,50,0.01
5792,Podere S. Alessandro,A,Republican Period,7,-350,-100,250,0.01
5793,La Madonna,A,Archaic Period,6,-400,-350,50,0.5
5793,La Madonna,A,Republican Period,7,-350,-100,250,0.5
5794,Podere Colombaio,A,Archaic Period,6,-400,-350,50,0.01
5794,Podere Colombaio,A,Republican Period,7,-350,-100,250,0.01
5795,Podere Colombaio,A,Archaic Period,6,-400,-350,50,0.01
5795,Podere Colombaio,A,Republican Period,7,-350,-100,250,0.01
5796,Podere Poggio al Vento,A,Republican Period,7,-200,-30,170,0.5
5796,Podere Poggio al Vento,A,Early Imperial Period,8,-30,100,130,0.5
5797,Podere S. Maria,A,Archaic Period,6,-400,-350,50,0.01
5797,Podere S. Maria,A,Republican Period,7,-350,-100,250,0.01
5798,Podere S. Maria,A,Archaic Period,6,-400,-350,50,0.01
5798,Podere S. Maria,A,Republican Period,7,-350,-100,250,0.01
5799,Podere Salviano,A,Archaic Period,6,-400,-350,50,0.01
5799,Podere Salviano,A,Republican Period,7,-350,-100,250,0.01
5800,Podere Poggio al Vento,A,Archaic Period,6,-400,-350,50,0.01
5800,Podere Poggio al Vento,A,Republican Period,7,-350,-100,250,0.01
5801,Podere Poggio al Vento,A,Archaic Period,6,-400,-350,50,0.029999999
5801,Podere Poggio al Vento,A,Republican Period,7,-350,-100,250,0.029999999
5802,Poggio Rotondo,A,Archaic Period,6,-400,-350,50,0.01
5802,Poggio Rotondo,A,Republican Period,7,-350,-100,250,0.01
5803,Poggio Rotondo,A,Archaic Period,6,-400,-350,50,0.5
5803,Poggio Rotondo,A,Republican Period,7,-350,-100,250,0.5
5803,Poggio Rotondo,B,Late Imperial Period,10,300,500,200,0.5
5804,Podere Colombaio,A,Archaic Period,6,-400,-350,50,0.029999999
5804,Podere Colombaio,A,Republican Period,7,-350,-100,250,0.029999999
5805,Podere Colombaio,A,Archaic Period,6,-400,-350,50,0.2
5805,Podere Colombaio,A,Republican Period,7,-350,-100,250,0.2
5805,Podere Colombaio,B,Late Imperial Period,10,300,500,200,0.2
5806,Podere Ginestrelle,A,Republican Period,7,-100,-30,70,0.01
5806,Podere Ginestrelle,A,Early Imperial Period,8,-30,100,130,0.01
5807,S. Giovanni d'Asso,A,Archaic Period,6,-400,-350,50,0.69999999
5807,S. Giovanni d'Asso,A,Republican Period,7,-350,-100,250,0.69999999
5808,Pieve di Pava,A,Republican Period,7,-300,-30,270,0.5
5808,Pieve di Pava,A,Early Imperial Period,8,-30,100,130,0.5
5808,Pieve di Pava,A,Mid-Imperial Period,9,100,300,200,0.5
5808,Pieve di Pava,A,Late Imperial Period,10,300,500,200,0.5
5809,Podere Casella,A,Early Imperial Period,8,0,100,100,0.01
5809,Podere Casella,B,Late Imperial Period,10,300,500,200,0.01
5810,Podere Picciolo,A,Republican Period,7,-100,-30,70,0.01
5810,Podere Picciolo,A,Early Imperial Period,8,-30,100,130,0.01
5811,Podere Canonica,A,Early Imperial Period,8,0,100,100,0.01
5812,Podere Canonica,A,Early Imperial Period,8,0,100,100,0.1
5812,Podere Canonica,B,Late Imperial Period,10,300,500,200,0.1
5813,Podere Canonica,A,Early Bronze Age,1,-2300,-1700,600,0.02
5813,Podere Canonica,A,Middle Bronze Age,2,-1700,-1300,400,0.02
5813,Podere Canonica,A,Late Bronze Age,3,-1300,-1020,280,0.02
5813,Podere Canonica,A,Early Iron Age,4,-1020,-1000,20,0.02
5813,Podere Canonica,B,Archaic Period,6,-400,-350,50,0.02
5813,Podere Canonica,B,Republican Period,7,-350,-30,320,0.02
5814,Podere Canonica,A,Early Bronze Age,1,-2200,-1700,500,0.02
5814,Podere Canonica,A,Middle Bronze Age,2,-1700,-1300,400,0.02
5814,Podere Canonica,A,Late Bronze Age,3,-1300,-1020,280,0.02
5814,Podere Canonica,A,Early Iron Age,4,-1020,-1000,20,0.02
5814,Podere Canonica,B,Archaic Period,6,-400,-350,50,0.02
5814,Podere Canonica,B,Republican Period,7,-350,-30,320,0.02
5815,Castel Verdelli,A,Republican Period,7,-100,-30,70,0.050000001
5815,Castel Verdelli,A,Early Imperial Period,8,-30,100,130,0.050000001
5816,Il Boschetto,A,Republican Period,7,-100,-30,70,0.40000001
5816,Il Boschetto,A,Early Imperial Period,8,-30,100,130,0.40000001
5817,Poggio Vergelle,A,Republican Period,7,-100,-30,70,0.1
5817,Poggio Vergelle,A,Early Imperial Period,8,-30,100,130,0.1
5818,Il Boschetto,A,Republican Period,7,-100,-30,70,0.2
5818,Il Boschetto,A,Early Imperial Period,8,-30,100,130,0.2
5819,Il Boschetto,A,Republican Period,7,-100,-30,70,0.050000001
5819,Il Boschetto,A,Early Imperial Period,8,-30,100,130,0.039999999
5820,Il Boschetto,A,Republican Period,7,-100,-30,70,0.039999999
5820,Il Boschetto,A,Early Imperial Period,8,-30,100,130,0.039999999
5821,Il Boschetto,A,Republican Period,7,-100,-30,70,0.2
5821,Il Boschetto,A,Early Imperial Period,8,-30,100,130,0.2
5822,Il Boschetto,A,Republican Period,7,-100,-30,70,0.059999999
5822,Il Boschetto,A,Early Imperial Period,8,-30,100,130,0.059999999
5823,S. Giovanni d'Asso,A,Archaic Period,6,-400,-350,50,0.01
5823,S. Giovanni d'Asso,A,Republican Period,7,-350,-100,250,0.01
5823,S. Giovanni d'Asso,B,Early Imperial Period,8,0,100,100,0.01
5824,Brizio,A,Republican Period,7,-100,-30,70,0.5
5824,Brizio,A,Early Imperial Period,8,-30,100,130,0.5
5825,Badia Ardenga,A,Late Iron Age,5,-600,-580,20,0.01
5825,Badia Ardenga,A,Archaic Period,6,-580,-500,80,0.01
5826,Badia Ardenga,A,Late Iron Age,5,-600,-580,20,0.01
5826,Badia Ardenga,A,Archaic Period,6,-580,-500,80,0.01
5827,Nuova,A,Republican Period,7,-100,-30,70,0.01
5827,Nuova,A,Early Imperial Period,8,-30,100,130,0.01
5828,Podere Lambertino,A,Republican Period,7,-300,-100,200,0.02
5829,Podere Lambertino,A,Early Imperial Period,8,-30,100,130,0.02
5830,Podere Lambertino,A,Republican Period,7,-300,-100,200,0.01
5830,Podere Lambertino,B,Early Imperial Period,8,-30,100,130,0.01
5831,Villa di Argiano,A,Republican Period,7,-300,-100,200,0.01
5832,Badia Ardenga,A,Republican Period,7,-300,-30,270,0.01
5832,Badia Ardenga,A,Early Imperial Period,8,-30,100,130,0.01
5833,Catelvecchio,A,Republican Period,7,-300,-30,270,0.01
5833,Catelvecchio,A,Early Imperial Period,8,-30,100,130,0.01
5834,Nuova,A,Late Iron Age,5,-600,-580,20,0.01
5834,Nuova,A,Archaic Period,6,-580,-500,80,0.01
5834,Nuova,B,Republican Period,7,-300,-100,200,0.01
5835,Osteriaccia,A,Republican Period,7,-100,-30,70,0.01
5835,Osteriaccia,A,Early Imperial Period,8,-30,100,130,0.01
5836,Quercecchio,A,Republican Period,7,-300,-100,200,0.01
5837,Quercecchio,A,Republican Period,7,-300,-100,200,0.02
5838,Quercecchio,A,Republican Period,7,-300,-100,200,0.01
5839,Bellaria,A,Republican Period,7,-300,-100,200,0.050000001
5840,Bellaria,A,Republican Period,7,-300,-100,200,0.01
5841,Bellaria,A,Republican Period,7,-300,-100,200,0.050000001
5842,Scopeto,A,Republican Period,7,-300,-100,200,0.02
5843,Nuova,A,Republican Period,7,-300,-30,270,0.01
5843,Nuova,A,Early Imperial Period,8,-30,100,130,0.01
5844,Vadossi,A,Republican Period,7,-300,-100,200,0.01
5845,Caprili,A,Early Imperial Period,8,-30,100,130,0.1
5846,Poderuccio,A,Early Imperial Period,8,-30,100,130,0.01
5847,Podere Stabbi,A,Republican Period,7,-300,-100,200,0.01
5848,Podere Lambertone,A,Republican Period,7,-300,-100,200,0.01
5848,Podere Lambertone,B,Early Imperial Period,8,-30,100,130,0.01
5849,Podere La Fornace,A,Republican Period,7,-100,-30,70,0.1
5849,Podere La Fornace,A,Early Imperial Period,8,-30,100,130,0.1
5850,Brixio,A,Republican Period,7,-100,-30,70,0.01
5850,Brixio,A,Early Imperial Period,8,-30,100,130,0.01
5851,Brixio,A,Early Imperial Period,8,-30,100,130,0.01
5852,Camigliano,A,Republican Period,7,-300,-100,200,0.01
5853,Podere Capanna,A,Early Imperial Period,8,-30,100,130,0.2
5854,Podere Capanna,A,Early Imperial Period,8,-30,100,130,0.1
5855,Poggio Civitella,A,Late Iron Age,5,-700,-580,120,1
5855,Poggio Civitella,A,Archaic Period,6,-580,-500,80,1
5858,Vadossi,A,Early Bronze Age,1,-2300,-1700,600,0.01
5858,Vadossi,A,Middle Bronze Age,2,-1700,-1300,400,0.01
5858,Vadossi,A,Late Bronze Age,3,-1300,-1020,280,0.01
5858,Vadossi,A,Early Iron Age,4,-1020,-1000,20,0.01
5859,Altesi,A,Early Imperial Period,8,-30,100,130,0.01
5861,Montalcino,A,Early Bronze Age,1,-2300,-1700,600,0.01
5862,Montalcino,A,Early Bronze Age,1,-2300,-1700,600,0.01
5863,Montalcino,A,Early Iron Age,4,-1000,-800,200,0.01
5864,S. Antimo,A,Late Iron Age,5,-600,-580,20,0.1
5864,S. Antimo,A,Archaic Period,6,-580,-500,80,0.1
5864,S. Antimo,B,Republican Period,7,-300,-100,200,0.1
5865,Montosoli,A,Republican Period,7,-300,-30,270,0.1
5865,Montosoli,A,Early Imperial Period,8,-30,100,130,0.1
5866,S. Antimo,A,Early Imperial Period,8,-30,100,130,0.2
5867,Canalicchio,A,Republican Period,7,-300,-100,200,0.02
5868,Canalicchio,A,Late Iron Age,5,-600,-580,20,0.01
5868,Canalicchio,A,Archaic Period,6,-580,-500,80,0.01
5868,Canalicchio,B,Early Imperial Period,8,0,100,100,0.01
5869,Montosoli,A,Late Iron Age,5,-600,-580,20,0.1
5869,Montosoli,A,Archaic Period,6,-580,-500,80,0.1
5870,Montosoli,A,Republican Period,7,-300,-100,200,0.01
5871,Montosoli,A,Late Iron Age,5,-600,-580,20,0.01
5871,Montosoli,A,Archaic Period,6,-580,-500,80,0.01
5871,Montosoli,B,Early Imperial Period,8,-30,100,130,0.01
5872,Montosoli,A,Republican Period,7,-300,-200,100,0.01
5873,Montosoli,A,Late Iron Age,5,-600,-580,20,0.02
5873,Montosoli,A,Archaic Period,6,-580,-500,80,0.02
5874,Montosoli,A,Late Iron Age,5,-600,-580,20,0.01
5874,Montosoli,A,Archaic Period,6,-580,-500,80,0.01
5875,Madonna del Piano,A,Republican Period,7,-300,-100,200,0.01
5876,Santa Restituta,A,Early Imperial Period,8,-30,100,130,0.01
5876,Santa Restituta,A,Mid-Imperial Period,9,100,300,200,0.01
5876,Santa Restituta,A,Late Imperial Period,10,300,500,200,0.01
5877,S. Antimo,A,Early Imperial Period,8,0,100,100,0.029999999
5878,S. Antimo,A,Late Iron Age,5,-600,-580,20,0.01
5878,S. Antimo,A,Archaic Period,6,-580,-500,80,0.01
5878,S. Antimo,B,Republican Period,7,-300,-100,200,0.029999999
5878,S. Antimo,C,Early Imperial Period,8,0,100,100,0.01
5879,S. Antimo,A,Republican Period,7,-300,-100,200,0.01
5880,S. Antimo,A,Republican Period,7,-300,-100,200,0.01
5881,S. Antimo,A,Republican Period,7,-300,-100,200,0.059999999
5882,S. Antimo,A,Late Iron Age,5,-600,-580,20,0.01
5882,S. Antimo,A,Archaic Period,6,-580,-500,80,0.01
5882,S. Antimo,B,Republican Period,7,-300,-100,200,0.02
5883,S. Antimo,A,Early Imperial Period,8,0,100,100,0.01
5884,Podere La Croce,A,Early Imperial Period,8,0,100,100,0.01
5885,Podere S. Piero,A,Republican Period,7,-300,-30,270,0.01
5885,Podere S. Piero,A,Early Imperial Period,8,-30,100,130,0.01
5885,Podere S. Piero,A,Mid-Imperial Period,9,100,300,200,0.01
5885,Podere S. Piero,A,Late Imperial Period,10,300,500,200,0.01
5886,Podere Collalli,A,Early Imperial Period,8,0,100,100,0.029999999
5886,Podere Collalli,A,Mid-Imperial Period,9,100,300,200,0.029999999
5886,Podere Collalli,A,Late Imperial Period,10,300,500,200,0.029999999
5887,Podere Sparampaglia,A,Republican Period,7,-300,-100,200,0.050000001
5888,Podere Il Palazzo,A,Republican Period,7,-350,-100,250,0.02
5889,Podere Collalli,A,Early Imperial Period,8,0,100,100,0.02
5890,Podere Collalli,A,Early Imperial Period,8,0,100,100,0.02
5891,Podere Collalli,A,Early Imperial Period,8,0,100,100,0.01
5892,Podere Sperata,A,Early Imperial Period,8,0,100,100,0.01
5893,La Casaccia,A,Republican Period,7,-100,-30,70,0.01
5893,La Casaccia,A,Early Imperial Period,8,-30,100,130,0.01
5894,La Casaccia,A,Republican Period,7,-100,-30,70,0.07
5894,La Casaccia,A,Early Imperial Period,8,-30,100,130,0.07
5895,La Casaccia,A,Republican Period,7,-100,-30,70,0.07
5895,La Casaccia,A,Early Imperial Period,8,-30,100,130,0.07
5896,Canalicchio,A,Republican Period,7,-100,-30,70,0.07
5896,Canalicchio,A,Early Imperial Period,8,-30,100,130,0.07
5897,Canalicchio,A,Republican Period,7,-100,-30,70,0.2
5897,Canalicchio,A,Early Imperial Period,8,-30,100,130,0.2
5898,Podere Luciere,A,Republican Period,7,-100,-30,70,0.01
5898,Podere Luciere,A,Early Imperial Period,8,-30,100,130,0.01
5899,Podere Fontepetri,A,Republican Period,7,-100,-30,70,0.01
5899,Podere Fontepetri,A,Early Imperial Period,8,-30,100,130,0.01
5900,Podere Toscano,A,Early Imperial Period,8,-30,100,130,0.01
5901,Podere Castellare,A,Republican Period,7,-300,-100,200,0.029999999
5902,Lume Spento,A,Republican Period,7,-300,-100,200,0.01
5903,Podere Montechiaro,A,Republican Period,7,-300,-100,200,0.02
5903,Podere Montechiaro,B,Early Imperial Period,8,-30,100,130,0.01
5904,Celamonti,A,Republican Period,7,-300,-100,200,0.01
5904,Celamonti,B,Early Imperial Period,8,-30,100,130,0.01
5905,Triboli di Sopra,A,Republican Period,7,-300,-100,200,0.1
5906,Patrizio,A,Republican Period,7,-100,-30,70,0.30000001
5906,Patrizio,A,Early Imperial Period,8,-30,100,130,0.30000001
5907,Podere Collalli,A,Early Imperial Period,8,0,100,100,0.059999999
5908,Casello,A,Republican Period,7,-300,-100,200,0.059999999
5909,Podere Pian dell'Asso,A,Republican Period,7,-300,-100,200,0.02
5910,Podere Pian dell'Asso,A,Republican Period,7,-300,-100,200,0.01
5911,Podere Pian dell'Asso,A,Republican Period,7,-300,-100,200,0.01
5912,Colombabione,A,Republican Period,7,-300,-100,200,0.2
5913,Podere Cerretalta,A,Republican Period,7,-300,-100,200,0.02
5914,Podere Cerretalta,A,Republican Period,7,-300,-100,200,0.02
5915,Fontilatro,A,Early Imperial Period,8,0,100,100,0.01
5916,Podere S. Giovanni,A,Republican Period,7,-300,-100,200,0.01
5917,Fontilatro,A,Republican Period,7,-300,-100,200,0.01
5917,Fontilatro,B,Early Imperial Period,8,-30,100,130,0.059999999
5918,Podere Lambertino,A,Late Iron Age,5,-600,-580,20,0.2
5918,Podere Lambertino,A,Archaic Period,6,-580,-500,80,0.2
5918,Podere Lambertino,B,Republican Period,7,-300,-100,200,0.02
5919,Podere Lambertino,A,Late Iron Age,5,-600,-580,20,0.01
5919,Podere Lambertino,A,Archaic Period,6,-580,-500,80,0.01
5919,Podere Lambertino,B,Early Imperial Period,8,-30,100,130,0.02
5920,Centine,A,Republican Period,7,-100,-30,70,1
5920,Centine,A,Early Imperial Period,8,-30,100,130,1
5920,Centine,A,Mid-Imperial Period,9,100,300,200,1
5920,Centine,A,Late Imperial Period,10,300,500,200,1
5921,Podere Nastasio,A,Republican Period,7,-300,-100,200,0.02
5922,Spontali,A,Republican Period,7,-100,-30,70,0.050000001
5922,Spontali,A,Early Imperial Period,8,-30,100,130,0.050000001
5923,Podere Nastasio,A,Republican Period,7,-300,-100,200,0.07
5924,Podere Bozzolino,A,Early Imperial Period,8,0,100,100,0.01
5925,Podere Bozzolino,A,Early Imperial Period,8,0,100,100,0.40000001
5926,Podere Fontilatro,A,Republican Period,7,-300,-100,200,0.01
5927,Podere Nastasio,A,Republican Period,7,-300,-100,200,0.039999999
5927,Podere Nastasio,B,Early Imperial Period,8,0,100,100,0.01
5928,Podere Nastasio,A,Republican Period,7,-300,-30,270,0.01
5928,Podere Nastasio,A,Early Imperial Period,8,-30,100,130,0.01
5929,Podere Bozzolino,A,Republican Period,7,-300,-100,200,0.029999999
5930,Buca di S. Antimo,A,Early Bronze Age,1,-2300,-1700,600,0.5
5930,Buca di S. Antimo,A,Middle Bronze Age,2,-1700,-1300,400,0.5
5930,Buca di S. Antimo,A,Late Bronze Age,3,-1300,-1020,280,0.5
5930,Buca di S. Antimo,A,Early Iron Age,4,-1020,-1000,20,0.5
5931,Fonte del Bozzolino,A,Republican Period,7,-100,-30,70,0.30000001
5931,Fonte del Bozzolino,A,Early Imperial Period,8,-30,100,130,0.30000001
5932,Fornacina,A,Early Imperial Period,8,-30,100,130,0.30000001
5932,Fornacina,A,Mid-Imperial Period,9,100,300,200,0.30000001
5933,Podere Terrarossa,A,Republican Period,7,-300,-100,200,0.01
5934,Podere Terrarossa,A,Early Imperial Period,8,0,100,100,0.01
5935,Podere Terrarossa,A,Early Imperial Period,8,0,100,100,0.02
5935,Podere Terrarossa,A,Mid-Imperial Period,9,100,200,100,0.02
5936,Podere Terrarossa,A,Republican Period,7,-300,-100,200,0.01
5937,Podere Terrarossa,A,Republican Period,7,-300,-100,200,0.01
5938,Podere L'Oliveto,A,Early Imperial Period,8,0,100,100,0.029999999
5939,Podere Casello,A,Republican Period,7,-300,-100,200,0.01
5940,Podere Casanova,A,Early Imperial Period,8,-30,100,130,0.1
5941,Podere Casanova,A,Early Imperial Period,8,-30,100,130,0.1
5942,Podere Sesta,A,Mid-Imperial Period,9,200,300,100,0.1
5942,Podere Sesta,A,Late Imperial Period,10,300,500,200,0.1
5943,Podere Casone,A,Early Imperial Period,8,0,100,100,0.01
5944,Podere Casone,A,Early Imperial Period,8,0,100,100,0.02
5945,Podere Casone,A,Early Imperial Period,8,0,100,100,0.01
5946,Podere Casone,A,Early Imperial Period,8,0,100,100,0.01
5947,Podere Casone,A,Early Imperial Period,8,-30,100,130,0.2
5948,S. Angelo in Colle,A,Republican Period,7,-300,-100,200,0.01
5949,Podere Collosorbo,A,Republican Period,7,-300,-100,200,0.02
5950,Podere Collosorbo,A,Late Iron Age,5,-600,-580,20,0.029999999
5950,Podere Collosorbo,A,Archaic Period,6,-580,-500,80,0.029999999
5950,Podere Collosorbo,B,Republican Period,7,-100,-30,70,0.029999999
5950,Podere Collosorbo,B,Early Imperial Period,8,-30,100,130,0.029999999
5951,Podere il Poderino,A,Republican Period,7,-300,-100,200,0.029999999
5952,Podere Collosorbo,A,Republican Period,7,-100,-30,70,0.02
5952,Podere Collosorbo,A,Early Imperial Period,8,-30,100,130,0.02
5953,Podere il Poderino,A,Republican Period,7,-100,-30,70,0.02
5953,Podere il Poderino,A,Early Imperial Period,8,-30,100,130,0.02
5954,Podere Collosorbo,A,Late Iron Age,5,-600,-580,20,0.01
5954,Podere Collosorbo,A,Archaic Period,6,-580,-500,80,0.01
5954,Podere Collosorbo,B,Republican Period,7,-300,-100,200,0.01
5955,Podere Terrarossa,A,Republican Period,7,-100,-30,70,0.1
5955,Podere Terrarossa,A,Early Imperial Period,8,-30,100,130,0.1
5956,Podere Collosorbo,A,Republican Period,7,-100,-30,70,0.01
5956,Podere Collosorbo,A,Early Imperial Period,8,-30,100,130,0.01
5957,Podere Le Chiuse,A,Republican Period,7,-300,-100,200,0.050000001
5958,Podere Terrarossa,A,Republican Period,7,-300,-100,200,0.1
5959,Podere Collosorbo,A,Republican Period,7,-300,-100,200,0.2
5959,Podere Collosorbo,B,Early Imperial Period,8,-30,100,130,0.1
5960,Calvana,A,Archaic Period,6,-400,-350,50,1
5960,Calvana,A,Republican Period,7,-350,-30,320,1
5964,Borgo S. Lorenzo,A,Republican Period,7,-200,-30,170,0.1
5964,Borgo S. Lorenzo,A,Early Imperial Period,8,-30,100,130,0.1
5964,Borgo S. Lorenzo,A,Mid-Imperial Period,9,100,300,200,0.1
5964,Borgo S. Lorenzo,A,Late Imperial Period,10,300,500,200,0.1
5965,Borgo S. Lorenzo,A,Middle Bronze Age,2,-1700,-1300,400,0.1
5966,Vigna alla Corte,A,Archaic Period,6,-400,-350,50,0.01
5966,Vigna alla Corte,A,Republican Period,7,-350,-30,320,0.01
5966,Vigna alla Corte,A,Early Imperial Period,8,-30,100,130,0.01
5968,Dicomano,A,Early Imperial Period,8,-30,100,130,0.01
5969,Dicomano,A,Middle Bronze Age,2,-1700,-1300,400,0.01
5970,Piandrati,A,Mid-Imperial Period,9,100,300,200,0.01
5970,Piandrati,A,Late Imperial Period,10,300,400,100,0.01
5971,Casa Vico,A,Republican Period,7,-100,-30,70,0.01
5971,Casa Vico,A,Early Imperial Period,8,-30,100,130,0.01
5971,Casa Vico,A,Mid-Imperial Period,9,100,300,200,0.01
5972,Poggio di S. Martino,A,Archaic Period,6,-400,-350,50,0.050000001
5972,Poggio di S. Martino,A,Republican Period,7,-350,-100,250,0.050000001
5973,Sandetole,A,Republican Period,7,-300,-30,270,0.01
5974,Scopeto,A,Late Iron Age,5,-600,-580,20,0.1
5974,Scopeto,A,Archaic Period,6,-580,-500,80,0.1
5975,Lo Stecco,A,Early Imperial Period,8,-30,100,130,0.01
5976,Casa Torricina,A,Archaic Period,6,-400,-350,50,0.1
5976,Casa Torricina,A,Republican Period,7,-350,-100,250,0.1
5977,La Rotta,A,Late Iron Age,5,-700,-580,120,0.059999999
5977,La Rotta,A,Archaic Period,6,-580,-350,230,0.059999999
5977,La Rotta,A,Republican Period,7,-350,-100,250,0.059999999
5978,Podere la Capraia,A,Republican Period,7,-200,-30,170,0.1
5978,Podere la Capraia,A,Early Imperial Period,8,-30,100,130,0.1
5979,Pieve di S. Romolo a Gaville,A,Early Imperial Period,8,-30,100,130,0.1
5979,Pieve di S. Romolo a Gaville,A,Mid-Imperial Period,9,100,300,200,0.1
5979,Pieve di S. Romolo a Gaville,A,Late Imperial Period,10,300,500,200,0.1
5981,Poggiaccio,A,Middle Bronze Age,2,-1700,-1300,400,0.01
5982,Poggio Castelluccio,A,Early Iron Age,4,-900,-750,150,0.01
5982,Poggio Castelluccio,A,Late Iron Age,5,-750,-700,50,0.01
5983,S. Pellegrino,A,Early Bronze Age,1,-2300,-1700,600,0.01
5984,Il Poggio,A,Early Bronze Age,1,-2300,-1700,600,0.01
5985,San Vito a Loppiano,A,Early Imperial Period,8,-30,100,130,0.1
5986,Scorzolino di Sotto,A,Republican Period,7,-100,-30,70,0.01
5986,Scorzolino di Sotto,A,Early Imperial Period,8,-30,100,130,0.01
5986,Scorzolino di Sotto,A,Mid-Imperial Period,9,100,300,200,0.01
5986,Scorzolino di Sotto,A,Late Imperial Period,10,300,500,200,0.01
5987,Monte di Sopra,A,Republican Period,7,-100,-30,70,0.01
5987,Monte di Sopra,A,Early Imperial Period,8,-30,100,130,0.01
5987,Monte di Sopra,A,Mid-Imperial Period,9,100,300,200,0.01
5987,Monte di Sopra,A,Late Imperial Period,10,300,500,200,0.01
5988,Monte di Sopra,A,Republican Period,7,-100,-30,70,0.01
5988,Monte di Sopra,A,Early Imperial Period,8,-30,100,130,0.01
5988,Monte di Sopra,A,Mid-Imperial Period,9,100,300,200,0.01
5988,Monte di Sopra,A,Late Imperial Period,10,300,500,200,0.01
5989,S. Adriano,A,Republican Period,7,-100,-30,70,0.01
5989,S. Adriano,A,Early Imperial Period,8,-30,100,130,0.01
5989,S. Adriano,A,Mid-Imperial Period,9,100,300,200,0.01
5989,S. Adriano,A,Late Imperial Period,10,300,500,200,0.01
5990,Dovilia,A,Republican Period,7,-100,-30,70,0.01
5990,Dovilia,A,Early Imperial Period,8,-30,100,130,0.01
5990,Dovilia,A,Mid-Imperial Period,9,100,300,200,0.01
5990,Dovilia,A,Late Imperial Period,10,300,500,200,0.01
5991,Taverna di Sotto,A,Early Imperial Period,8,0,100,100,0.1
5991,Taverna di Sotto,A,Mid-Imperial Period,9,100,150,50,0.1
5992,Brilletta di Senzano,A,Republican Period,7,-50,-30,20,0.050000001
5992,Brilletta di Senzano,A,Early Imperial Period,8,-30,100,130,0.050000001
5993,La Villa,A,Archaic Period,6,-400,-350,50,0.1
5993,La Villa,A,Republican Period,7,-350,-100,250,0.1
5994,Vignali,A,Early Imperial Period,8,-30,100,130,0.1
5994,Vignali,A,Mid-Imperial Period,9,100,300,200,0.1
5994,Vignali,A,Late Imperial Period,10,300,500,200,0.1
5995,Vignali,A,Republican Period,7,-300,-100,200,0.1
5996,Le Ari,A,Mid-Imperial Period,9,100,300,200,0.01
5996,Le Ari,A,Late Imperial Period,10,300,400,100,0.01
5997,Campopuglio,A,Late Bronze Age,3,-1300,-1020,280,0.01
5997,Campopuglio,A,Early Iron Age,4,-1020,-1000,20,0.01
5998,Sala di Sotto,A,Late Bronze Age,3,-1300,-1020,280,0.01
5998,Sala di Sotto,A,Early Iron Age,4,-1020,-1000,20,0.01
5999,Mantigno,A,Early Bronze Age,1,-2300,-1700,600,0.01
5999,Mantigno,A,Middle Bronze Age,2,-1700,-1300,400,0.01
5999,Mantigno,A,Late Bronze Age,3,-1300,-1020,280,0.01
5999,Mantigno,A,Early Iron Age,4,-1020,-1000,20,0.01
6001,Podere il Nevale,A,Archaic Period,6,-400,-350,50,0.02
6001,Podere il Nevale,A,Republican Period,7,-350,-300,50,0.02
6002,I Sodi,A,Early Imperial Period,8,-30,100,130,0.01
6002,I Sodi,A,Mid-Imperial Period,9,100,300,200,0.01
6002,I Sodi,A,Late Imperial Period,10,300,500,200,0.01
6003,Diacceto,A,Early Imperial Period,8,-30,100,130,0.1
6003,Diacceto,A,Mid-Imperial Period,9,100,300,200,0.1
6003,Diacceto,A,Late Imperial Period,10,300,500,200,0.1
6004,Bardiglioni,A,Archaic Period,6,-400,-350,50,0.01
6004,Bardiglioni,A,Republican Period,7,-350,-100,250,0.01
6005,Monte Giovi,A,Late Iron Age,5,-700,-580,120,0.13
6005,Monte Giovi,A,Archaic Period,6,-580,-350,230,0.13
6005,Monte Giovi,A,Republican Period,7,-350,-300,50,0.13
6006,Colognole,A,Early Imperial Period,8,-30,100,130,0.01
6006,Colognole,A,Mid-Imperial Period,9,100,300,200,0.01
6006,Colognole,A,Late Imperial Period,10,300,500,200,0.01
6007,La Capraia,A,Republican Period,7,-300,-30,270,0.01
6008,Colle Guadagni,A,Archaic Period,6,-400,-350,50,0.1
6008,Colle Guadagni,A,Republican Period,7,-350,-100,250,0.1
6009,Poggio Castellonchio,A,Late Bronze Age,3,-1300,-1020,280,0.1
6009,Poggio Castellonchio,A,Early Iron Age,4,-1020,-1000,20,0.1
6010,Ginestreto,A,Republican Period,7,-200,-30,170,0.1
6010,Ginestreto,A,Early Imperial Period,8,-30,100,130,0.1
6010,Ginestreto,A,Mid-Imperial Period,9,100,300,200,0.1
6010,Ginestreto,A,Late Imperial Period,10,300,500,200,0.1
6011,Pitella,A,Late Iron Age,5,-700,-580,120,0.1
6011,Pitella,A,Archaic Period,6,-580,-350,230,0.1
6011,Pitella,A,Republican Period,7,-350,-300,50,0.1
6012,Doccia,A,Early Imperial Period,8,-30,100,130,0.1
6012,Doccia,A,Mid-Imperial Period,9,100,300,200,0.1
6012,Doccia,B,Late Imperial Period,10,300,500,200,0.1
6014,Montefiesole,A,Late Iron Age,5,-700,-580,120,0.1
6014,Montefiesole,A,Archaic Period,6,-580,-350,230,0.1
6014,Montefiesole,A,Republican Period,7,-350,-300,50,0.1
6015,La Torre,A,Early Iron Age,4,-900,-750,150,0.1
6015,La Torre,A,Late Iron Age,5,-750,-700,50,0.1
6016,Ponte a Vico,A,Archaic Period,6,-400,-350,50,0.01
6016,Ponte a Vico,A,Republican Period,7,-350,-100,250,0.01
6017,Il Pratello,A,Archaic Period,6,-400,-350,50,0.1
6017,Il Pratello,A,Republican Period,7,-350,-100,250,0.1
6018,Sieci,A,Mid-Imperial Period,9,100,300,200,0.050000001
6018,Sieci,A,Late Imperial Period,10,300,500,200,0.050000001
6019,Podere Voltorio,A,Republican Period,7,-300,-30,270,0.1
6020,Villa Bensi,A,Republican Period,7,-200,-30,170,0.01
6020,Villa Bensi,A,Early Imperial Period,8,-30,100,130,0.01
6020,Villa Bensi,A,Mid-Imperial Period,9,100,300,200,0.01
6020,Villa Bensi,A,Late Imperial Period,10,300,500,200,0.01
6021,Massa Nera,A,Early Imperial Period,8,-30,100,130,0.01
6021,Massa Nera,A,Mid-Imperial Period,9,100,300,200,0.01
6021,Massa Nera,A,Late Imperial Period,10,300,500,200,0.01
6022,Casa Tea,A,Early Imperial Period,8,-30,100,130,0.1
6022,Casa Tea,A,Mid-Imperial Period,9,100,200,100,0.1
6023,Pieve a Cascia,A,Republican Period,7,-300,-30,270,0.1
6023,Pieve a Cascia,A,Early Imperial Period,8,-30,100,130,0.1
6023,Pieve a Cascia,A,Mid-Imperial Period,9,100,300,200,0.1
6023,Pieve a Cascia,A,Late Imperial Period,10,300,500,200,0.1
6024,Poggio a Luco,A,Archaic Period,6,-400,-350,50,0.1
6024,Poggio a Luco,A,Republican Period,7,-350,-100,250,0.1
6025,Samprugnano,A,Republican Period,7,-200,-30,170,0.1
6025,Samprugnano,A,Early Imperial Period,8,-30,100,130,0.1
6025,Samprugnano,A,Mid-Imperial Period,9,100,300,200,0.1
6025,Samprugnano,A,Late Imperial Period,10,300,500,200,0.1
6026,podere La Bertinga,A,Early Imperial Period,8,-30,100,130,0.1
6026,podere La Bertinga,A,Mid-Imperial Period,9,100,300,200,0.1
6026,podere La Bertinga,A,Late Imperial Period,10,300,500,200,0.1
6027,Montecucco,A,Archaic Period,6,-500,-350,150,0.1
6027,Montecucco,A,Republican Period,7,-350,-200,150,0.1
6028,Poggio di Marciano,A,Republican Period,7,-200,-30,170,0.1
6028,Poggio di Marciano,A,Early Imperial Period,8,-30,100,130,0.1
6028,Poggio di Marciano,A,Mid-Imperial Period,9,100,300,200,0.1
6028,Poggio di Marciano,A,Late Imperial Period,10,300,500,200,0.1
6029,Casa La Noce,A,Republican Period,7,-200,-30,170,0.1
6029,Casa La Noce,A,Early Imperial Period,8,-30,100,130,0.1
6029,Casa La Noce,A,Mid-Imperial Period,9,100,300,200,0.1
6029,Casa La Noce,A,Late Imperial Period,10,300,500,200,0.1
6030,Pagnana,A,Republican Period,7,-200,-30,170,0.01
6030,Pagnana,A,Early Imperial Period,8,-30,100,130,0.01
6030,Pagnana,A,Mid-Imperial Period,9,100,300,200,0.01
6030,Pagnana,A,Late Imperial Period,10,300,500,200,0.01
6031,Casa Gamberaia,A,Archaic Period,6,-400,-350,50,0.1
6031,Casa Gamberaia,A,Republican Period,7,-350,-30,320,0.1
6031,Casa Gamberaia,A,Early Imperial Period,8,-30,100,130,0.1
6032,Troghi,A,Republican Period,7,-150,-100,50,0.01
6033,Poggio di Firenze,A,Late Iron Age,5,-600,-580,20,0.1
6033,Poggio di Firenze,A,Archaic Period,6,-580,-400,180,0.1
6036,I Monti,A,Late Iron Age,5,-650,-580,70,0.1
6036,I Monti,A,Archaic Period,6,-580,-450,130,0.1
6037,Marroneta Tonda,A,Early Bronze Age,1,-2300,-1700,600,0.01
6037,Marroneta Tonda,A,Middle Bronze Age,2,-1700,-1300,400,0.01
6038,Poggio Savelli,A,Early Imperial Period,8,0,100,100,0.30000001
6038,Poggio Savelli,A,Mid-Imperial Period,9,100,300,200,0.30000001
6038,Poggio Savelli,A,Late Imperial Period,10,300,400,100,0.30000001
6039,Coaiano,A,Mid-Imperial Period,9,100,300,200,0.029999999
6039,Coaiano,A,Late Imperial Period,10,300,400,100,0.029999999
6040,Maltempo,A,Early Imperial Period,8,0,100,100,0.1
6040,Maltempo,A,Mid-Imperial Period,9,100,300,200,0.1
6040,Maltempo,A,Late Imperial Period,10,300,500,200,0.1
6041,Poggio Colla,A,Late Iron Age,5,-600,-580,20,0.5
6041,Poggio Colla,A,Archaic Period,6,-580,-350,230,0.5
6041,Poggio Colla,A,Republican Period,7,-350,-200,150,0.5
6042,Podere Arena,A,Archaic Period,6,-400,-350,50,0.1
6042,Podere Arena,A,Republican Period,7,-350,-100,250,0.1
6043,Casa Poggiolino,A,Republican Period,7,-300,-100,200,0.1
6044,Piandrati,A,Late Iron Age,5,-600,-580,20,0.01
6044,Piandrati,A,Archaic Period,6,-580,-350,230,0.01
6044,Piandrati,A,Republican Period,7,-350,-100,250,0.01
6045,Casa Vico,A,Late Iron Age,5,-600,-580,20,0.01
6045,Casa Vico,A,Archaic Period,6,-580,-350,230,0.01
6045,Casa Vico,A,Republican Period,7,-350,-100,250,0.01
6047,Monte Bastione,A,Middle Bronze Age,2,-1700,-1300,400,0.01
6047,Monte Bastione,A,Late Bronze Age,3,-1300,-1200,100,0.01
6048,C. Poggio Commissario,A,Early Imperial Period,8,-30,100,130,0.2
6048,C. Poggio Commissario,A,Mid-Imperial Period,9,100,300,200,0.2
6048,C. Poggio Commissario,A,Late Imperial Period,10,300,500,200,0.2
6049,Pieve,A,Late Iron Age,5,-600,-580,20,0.1
6049,Pieve,A,Archaic Period,6,-580,-350,230,0.1
6049,Pieve,A,Republican Period,7,-350,-100,250,0.1
6050,Altomena,A,Early Imperial Period,8,-30,100,130,0.2
6050,Altomena,A,Mid-Imperial Period,9,100,300,200,0.2
6050,Altomena,A,Late Imperial Period,10,300,500,200,0.2
6051,Pieve di Lobaco,A,Late Iron Age,5,-600,-580,20,0.01
6051,Pieve di Lobaco,A,Archaic Period,6,-580,-350,230,0.01
6051,Pieve di Lobaco,A,Republican Period,7,-350,-30,320,0.01
6051,Pieve di Lobaco,A,Early Imperial Period,8,-30,100,130,0.01
6051,Pieve di Lobaco,A,Mid-Imperial Period,9,100,300,200,0.01
6051,Pieve di Lobaco,A,Late Imperial Period,10,300,500,200,0.01
6052,S. Martino,A,Republican Period,7,-100,-30,70,0.1
6052,S. Martino,A,Early Imperial Period,8,-30,100,130,0.1
6052,S. Martino,A,Mid-Imperial Period,9,100,300,200,0.1
6052,S. Martino,A,Late Imperial Period,10,300,500,200,0.1
6053,Grignano,A,Late Iron Age,5,-600,-580,20,0.01
6053,Grignano,A,Archaic Period,6,-580,-350,230,0.01
6053,Grignano,A,Republican Period,7,-350,-100,250,0.01
6054,Tabernacolo,A,Late Iron Age,5,-600,-580,20,0.01
6054,Tabernacolo,A,Archaic Period,6,-580,-350,230,0.01
6054,Tabernacolo,A,Republican Period,7,-350,-100,250,0.01
6055,S. Pier Maggiore,A,Late Iron Age,5,-600,-580,20,0.01
6055,S. Pier Maggiore,A,Archaic Period,6,-580,-350,230,0.01
6055,S. Pier Maggiore,A,Republican Period,7,-350,-100,250,0.01
6056,Gualdo,A,Republican Period,7,-100,-30,70,0.01
6056,Gualdo,A,Early Imperial Period,8,-30,100,130,0.01
6056,Gualdo,A,Mid-Imperial Period,9,100,300,200,0.01
6056,Gualdo,A,Late Imperial Period,10,300,500,200,0.01
6057,Le Colline,A,Republican Period,7,-100,-30,70,0.01
6057,Le Colline,A,Early Imperial Period,8,-30,100,130,0.01
6057,Le Colline,A,Mid-Imperial Period,9,100,300,200,0.01
6057,Le Colline,A,Late Imperial Period,10,300,500,200,0.01
6058,Poggio del Giro,A,Late Iron Age,5,-600,-580,20,0.1
6058,Poggio del Giro,A,Archaic Period,6,-580,-350,230,0.1
6058,Poggio del Giro,A,Republican Period,7,-350,-100,250,0.1
6059,Poggio del Giro,A,Republican Period,7,-100,-30,70,0.1
6059,Poggio del Giro,A,Early Imperial Period,8,-30,100,130,0.1
6059,Poggio del Giro,A,Mid-Imperial Period,9,100,300,200,0.1
6059,Poggio del Giro,A,Late Imperial Period,10,300,500,200,0.1
6060,Poggio Balletto,A,Late Iron Age,5,-600,-580,20,0.01
6060,Poggio Balletto,A,Archaic Period,6,-580,-350,230,0.01
6060,Poggio Balletto,A,Republican Period,7,-350,-100,250,0.01
6061,Torrigiana,A,Republican Period,7,-100,-30,70,0.01
6061,Torrigiana,A,Early Imperial Period,8,-30,100,130,0.01
6061,Torrigiana,A,Mid-Imperial Period,9,100,300,200,0.01
6061,Torrigiana,A,Late Imperial Period,10,300,500,200,0.01
6062,Podere Bellavista,A,Late Iron Age,5,-600,-580,20,0.01
6062,Podere Bellavista,A,Archaic Period,6,-580,-350,230,0.01
6062,Podere Bellavista,A,Republican Period,7,-350,-100,250,0.01
6063,C.le Le Cav,A,Republican Period,7,-100,-30,70,0.01
6063,C.le Le Cav,A,Early Imperial Period,8,-30,100,130,0.01
6063,C.le Le Cav,A,Mid-Imperial Period,9,100,300,200,0.01
6063,C.le Le Cav,A,Late Imperial Period,10,300,500,200,0.01
6068,Bulimacco/Cilea,A,Late Bronze Age,3,-1200,-1020,180,0.1
6068,Bulimacco/Cilea,A,Early Iron Age,4,-1020,-1000,20,0.1
6069,Latsruccia,A,Middle Bronze Age,2,-1700,-1500,200,0.1
6070,Val di Rose,A,Middle Bronze Age,2,-1700,-1500,200,0.1
6071,Via Lazzerini,A,Middle Bronze Age,2,-1700,-1500,200,0.1
6072,Podere Dogaia,A,Middle Bronze Age,2,-1700,-1500,200,0.1
6072,Podere Dogaia,B,Early Iron Age,4,-900,-750,150,0.1
6072,Podere Dogaia,B,Late Iron Age,5,-750,-580,170,0.1
6072,Podere Dogaia,B,Archaic Period,6,-580,-350,230,0.1
6072,Podere Dogaia,B,Republican Period,7,-350,-30,320,0.1
6072,Podere Dogaia,B,Early Imperial Period,8,-30,100,130,0.1
6072,Podere Dogaia,B,Mid-Imperial Period,9,100,300,200,0.1
6072,Podere Dogaia,B,Late Imperial Period,10,300,500,200,0.1
6073,S. Antonio,A,Middle Bronze Age,2,-1700,-1500,200,0.1
6075,Casa Nuova,A,Late Bronze Age,3,-1200,-1020,180,0.01
6075,Casa Nuova,A,Early Iron Age,4,-1020,-1000,20,0.01
6075,Casa Nuova,B,Late Iron Age,5,-600,-580,20,0.01
6075,Casa Nuova,B,Archaic Period,6,-580,-350,230,0.01
6075,Casa Nuova,C,Republican Period,7,-350,-30,320,0.01
6075,Casa Nuova,C,Early Imperial Period,8,-30,100,130,0.01
6075,Casa Nuova,C,Mid-Imperial Period,9,100,300,200,0.01
6075,Casa Nuova,C,Late Imperial Period,10,300,500,200,0.01
6076,Podere Becciani I,A,Republican Period,7,-100,-30,70,0.01
6076,Podere Becciani I,A,Early Imperial Period,8,-30,100,130,0.01
6077,Podere Becciani II,A,Early Imperial Period,8,0,100,100,0.01
6078,Podere Bosco,A,Republican Period,7,-100,-30,70,0.1
6078,Podere Bosco,A,Early Imperial Period,8,-30,100,130,0.1
6079,Poggio Montefferrato I,A,Late Bronze Age,3,-1200,-1020,180,0.01
6079,Poggio Montefferrato I,A,Early Iron Age,4,-1020,-1000,20,0.01
6080,Costa di Monteferrato I,A,Late Bronze Age,3,-1100,-1020,80,0.01
6080,Costa di Monteferrato I,A,Early Iron Age,4,-1020,-900,120,0.01
6081,Bagnol0,A,Middle Bronze Age,2,-1700,-1300,400,0.01
6081,Bagnol0,A,Late Bronze Age,3,-1300,-1020,280,0.01
6081,Bagnol0,A,Early Iron Age,4,-1020,-1000,20,0.01
6082,Il Polendone,A,Late Iron Age,5,-600,-580,20,0.01
6082,Il Polendone,A,Archaic Period,6,-580,-400,180,0.01
6083,Monte Piccioli I,A,Early Bronze Age,1,-2300,-1700,600,0.01
6083,Monte Piccioli I,A,Middle Bronze Age,2,-1700,-1300,400,0.01
6083,Monte Piccioli I,A,Late Bronze Age,3,-1300,-1020,280,0.01
6083,Monte Piccioli I,A,Early Iron Age,4,-1020,-1000,20,0.01
6084,Monte Mezzano,A,Late Bronze Age,3,-1200,-1020,180,0.1
6084,Monte Mezzano,A,Early Iron Age,4,-1020,-1000,20,0.1
6085,Poggio Monteferrato,A,Late Bronze Age,3,-1200,-1020,180,0.2
6085,Poggio Monteferrato,A,Early Iron Age,4,-1020,-1000,20,0.2
6085,Poggio Monteferrato,B,Archaic Period,6,-400,-350,50,0.2
6085,Poggio Monteferrato,B,Republican Period,7,-350,-100,250,0.2
6085,Poggio Monteferrato,C,Early Imperial Period,8,0,100,100,0.2
6085,Poggio Monteferrato,C,Mid-Imperial Period,9,100,300,200,0.2
6085,Poggio Monteferrato,C,Late Imperial Period,10,300,500,200,0.2
6086,Poggio Monteferrato IV,A,Late Bronze Age,3,-1200,-1020,180,0.01
6086,Poggio Monteferrato IV,A,Early Iron Age,4,-1020,-1000,20,0.01
6086,Poggio Monteferrato IV,B,Late Iron Age,5,-600,-580,20,0.01
6086,Poggio Monteferrato IV,B,Archaic Period,6,-580,-350,230,0.01
6086,Poggio Monteferrato IV,B,Republican Period,7,-350,-100,250,0.01
6087,Casa Monteferrato,A,Late Bronze Age,3,-1200,-1020,180,0.1
6087,Casa Monteferrato,A,Early Iron Age,4,-1020,-1000,20,0.1
6088,Figline I,A,Late Bronze Age,3,-1200,-1020,180,0.01
6088,Figline I,A,Early Iron Age,4,-1020,-1000,20,0.01
6089,Villa Nazzetti,A,Mid-Imperial Period,9,200,300,100,0.01
6089,Villa Nazzetti,A,Late Imperial Period,10,300,400,100,0.01
6090,Galcetello,A,Middle Bronze Age,2,-1700,-1300,400,0.01
6090,Galcetello,A,Late Bronze Age,3,-1300,-1020,280,0.1
6090,Galcetello,A,Early Iron Age,4,-1020,-1000,20,0.1
6091,Galcetello,A,Early Bronze Age,1,-2300,-1700,600,0.01
6091,Galcetello,B,Late Bronze Age,3,-1200,-1020,180,0.01
6091,Galcetello,B,Early Iron Age,4,-1020,-1000,20,0.01
6091,Galcetello,C,Early Imperial Period,8,-30,100,130,0.01
6091,Galcetello,C,Mid-Imperial Period,9,100,300,200,0.01
6091,Galcetello,C,Late Imperial Period,10,300,500,200,0.01
6092,Galcetello,A,Early Bronze Age,1,-2300,-1700,600,0.01
6093,Costa di Monteferrato II,A,Middle Bronze Age,2,-1700,-1300,400,0.01
6093,Costa di Monteferrato II,A,Late Bronze Age,3,-1300,-1020,280,0.01
6093,Costa di Monteferrato II,A,Early Iron Age,4,-1020,-1000,20,0.01
6094,Borro di Galceti,A,Late Bronze Age,3,-1200,-1020,180,0.01
6094,Borro di Galceti,A,Early Iron Age,4,-1020,-750,270,0.01
6094,Borro di Galceti,A,Late Iron Age,5,-750,-580,170,0.01
6094,Borro di Galceti,A,Archaic Period,6,-580,-350,230,0.01
6094,Borro di Galceti,A,Republican Period,7,-350,-30,320,0.01
6094,Borro di Galceti,A,Early Imperial Period,8,-30,100,130,0.01
6094,Borro di Galceti,A,Mid-Imperial Period,9,100,300,200,0.01
6094,Borro di Galceti,A,Late Imperial Period,10,300,500,200,0.01
6094,Borro di Galceti,A,Late Antique Period,11,500,800,300,0.01
6095,Galceti IV,A,Early Bronze Age,1,-2300,-1700,600,0.01
6095,Galceti IV,A,Middle Bronze Age,2,-1700,-1300,400,0.01
6095,Galceti IV,A,Late Bronze Age,3,-1300,-1020,280,0.01
6095,Galceti IV,A,Early Iron Age,4,-1020,-1000,20,0.01
6096,Galceti,A,Early Bronze Age,1,-2300,-1700,600,0.01
6096,Galceti,A,Late Bronze Age,3,-1300,-1020,280,0.01
6096,Galceti,A,Early Iron Age,4,-1020,-1000,20,0.01
6097,Poggio Alto,A,Early Imperial Period,8,0,100,100,0.1
6097,Poggio Alto,A,Mid-Imperial Period,9,100,200,100,0.1
6098,Le Lastre,A,Early Imperial Period,8,0,100,100,0.029999999
6098,Le Lastre,A,Mid-Imperial Period,9,100,200,100,0.029999999
6099,Coiano,A,Early Bronze Age,1,-2300,-1700,600,0.01
6100,Sant'Ippolito in Piazzanese,A,Early Imperial Period,8,0,100,100,0.01
6100,Sant'Ippolito in Piazzanese,A,Mid-Imperial Period,9,100,300,200,0.01
6100,Sant'Ippolito in Piazzanese,A,Late Imperial Period,10,300,500,200,0.01
6102,Casa Briganti,A,Late Bronze Age,3,-1200,-1020,180,0.1
6102,Casa Briganti,A,Early Iron Age,4,-1020,-750,270,0.1
6102,Casa Briganti,A,Late Iron Age,5,-750,-580,170,0.1
6102,Casa Briganti,A,Archaic Period,6,-580,-350,230,0.1
6102,Casa Briganti,A,Republican Period,7,-350,-30,320,0.1
6102,Casa Briganti,A,Early Imperial Period,8,-30,100,130,0.1
6102,Casa Briganti,A,Mid-Imperial Period,9,100,300,200,0.1
6102,Casa Briganti,A,Late Imperial Period,10,300,500,200,0.1
6103,Casa delle Selve di Sopra,A,Late Iron Age,5,-600,-580,20,0.01
6103,Casa delle Selve di Sopra,A,Archaic Period,6,-580,-350,230,0.01
6103,Casa delle Selve di Sopra,A,Republican Period,7,-350,-30,320,0.01
6103,Casa delle Selve di Sopra,A,Early Imperial Period,8,-30,100,130,0.01
6103,Casa delle Selve di Sopra,A,Mid-Imperial Period,9,100,300,200,0.01
6103,Casa delle Selve di Sopra,A,Late Imperial Period,10,300,500,200,0.01
6105,La Retaia,A,Late Iron Age,5,-600,-580,20,0.30000001
6105,La Retaia,A,Archaic Period,6,-580,-400,180,0.30000001
6106,Villa San Leonardo al Palco,A,Republican Period,7,-300,-30,270,0.050000001
6106,Villa San Leonardo al Palco,A,Early Imperial Period,8,-30,100,130,0.050000001
6107,Palco di Sotto,A,Archaic Period,6,-400,-350,50,0.01
6107,Palco di Sotto,A,Republican Period,7,-350,-30,320,0.01
6107,Palco di Sotto,A,Early Imperial Period,8,-30,100,130,0.01
6107,Palco di Sotto,A,Mid-Imperial Period,9,100,300,200,0.01
6107,Palco di Sotto,A,Late Imperial Period,10,300,500,200,0.01
6108,La Pieta',A,Late Iron Age,5,-600,-580,20,0.1
6108,La Pieta',A,Archaic Period,6,-580,-400,180,0.1
6108,La Pieta',B,Republican Period,7,-300,-30,270,0.1
6108,La Pieta',B,Early Imperial Period,8,-30,100,130,0.1
6108,La Pieta',B,Mid-Imperial Period,9,100,300,200,0.1
6108,La Pieta',B,Late Imperial Period,10,300,400,100,0.1
6109,Filettole,A,Middle Bronze Age,2,-1700,-1300,400,0.01
6109,Filettole,A,Late Bronze Age,3,-1300,-1020,280,0.01
6109,Filettole,A,Early Iron Age,4,-1020,-1000,20,0.01
6112,Villa Poggi Banchieri,A,Late Iron Age,5,-600,-580,20,0.01
6112,Villa Poggi Banchieri,A,Archaic Period,6,-580,-400,180,0.01
6112,Villa Poggi Banchieri,B,Republican Period,7,-100,-30,70,0.01
6112,Villa Poggi Banchieri,B,Early Imperial Period,8,-30,100,130,0.01
6112,Villa Poggi Banchieri,B,Mid-Imperial Period,9,100,300,200,0.01
6112,Villa Poggi Banchieri,B,Late Imperial Period,10,300,500,200,0.01
6113,Villa Scarselli,A,Early Imperial Period,8,0,100,100,0.1
6113,Villa Scarselli,A,Mid-Imperial Period,9,100,300,200,0.1
6113,Villa Scarselli,A,Late Imperial Period,10,300,400,100,0.1
6114,Gonfienti,A,Late Iron Age,5,-600,-580,20,15.149199
6114,Gonfienti,A,Archaic Period,6,-580,-400,180,15.149199
6115,Gonfienti,A,Early Imperial Period,8,0,100,100,0.66850471
6115,Gonfienti,A,Mid-Imperial Period,9,100,300,200,0.66850471
6116,Gonfienti,A,Middle Bronze Age,2,-1700,-1300,400,0.5
6117,Spazzavento,A,Late Iron Age,5,-600,-580,20,0.1
6117,Spazzavento,A,Archaic Period,6,-580,-350,230,0.1
6117,Spazzavento,A,Republican Period,7,-350,-300,50,0.1
6118,Monte Pietramarina,A,Late Iron Age,5,-650,-580,70,1.9939055
6118,Monte Pietramarina,A,Archaic Period,6,-580,-350,230,1.9939055
6118,Monte Pietramarina,A,Republican Period,7,-350,-100,250,1.9939055
6119,Comeana,A,Late Iron Age,5,-600,-580,20,0.1
6119,Comeana,A,Archaic Period,6,-580,-350,230,0.1
6119,Comeana,A,Republican Period,7,-350,-100,250,0.1
6120,Villa di Artimino,A,Late Iron Age,5,-600,-580,20,4.6130772
6120,Villa di Artimino,A,Archaic Period,6,-580,-350,230,4.6130772
6120,Villa di Artimino,B,Republican Period,7,-350,-30,320,4.6130772
6121,Prato Rosello I,A,Late Iron Age,5,-600,-580,20,0.1
6121,Prato Rosello I,A,Archaic Period,6,-580,-350,230,0.1
6121,Prato Rosello I,A,Republican Period,7,-350,-100,250,0.1
6122,Prato Rosello III,A,Late Iron Age,5,-650,-580,70,0.1
6122,Prato Rosello III,A,Archaic Period,6,-580,-550,30,0.1
6123,Prato Rosello IV,A,Late Iron Age,5,-600,-580,20,0.01
6123,Prato Rosello IV,A,Archaic Period,6,-580,-400,180,0.01
6125,Pianarola,A,Republican Period,7,-200,-30,170,0.24807315
6126,Ara della Trecca,A,Mid-Imperial Period,9,100,300,200,1.177953
6127,Pontone Sevignano,A,Republican Period,7,-200,-30,170,0.39468479
6127,Pontone Sevignano,A,Early Imperial Period,8,-30,100,130,0.39468479
6127,Pontone Sevignano,A,Mid-Imperial Period,9,100,300,200,0.39468479
6127,Pontone Sevignano,A,Late Imperial Period,10,300,500,200,0.39468479
6128,Pontone della Noce,A,Middle Bronze Age,2,-1700,-1300,400,0.20227847
6129,Ara della Trecca,A,Mid-Imperial Period,9,100,200,100,0.424099
6130,Pontone Sevignano,A,Republican Period,7,-100,-30,70,0.25819483
6130,Pontone Sevignano,A,Early Imperial Period,8,-30,100,130,0.25819483
6131,Ara della Trecca,A,Republican Period,7,-200,-30,170,0.23756891
6131,Ara della Trecca,A,Early Imperial Period,8,-30,100,130,0.23756891
6131,Ara della Trecca,A,Mid-Imperial Period,9,100,300,200,0.23756891
6131,Ara della Trecca,A,Late Imperial Period,10,300,500,200,0.23756891
6132,Selvasecca,A,Republican Period,7,-300,-30,270,0.62179339
6132,Selvasecca,A,Early Imperial Period,8,-30,100,130,0.62179339
6132,Selvasecca,A,Mid-Imperial Period,9,100,300,200,0.62179339
6132,Selvasecca,A,Late Imperial Period,10,300,500,200,0.62179339
6133,Ara della Trecca,A,Republican Period,7,-300,-30,270,0.3612532
6133,Ara della Trecca,A,Early Imperial Period,8,-30,100,130,0.3612532
6133,Ara della Trecca,A,Mid-Imperial Period,9,100,300,200,0.3612532
6133,Ara della Trecca,A,Late Imperial Period,10,300,500,200,0.3612532
6134,Selvasecca,A,Republican Period,7,-300,-30,270,0.19898167
6134,Selvasecca,A,Early Imperial Period,8,-30,100,130,0.19898167
6134,Selvasecca,A,Mid-Imperial Period,9,100,300,200,0.19898167
6134,Selvasecca,A,Late Imperial Period,10,300,500,200,0.19898167
6135,Capareccia,A,Early Bronze Age,1,-2300,-1700,600,0.27964965
6135,Capareccia,A,Middle Bronze Age,2,-1700,-1300,400,0.27964965
6135,Capareccia,A,Late Bronze Age,3,-1300,-1020,280,0.27964965
6135,Capareccia,A,Early Iron Age,4,-1020,-1000,20,0.27964965
6135,Capareccia,B,Late Iron Age,5,-700,-580,120,0.27964965
6135,Capareccia,B,Archaic Period,6,-580,-350,230,0.27964965
6135,Capareccia,B,Republican Period,7,-350,-300,50,0.27964965
6136,,A,Republican Period,7,-300,-30,270,0.2317681
6136,,A,Early Imperial Period,8,-30,100,130,0.2317681
6136,,A,Mid-Imperial Period,9,100,300,200,0.2317681
6136,,A,Late Imperial Period,10,300,500,200,0.2317681
6137,,A,Republican Period,7,-200,-30,170,0.23844376
6137,,A,Early Imperial Period,8,-30,100,130,0.23844376
6138,,A,Mid-Imperial Period,9,200,300,100,0.31454843
6138,,A,Late Imperial Period,10,300,500,200,0.31454843
6139,,A,Late Iron Age,5,-700,-580,120,0.25991935
6139,,A,Archaic Period,6,-580,-350,230,0.25991935
6139,,A,Republican Period,7,-350,-30,320,0.25991935
6140,,A,Republican Period,7,-300,-30,270,0.29429096
6140,,A,Early Imperial Period,8,-30,100,130,0.29429096
6141,,A,Early Imperial Period,8,-30,100,130,0.10572959
6141,,A,Mid-Imperial Period,9,100,300,200,0.10572959
6141,,A,Late Imperial Period,10,300,500,200,0.10572959
6142,,A,Republican Period,7,-300,-30,270,0.24023268
6142,,A,Early Imperial Period,8,-30,100,130,0.24023268
6143,Casentile,A,Republican Period,7,-200,-30,170,2.3013847
6143,Casentile,A,Early Imperial Period,8,-30,100,130,2.3013847
6143,Casentile,A,Mid-Imperial Period,9,100,300,200,2.3013847
6143,Casentile,A,Late Imperial Period,10,300,500,200,2.3013847
6144,La Stora,A,Early Bronze Age,1,-2300,-1700,600,0.20603941
6144,La Stora,B,Late Iron Age,5,-700,-580,120,0.20603941
6144,La Stora,B,Archaic Period,6,-580,-350,230,0.20603941
6144,La Stora,B,Republican Period,7,-350,-300,50,0.20603941
6145,,A,Late Iron Age,5,-700,-580,120,1.1907532
6145,,A,Archaic Period,6,-580,-350,230,1.1907532
6145,,A,Republican Period,7,-350,-300,50,1.1907532
6146,,A,Republican Period,7,-300,-30,270,0.31565753
6146,,A,Early Imperial Period,8,-30,100,130,0.31565753
6146,,A,Mid-Imperial Period,9,100,300,200,0.31565753
6146,,A,Late Imperial Period,10,300,500,200,0.31565753
6147,Pian de Crette,A,Late Bronze Age,3,-1200,-1020,180,1.4389994
6147,Pian de Crette,A,Early Iron Age,4,-1020,-1000,20,1.4389994
6147,Pian de Crette,B,Republican Period,7,-250,-30,220,1.4389994
6147,Pian de Crette,B,Early Imperial Period,8,-30,100,130,1.4389994
6147,Pian de Crette,B,Mid-Imperial Period,9,100,300,200,1.4389994
6147,Pian de Crette,B,Late Imperial Period,10,300,400,100,1.4389994
6148,Pian della Dogana,A,Late Iron Age,5,-700,-600,100,0.56051904
6148,Pian della Dogana,B,Mid-Imperial Period,9,200,300,100,0.56051904
6148,Pian della Dogana,B,Late Imperial Period,10,300,400,100,0.56051904
6149,,A,Early Bronze Age,1,-2300,-1700,600,0.19040143
6149,,A,Middle Bronze Age,2,-1700,-1300,400,0.19040143
6149,,A,Late Bronze Age,3,-1300,-1020,280,0.19040143
6149,,A,Early Iron Age,4,-1020,-1000,20,0.19040143
6150,Valle Vergine,A,Republican Period,7,-100,-30,70,0.27313378
6150,Valle Vergine,A,Early Imperial Period,8,-30,100,130,0.27313378
6150,Valle Vergine,A,Mid-Imperial Period,9,100,300,200,0.27313378
6150,Valle Vergine,A,Late Imperial Period,10,300,400,100,0.27313378
6151,,A,Republican Period,7,-300,-100,200,0.13618878
6152,,A,Late Iron Age,5,-700,-600,100,0.21551614
6153,,A,Republican Period,7,-100,-30,70,0.23994684
6153,,A,Early Imperial Period,8,-30,100,130,0.23994684
6154,,A,Republican Period,7,-100,-30,70,0.23992702
6154,,A,Early Imperial Period,8,-30,100,130,0.23992702
6155,Pallucoleto,A,Republican Period,7,-200,-30,170,0.46883175
6155,Pallucoleto,B,Mid-Imperial Period,9,100,300,200,0.46883175
6155,Pallucoleto,B,Late Imperial Period,10,300,400,100,0.46883175
6156,,A,Republican Period,7,-200,-30,170,1.0794357
6156,,A,Early Imperial Period,8,-30,100,130,1.0794357
6156,,A,Mid-Imperial Period,9,100,300,200,1.0794357
6156,,A,Late Imperial Period,10,300,500,200,1.0794357
6157,,A,Republican Period,7,-200,-30,170,0.3210955
6157,,A,Early Imperial Period,8,-30,100,130,0.3210955
6158,Ara del Lamaccio,A,Late Iron Age,5,-700,-600,100,0.20397329
6158,Ara del Lamaccio,B,Republican Period,7,-100,-30,70,0.20397329
6158,Ara del Lamaccio,B,Early Imperial Period,8,-30,100,130,0.20397329
6158,Ara del Lamaccio,C,Late Imperial Period,10,300,400,100,0.20397329
6159,Ara della Vecchia,A,Republican Period,7,-100,-30,70,0.50059092
6159,Ara della Vecchia,A,Early Imperial Period,8,-30,100,130,0.50059092
6159,Ara della Vecchia,A,Mid-Imperial Period,9,100,300,200,0.50059092
6159,Ara della Vecchia,A,Late Imperial Period,10,300,500,200,0.50059092
6160,S. Giovenale,A,Middle Bronze Age,2,-1700,-1300,400,0.26025295
6160,S. Giovenale,A,Late Bronze Age,3,-1300,-1020,280,3.8693528
6160,S. Giovenale,A,Early Iron Age,4,-1020,-1000,20,3.8693528
6160,S. Giovenale,B,Late Iron Age,5,-700,-580,120,3.8693528
6160,S. Giovenale,B,Archaic Period,6,-580,-350,230,3.8693528
6160,S. Giovenale,B,Republican Period,7,-350,-250,100,3.8693528
6161,Vignale,A,Republican Period,7,-100,-30,70,0.23640192
6161,Vignale,A,Early Imperial Period,8,-30,100,130,0.23640192
6161,Vignale,A,Mid-Imperial Period,9,100,200,100,0.23640192
6161,Vignale,B,Late Imperial Period,10,300,400,100,0.23640192
6162,Piano delle Pareti,A,Republican Period,7,-100,-30,70,0.49216014
6162,Piano delle Pareti,A,Early Imperial Period,8,-30,100,130,0.49216014
6162,Piano delle Pareti,A,Mid-Imperial Period,9,100,300,200,0.49216014
6162,Piano delle Pareti,A,Late Imperial Period,10,300,400,100,0.49216014
6163,Vignale,A,Late Iron Age,5,-700,-580,120,0.22360702
6163,Vignale,A,Archaic Period,6,-580,-350,230,0.22360702
6163,Vignale,A,Republican Period,7,-350,-300,50,0.22360702
6164,Macchia Nuova,A,Early Imperial Period,8,0,100,100,0.66383058
6164,Macchia Nuova,A,Mid-Imperial Period,9,100,200,100,0.66383058
6165,Fammilume,A,Republican Period,7,-300,-30,270,0.36764464
6165,Fammilume,A,Early Imperial Period,8,-30,100,130,0.36764464
6165,Fammilume,A,Mid-Imperial Period,9,100,300,200,0.36764464
6165,Fammilume,A,Late Imperial Period,10,300,500,200,0.36764464
6166,Vignale,A,Republican Period,7,-300,-30,270,0.3207922
6166,Vignale,A,Early Imperial Period,8,-30,100,130,0.3207922
6166,Vignale,A,Mid-Imperial Period,9,100,300,200,0.3207922
6166,Vignale,A,Late Imperial Period,10,300,500,200,0.3207922
6167,Casale Vignale,A,Mid-Imperial Period,9,200,300,100,0.13479044
6167,Casale Vignale,A,Late Imperial Period,10,300,400,100,0.13479044
6168,,A,Late Imperial Period,10,300,400,100,0.21114776
6169,Macchia Nuova,A,Republican Period,7,-300,-30,270,0.55338413
6169,Macchia Nuova,A,Early Imperial Period,8,-30,100,130,0.55338413
6169,Macchia Nuova,A,Mid-Imperial Period,9,100,300,200,0.55338413
6169,Macchia Nuova,A,Late Imperial Period,10,300,500,200,0.55338413
6170,Casale Vignale,A,Late Iron Age,5,-600,-580,20,0.20237777
6170,Casale Vignale,A,Archaic Period,6,-580,-400,180,0.20237777
6170,Casale Vignale,B,Republican Period,7,-300,-30,270,1.7398847
6170,Casale Vignale,B,Early Imperial Period,8,-30,100,130,1.7398847
6170,Casale Vignale,B,Mid-Imperial Period,9,100,300,200,1.7398847
6170,Casale Vignale,B,Late Imperial Period,10,300,500,200,1.7398847
6171,,A,Late Iron Age,5,-700,-580,120,0.26497731
6171,,A,Archaic Period,6,-580,-500,80,0.26497731
6171,,B,Republican Period,7,-300,-30,270,0.26497731
6171,,B,Early Imperial Period,8,-30,100,130,0.26497731
6171,,B,Mid-Imperial Period,9,100,200,100,0.26497731
6172,Macchia Nuova,A,Republican Period,7,-300,-30,270,0.12671679
6172,Macchia Nuova,A,Early Imperial Period,8,-30,100,130,0.12671679
6172,Macchia Nuova,A,Mid-Imperial Period,9,100,300,200,0.12671679
6172,Macchia Nuova,A,Late Imperial Period,10,300,500,200,0.12671679
6173,,A,Republican Period,7,-300,-30,270,0.19254096
6173,,A,Early Imperial Period,8,-30,100,130,0.19254096
6173,,A,Mid-Imperial Period,9,100,300,200,0.19254096
6173,,A,Late Imperial Period,10,300,500,200,0.19254096
6174,Ripa Rossa,A,Republican Period,7,-200,-30,170,0.70450252
6174,Ripa Rossa,A,Early Imperial Period,8,-30,100,130,0.70450252
6174,Ripa Rossa,A,Mid-Imperial Period,9,100,300,200,0.70450252
6174,Ripa Rossa,A,Late Imperial Period,10,300,500,200,0.70450252
6175,Il Comunaletto,A,Early Imperial Period,8,0,100,100,0.50229543
6175,Il Comunaletto,A,Mid-Imperial Period,9,100,200,100,0.50229543
6175,Il Comunaletto,B,Late Imperial Period,10,300,500,200,0.50229543
6176,La Banditella,A,Republican Period,7,-300,-30,270,0.40082267
6176,La Banditella,A,Early Imperial Period,8,-30,100,130,0.40082267
6176,La Banditella,A,Mid-Imperial Period,9,100,300,200,0.40082267
6176,La Banditella,A,Late Imperial Period,10,300,500,200,0.40082267
6177,Castellina di Giacinto,A,Late Bronze Age,3,-1300,-1020,280,0.54395247
6177,Castellina di Giacinto,A,Early Iron Age,4,-1020,-1000,20,0.54395247
6178,Cupellaro,A,Middle Bronze Age,2,-1500,-1300,200,0.15196732
6178,Cupellaro,B,Late Iron Age,5,-700,-600,100,0.15196732
6179,La Banditella,A,Republican Period,7,-300,-30,270,0.4466221
6179,La Banditella,A,Early Imperial Period,8,-30,100,130,0.4466221
6179,La Banditella,A,Mid-Imperial Period,9,100,300,200,0.4466221
6180,Portaventacola,A,Republican Period,7,-100,-30,70,0.34940299
6180,Portaventacola,A,Early Imperial Period,8,-30,100,130,0.34940299
6180,Portaventacola,A,Mid-Imperial Period,9,100,300,200,0.34940299
6180,Portaventacola,A,Late Imperial Period,10,300,400,100,0.34940299
6181,Casaline/Arda,A,Republican Period,7,-200,-30,170,0.53044301
6181,Casaline/Arda,A,Early Imperial Period,8,-30,100,130,0.53044301
6181,Casaline/Arda,A,Mid-Imperial Period,9,100,200,100,0.53044301
6182,Ara del Morto,A,Early Imperial Period,8,0,100,100,0.28204346
6183,Guinze San Bingio,A,Republican Period,7,-300,-30,270,0.71392804
6183,Guinze San Bingio,A,Early Imperial Period,8,-30,100,130,0.71392804
6183,Guinze San Bingio,A,Mid-Imperial Period,9,100,300,200,0.71392804
6183,Guinze San Bingio,A,Late Imperial Period,10,300,500,200,0.71392804
6184,Guinze San Bingio,A,Republican Period,7,-300,-30,270,0.22193304
6184,Guinze San Bingio,A,Early Imperial Period,8,-30,100,130,0.22193304
6184,Guinze San Bingio,A,Mid-Imperial Period,9,100,300,200,0.22193304
6184,Guinze San Bingio,A,Late Imperial Period,10,300,500,200,0.22193304
6185,Fontana Murata/Fontana Vangata,A,Early Bronze Age,1,-2300,-1700,600,0.24318609
6185,Fontana Murata/Fontana Vangata,A,Middle Bronze Age,2,-1700,-1300,400,0.24318609
6185,Fontana Murata/Fontana Vangata,A,Late Bronze Age,3,-1300,-1020,280,0.24318609
6185,Fontana Murata/Fontana Vangata,A,Early Iron Age,4,-1020,-1000,20,0.24318609
6185,Fontana Murata/Fontana Vangata,B,Late Iron Age,5,-700,-580,120,0.24318609
6185,Fontana Murata/Fontana Vangata,B,Archaic Period,6,-580,-500,80,0.24318609
6185,Fontana Murata/Fontana Vangata,C,Republican Period,7,-100,-30,70,0.24318609
6185,Fontana Murata/Fontana Vangata,C,Early Imperial Period,8,-30,100,130,0.24318609
6185,Fontana Murata/Fontana Vangata,C,Mid-Imperial Period,9,100,300,200,0.24318609
6185,Fontana Murata/Fontana Vangata,C,Late Imperial Period,10,300,500,200,0.24318609
6186,Petrola/Cantinaccio,A,Late Iron Age,5,-700,-580,120,0.58406508
6186,Petrola/Cantinaccio,A,Archaic Period,6,-580,-500,80,0.58406508
6186,Petrola/Cantinaccio,B,Republican Period,7,-200,-30,170,0.58406508
6186,Petrola/Cantinaccio,B,Early Imperial Period,8,-30,100,130,0.58406508
6186,Petrola/Cantinaccio,B,Mid-Imperial Period,9,100,300,200,0.58406508
6186,Petrola/Cantinaccio,B,Late Imperial Period,10,300,500,200,0.58406508
6187,Bandita delle More,A,Republican Period,7,-300,-30,270,0.32155645
6187,Bandita delle More,A,Early Imperial Period,8,-30,100,130,0.32155645
6187,Bandita delle More,A,Mid-Imperial Period,9,100,300,200,0.32155645
6187,Bandita delle More,A,Late Imperial Period,10,300,500,200,0.32155645
6188,Poggio Ventacolo,A,Republican Period,7,-300,-30,270,0.36968991
6188,Poggio Ventacolo,A,Early Imperial Period,8,-30,100,130,0.36968991
6188,Poggio Ventacolo,A,Mid-Imperial Period,9,100,300,200,0.36968991
6188,Poggio Ventacolo,A,Late Imperial Period,10,300,500,200,0.36968991
6189,Chiesaccia,A,Republican Period,7,-300,-30,270,0.257938
6189,Chiesaccia,A,Early Imperial Period,8,-30,100,130,0.257938
6189,Chiesaccia,A,Mid-Imperial Period,9,100,300,200,0.257938
6189,Chiesaccia,A,Late Imperial Period,10,300,500,200,0.257938
6190,Bandita delle More/Campicciolo,A,Republican Period,7,-100,-30,70,0.21794409
6190,Bandita delle More/Campicciolo,A,Early Imperial Period,8,-30,100,130,0.21794409
6191,Bandita delle More,A,Republican Period,7,-200,-30,170,0.190247
6191,Bandita delle More,B,Late Imperial Period,10,300,500,200,0.190247
6191,Bandita delle More,B,Late Antique Period,11,500,600,100,0.190247
6192,Muraccioli,A,Early Imperial Period,8,-30,100,130,0.23534557
6193,,A,Early Imperial Period,8,-30,100,130,0.60965747
6193,,A,Mid-Imperial Period,9,100,300,200,0.60965747
6193,,A,Late Imperial Period,10,300,500,200,0.60965747
6194,Sgrulla,A,Republican Period,7,-100,-30,70,0.37477693
6194,Sgrulla,A,Early Imperial Period,8,-30,100,130,0.37477693
6195,Macchia della Banditella,A,Late Iron Age,5,-700,-580,120,0.27056894
6195,Macchia della Banditella,A,Archaic Period,6,-580,-350,230,0.27056894
6195,Macchia della Banditella,A,Republican Period,7,-350,-300,50,0.27056894
6195,Macchia della Banditella,B,Early Imperial Period,8,0,100,100,0.27056894
6195,Macchia della Banditella,B,Mid-Imperial Period,9,100,200,100,0.27056894
6196,Monte Regolano,A,Republican Period,7,-300,-30,270,0.32329419
6196,Monte Regolano,A,Early Imperial Period,8,-30,100,130,0.32329419
6196,Monte Regolano,A,Mid-Imperial Period,9,100,300,200,0.32329419
6196,Monte Regolano,A,Late Imperial Period,10,300,500,200,0.32329419
6197,Fontanile Tirintera,A,Mid-Imperial Period,9,100,250,150,0.72693729
6198,S. Antonio,A,Republican Period,7,-300,-30,270,0.36488804
6198,S. Antonio,A,Early Imperial Period,8,-30,100,130,0.36488804
6198,S. Antonio,A,Mid-Imperial Period,9,100,300,200,0.36488804
6198,S. Antonio,A,Late Imperial Period,10,300,500,200,0.36488804
6199,Monte S. Stefano,A,Republican Period,7,-300,-30,270,0.25014663
6199,Monte S. Stefano,A,Early Imperial Period,8,-30,100,130,0.25014663
6199,Monte S. Stefano,A,Mid-Imperial Period,9,100,300,200,0.25014663
6199,Monte S. Stefano,A,Late Imperial Period,10,300,500,200,0.25014663
6200,Latignana,A,Early Imperial Period,8,-30,100,130,0.24662045
6200,Latignana,A,Mid-Imperial Period,9,100,300,200,0.24662045
6200,Latignana,A,Late Imperial Period,10,300,400,100,0.24662045
6201,Latignana,A,Late Iron Age,5,-700,-580,120,0.25656781
6201,Latignana,A,Archaic Period,6,-580,-350,230,0.25656781
6201,Latignana,B,Republican Period,7,-350,-30,320,0.25656781
6201,Latignana,B,Early Imperial Period,8,-30,100,130,0.25656781
6201,Latignana,B,Mid-Imperial Period,9,100,300,200,0.25656781
6201,Latignana,B,Late Imperial Period,10,300,400,100,0.25656781
6202,Terrenuovo,A,Republican Period,7,-300,-30,270,0.6339184
6202,Terrenuovo,A,Early Imperial Period,8,-30,100,130,0.6339184
6202,Terrenuovo,A,Mid-Imperial Period,9,100,300,200,0.6339184
6202,Terrenuovo,A,Late Imperial Period,10,300,500,200,0.6339184
6203,Costone del Castellaccio,A,Late Iron Age,5,-700,-580,120,0.16926059
6203,Costone del Castellaccio,A,Archaic Period,6,-580,-350,230,0.16926059
6203,Costone del Castellaccio,A,Republican Period,7,-350,-300,50,0.16926059
6203,Costone del Castellaccio,B,Early Imperial Period,8,-30,100,130,0.16926059
6204,Costone del Castellaccio,A,Archaic Period,6,-550,-350,200,0.23499753
6204,Costone del Castellaccio,A,Republican Period,7,-350,-300,50,0.23499753
6205,Il Marano,A,Republican Period,7,-300,-30,270,0.25874221
6205,Il Marano,A,Early Imperial Period,8,-30,100,130,0.25874221
6205,Il Marano,A,Mid-Imperial Period,9,100,200,100,0.25874221
6206,Lampregnana,A,Middle Bronze Age,2,-1500,-1300,200,1.0288448
6206,Lampregnana,A,Late Bronze Age,3,-1300,-1020,280,1.0288448
6206,Lampregnana,A,Early Iron Age,4,-1020,-750,270,1.0288448
6206,Lampregnana,A,Late Iron Age,5,-750,-580,170,1.1463417
6206,Lampregnana,A,Archaic Period,6,-580,-350,230,1.1463417
6206,Lampregnana,A,Republican Period,7,-350,-30,320,1.1444908
6206,Lampregnana,A,Early Imperial Period,8,-30,100,130,1.0288448
6206,Lampregnana,A,Mid-Imperial Period,9,100,300,200,1.0288448
6206,Lampregnana,A,Late Imperial Period,10,300,500,200,1.0288448
6207,Pian Fagiano,A,Late Iron Age,5,-700,-580,120,0.36913025
6207,Pian Fagiano,A,Archaic Period,6,-580,-500,80,0.36913025
6207,Pian Fagiano,B,Republican Period,7,-300,-30,270,0.36913025
6207,Pian Fagiano,C,Mid-Imperial Period,9,100,300,200,0.36913025
6208,Il Marano,A,Late Iron Age,5,-700,-580,120,0.20084493
6208,Il Marano,A,Archaic Period,6,-580,-350,230,0.20084493
6208,Il Marano,A,Republican Period,7,-350,-300,50,0.20084493
6208,Il Marano,B,Early Imperial Period,8,-30,100,130,0.20084493
6208,Il Marano,B,Mid-Imperial Period,9,100,300,200,0.20084493
6209,Ara del Pero,A,Republican Period,7,-300,-30,270,0.43813789
6209,Ara del Pero,A,Early Imperial Period,8,-30,100,130,0.43813789
6210,Il Marano,A,Republican Period,7,-300,-30,270,0.23043798
6210,Il Marano,A,Early Imperial Period,8,-30,100,130,0.23043798
6210,Il Marano,A,Mid-Imperial Period,9,100,300,200,0.23043798
6210,Il Marano,A,Late Imperial Period,10,300,500,200,0.23043798
6211,S. Andrea/Pian di LampregnanaL,A,Late Iron Age,5,-600,-580,20,0.49270687
6211,S. Andrea/Pian di LampregnanaL,A,Archaic Period,6,-580,-400,180,0.49270687
6212,S. Andrea/Pian di LampregnanaL,A,Republican Period,7,-300,-30,270,0.12235358
6212,S. Andrea/Pian di LampregnanaL,A,Early Imperial Period,8,-30,100,130,0.12235358
6212,S. Andrea/Pian di LampregnanaL,A,Mid-Imperial Period,9,100,300,200,0.12235358
6212,S. Andrea/Pian di LampregnanaL,A,Late Imperial Period,10,300,500,200,0.12235358
6213,S. Andrea/Pian di LampregnanaL,A,Middle Bronze Age,2,-1700,-1300,400,0.22676498
6213,S. Andrea/Pian di LampregnanaL,A,Late Bronze Age,3,-1300,-1020,280,0.22676498
6213,S. Andrea/Pian di LampregnanaL,A,Early Iron Age,4,-1020,-1000,20,0.22676498
6213,S. Andrea/Pian di LampregnanaL,B,Late Iron Age,5,-700,-580,120,0.22676498
6213,S. Andrea/Pian di LampregnanaL,B,Archaic Period,6,-580,-350,230,0.22676498
6213,S. Andrea/Pian di LampregnanaL,B,Republican Period,7,-350,-300,50,0.22676498
6214,Poggio Terzolo,A,Late Iron Age,5,-700,-580,120,0.17112511
6214,Poggio Terzolo,A,Archaic Period,6,-580,-350,230,0.17112511
6214,Poggio Terzolo,A,Republican Period,7,-350,-300,50,0.17112511
6214,Poggio Terzolo,B,Mid-Imperial Period,9,150,250,100,0.17112511
6215,,A,Republican Period,7,-300,-30,270,0.72272974
6215,,A,Early Imperial Period,8,-30,0,30,0.72272974
6215,,B,Mid-Imperial Period,9,150,250,100,0.72272974
6216,Poggio Terzolo,A,Early Imperial Period,8,0,100,100,0.32756826
6216,Poggio Terzolo,A,Mid-Imperial Period,9,100,300,200,0.32756826
6217,Le Pampanare,A,Early Imperial Period,8,0,100,100,0.45545554
6218,Pontone del'Oro,A,Late Iron Age,5,-700,-580,120,0.5925566
6218,Pontone del'Oro,A,Archaic Period,6,-580,-500,80,0.5925566
6218,Pontone del'Oro,B,Republican Period,7,-300,-30,270,0.5925566
6218,Pontone del'Oro,B,Early Imperial Period,8,-30,100,130,0.5925566
6219,Macchia delle Pampanare,A,Republican Period,7,-100,-30,70,0.52128989
6219,Macchia delle Pampanare,A,Early Imperial Period,8,-30,100,130,0.52128989
6219,Macchia delle Pampanare,A,Mid-Imperial Period,9,100,300,200,0.52128989
6220,Quarto della Cammerata,A,Republican Period,7,-300,-30,270,1.3292956
6220,Quarto della Cammerata,A,Early Imperial Period,8,-30,100,130,1.3292956
6220,Quarto della Cammerata,A,Mid-Imperial Period,9,100,300,200,1.3292956
6220,Quarto della Cammerata,A,Late Imperial Period,10,300,500,200,1.3292956
6221,Pontone delle Macine,A,Early Imperial Period,8,-30,100,130,0.44663382
6221,Pontone delle Macine,A,Mid-Imperial Period,9,100,300,200,0.44663382
6222,Riverse,A,Late Iron Age,5,-600,-580,20,0.2062043
6222,Riverse,A,Archaic Period,6,-580,-500,80,0.2062043
6223,Casale delle Riverse,A,Republican Period,7,-100,-30,70,0.53505832
6223,Casale delle Riverse,A,Early Imperial Period,8,-30,100,130,0.53505832
6223,Casale delle Riverse,A,Mid-Imperial Period,9,100,300,200,0.53505832
6223,Casale delle Riverse,A,Late Imperial Period,10,300,500,200,0.53505832
6224,Fontanile Patocco,A,Early Imperial Period,8,0,100,100,0.31962964
6224,Fontanile Patocco,A,Mid-Imperial Period,9,100,300,200,0.31962964
6225,,A,Mid-Imperial Period,9,200,300,100,0.25057122
6225,,A,Late Imperial Period,10,300,400,100,0.25057122
6226,Fontanile Vaccarecciola,A,Republican Period,7,-200,-30,170,0.80448484
6226,Fontanile Vaccarecciola,A,Early Imperial Period,8,-30,100,130,0.80448484
6226,Fontanile Vaccarecciola,A,Mid-Imperial Period,9,100,300,200,0.80448484
6226,Fontanile Vaccarecciola,A,Late Imperial Period,10,300,500,200,0.80448484
6227,Vaccarecciola/Ginestreto,A,Republican Period,7,-100,-30,70,0.47254434
6227,Vaccarecciola/Ginestreto,B,Mid-Imperial Period,9,100,200,100,0.47254434
6227,Vaccarecciola/Ginestreto,C,Late Imperial Period,10,300,500,200,0.47254434
6228,Ginestreto,A,Republican Period,7,-100,-30,70,0.21016386
6228,Ginestreto,A,Early Imperial Period,8,-30,100,130,0.21016386
6228,Ginestreto,A,Mid-Imperial Period,9,100,300,200,0.21016386
6228,Ginestreto,A,Late Imperial Period,10,300,500,200,0.21016386
6229,Civitella Cesi,A,Late Iron Age,5,-700,-580,120,1.3037184
6229,Civitella Cesi,A,Archaic Period,6,-580,-350,230,1.3037184
6229,Civitella Cesi,A,Republican Period,7,-350,-300,50,1.3037184
6230,,A,Early Imperial Period,8,0,100,100,0.26134971
6230,,A,Mid-Imperial Period,9,100,300,200,0.26134971
6230,,A,Late Imperial Period,10,300,400,100,0.26134971
6231,Fosso Scarchiolo,A,Republican Period,7,-300,-30,270,0.2316405
6231,Fosso Scarchiolo,A,Early Imperial Period,8,-30,100,130,0.2316405
6231,Fosso Scarchiolo,A,Mid-Imperial Period,9,100,300,200,0.2316405
6231,Fosso Scarchiolo,A,Late Imperial Period,10,300,500,200,0.2316405
6232,Castellia del Pidocchio,A,Archaic Period,6,-400,-350,50,0.40602228
6232,Castellia del Pidocchio,A,Republican Period,7,-350,-200,150,0.40602228
6233,,A,Late Iron Age,5,-700,-580,120,0.42032176
6233,,A,Archaic Period,6,-580,-350,230,0.42032176
6233,,B,Republican Period,7,-350,-30,320,0.42032176
6233,,B,Early Imperial Period,8,-30,100,130,0.42032176
6233,,C,Late Imperial Period,10,300,500,200,0.42032176
6234,,A,Republican Period,7,-300,-30,270,0.33458528
6234,,A,Early Imperial Period,8,-30,100,130,0.33458528
6234,,A,Mid-Imperial Period,9,100,300,200,0.33458528
6234,,A,Late Imperial Period,10,300,400,100,0.33458528
6235,Castellina Tamburina,A,Early Bronze Age,1,-2300,-1700,600,0.39520094
6235,Castellina Tamburina,A,Middle Bronze Age,2,-1700,-1300,400,0.39520094
6235,Castellina Tamburina,A,Late Bronze Age,3,-1300,-1020,280,0.39520094
6235,Castellina Tamburina,A,Early Iron Age,4,-1020,-1000,20,0.39520094
6235,Castellina Tamburina,B,Archaic Period,6,-400,-350,50,0.39520094
6235,Castellina Tamburina,B,Republican Period,7,-350,-30,320,0.39520094
6235,Castellina Tamburina,B,Early Imperial Period,8,-30,100,130,0.39520094
6235,Castellina Tamburina,B,Mid-Imperial Period,9,100,300,200,0.39520094
6236,Montelungo,A,Republican Period,7,-300,-30,270,0.20179074
6236,Montelungo,A,Early Imperial Period,8,-30,100,130,0.20179074
6236,Montelungo,A,Mid-Imperial Period,9,100,300,200,0.20179074
6236,Montelungo,A,Late Imperial Period,10,300,500,200,0.20179074
6237,Monte Grosso,A,Republican Period,7,-100,-30,70,0.48938584
6237,Monte Grosso,A,Early Imperial Period,8,-30,100,130,0.48938584
6237,Monte Grosso,A,Mid-Imperial Period,9,100,200,100,0.48938584
6238,Piaggialta,A,Early Imperial Period,8,0,100,100,1.1992036
6238,Piaggialta,A,Mid-Imperial Period,9,100,200,100,1.1992036
6238,Piaggialta,B,Late Imperial Period,10,400,500,100,1.1992036
6239,,A,Republican Period,7,-300,-30,270,0.21899647
6239,,A,Early Imperial Period,8,-30,100,130,0.21899647
6239,,A,Mid-Imperial Period,9,100,300,200,0.21899647
6239,,A,Late Imperial Period,10,300,500,200,0.21899647
6240,Piaggialta,A,Late Iron Age,5,-600,-580,20,0.26048028
6240,Piaggialta,A,Archaic Period,6,-580,-400,180,0.26048028
6241,Reale,A,Republican Period,7,-200,-30,170,1.4242022
6241,Reale,A,Early Imperial Period,8,-30,100,130,1.4242022
6241,Reale,A,Mid-Imperial Period,9,100,300,200,1.4242022
6241,Reale,A,Late Imperial Period,10,300,500,200,1.4242022
6242,Reale,A,Middle Bronze Age,2,-1700,-1500,200,0.11006226
6243,,A,Republican Period,7,-300,-30,270,0.20886953
6243,,A,Early Imperial Period,8,-30,100,130,0.20886953
6243,,A,Mid-Imperial Period,9,100,300,200,0.20886953
6243,,A,Late Imperial Period,10,300,500,200,0.20886953
6244,Monte Grosso,A,Republican Period,7,-300,-30,270,0.22005321
6244,Monte Grosso,A,Early Imperial Period,8,-30,100,130,0.22005321
6244,Monte Grosso,A,Mid-Imperial Period,9,100,300,200,0.22005321
6244,Monte Grosso,A,Late Imperial Period,10,300,500,200,0.22005321
6245,Poggio Mandrione,A,Republican Period,7,-300,-30,270,0.16137643
6245,Poggio Mandrione,A,Early Imperial Period,8,-30,100,130,0.16137643
6245,Poggio Mandrione,A,Mid-Imperial Period,9,100,300,200,0.16137643
6245,Poggio Mandrione,A,Late Imperial Period,10,300,500,200,0.16137643
6246,,A,Late Iron Age,5,-700,-580,120,0.56592375
6246,,A,Archaic Period,6,-580,-350,230,0.56592375
6246,,A,Republican Period,7,-350,-300,50,0.56592375
6246,,B,Early Imperial Period,8,-30,100,130,0.56592375
6246,,B,Mid-Imperial Period,9,100,300,200,0.56592375
6246,,B,Late Imperial Period,10,300,500,200,0.56592375
6247,Le Caseline,A,Late Imperial Period,10,350,500,150,0.23355658
6248,Le Caseline,A,Republican Period,7,-300,-30,270,0.10694868
6248,Le Caseline,A,Early Imperial Period,8,-30,100,130,0.10694868
6248,Le Caseline,A,Mid-Imperial Period,9,100,300,200,0.10694868
6248,Le Caseline,A,Late Imperial Period,10,300,500,200,0.10694868
6249,Poggio di Caccia,A,Early Imperial Period,8,0,100,100,0.27955487
6249,Poggio di Caccia,A,Mid-Imperial Period,9,100,300,200,0.27955487
6249,Poggio di Caccia,A,Late Imperial Period,10,300,500,200,0.27955487
6250,Le Stranghe,A,Early Imperial Period,8,0,100,100,0.21824233
6250,Le Stranghe,A,Mid-Imperial Period,9,100,300,200,0.21824233
6250,Le Stranghe,A,Late Imperial Period,10,300,500,200,0.21824233
6251,Poggio Cervario/Trocchi,A,Early Imperial Period,8,-30,100,130,0.20991774
6251,Poggio Cervario/Trocchi,A,Mid-Imperial Period,9,100,300,200,0.20991774
6251,Poggio Cervario/Trocchi,A,Late Imperial Period,10,300,500,200,0.20991774
6252,Poggio Cervario/Trocchi,A,Republican Period,7,-300,-30,270,0.1992234
6252,Poggio Cervario/Trocchi,A,Early Imperial Period,8,-30,100,130,0.1992234
6252,Poggio Cervario/Trocchi,A,Mid-Imperial Period,9,100,300,200,0.1992234
6252,Poggio Cervario/Trocchi,A,Late Imperial Period,10,300,500,200,0.1992234
6253,La Bandita,A,Early Imperial Period,8,-30,100,130,0.27986851
6253,La Bandita,A,Mid-Imperial Period,9,100,300,200,0.27986851
6253,La Bandita,A,Late Imperial Period,10,300,500,200,0.27986851
6254,le Pianette,A,Archaic Period,6,-400,-350,50,0.23257886
6254,le Pianette,A,Republican Period,7,-350,-30,320,0.23257886
6254,le Pianette,A,Early Imperial Period,8,-30,100,130,0.23257886
6254,le Pianette,A,Mid-Imperial Period,9,100,300,200,0.23257886
6254,le Pianette,A,Late Imperial Period,10,300,500,200,0.23257886
6255,Poggetto della Guerra,A,Early Imperial Period,8,-30,100,130,0.26814133
6255,Poggetto della Guerra,A,Mid-Imperial Period,9,100,300,200,0.26814133
6256,Costa Paganella,A,Republican Period,7,-300,-30,270,0.15977053
6256,Costa Paganella,A,Early Imperial Period,8,-30,100,130,0.15977053
6256,Costa Paganella,A,Mid-Imperial Period,9,100,300,200,0.15977053
6256,Costa Paganella,A,Late Imperial Period,10,300,500,200,0.15977053
6257,Poggetto della Guerra,A,Republican Period,7,-200,-30,170,0.29239213
6257,Poggetto della Guerra,A,Early Imperial Period,8,-30,100,130,0.29239213
6257,Poggetto della Guerra,A,Mid-Imperial Period,9,100,300,200,0.29239213
6257,Poggetto della Guerra,A,Late Imperial Period,10,300,400,100,0.29239213
6258,La Selcia,A,Late Iron Age,5,-600,-580,20,0.1814778
6258,La Selcia,A,Archaic Period,6,-580,-500,80,0.1814778
6258,La Selcia,B,Early Imperial Period,8,50,100,50,0.1814778
6259,La Selcia,A,Mid-Imperial Period,9,100,300,200,0.17017989
6260,La Selcia,A,Early Bronze Age,1,-2300,-1700,600,0.24706019
6260,La Selcia,B,Archaic Period,6,-400,-350,50,0.24706019
6260,La Selcia,C,Republican Period,7,-350,-30,320,0.24706019
6260,La Selcia,C,Early Imperial Period,8,-30,100,130,0.24706019
6260,La Selcia,C,Mid-Imperial Period,9,100,200,100,0.24706019
6261,Casale Baldone,A,Republican Period,7,-100,-30,70,0.25244161
6261,Casale Baldone,A,Early Imperial Period,8,-30,100,130,0.25244161
6261,Casale Baldone,A,Mid-Imperial Period,9,100,200,100,0.25244161
6262,Casale Baldone,A,Early Imperial Period,8,-30,100,130,0.20348017
6262,Casale Baldone,A,Mid-Imperial Period,9,100,300,200,0.20348017
6262,Casale Baldone,A,Late Imperial Period,10,300,500,200,0.20348017
6263,Poggio Fico,A,Republican Period,7,-300,-30,270,0.29421443
6263,Poggio Fico,A,Early Imperial Period,8,-30,100,130,0.29421443
6263,Poggio Fico,A,Mid-Imperial Period,9,100,300,200,0.29421443
6263,Poggio Fico,A,Late Imperial Period,10,300,500,200,0.29421443
6264,Casale Baldone,A,Republican Period,7,-100,-30,70,0.25128388
6264,Casale Baldone,A,Early Imperial Period,8,-30,100,130,0.25128388
6265,,A,Early Imperial Period,8,-30,100,130,0.38189504
6265,,A,Mid-Imperial Period,9,100,300,200,0.38189504
6265,,A,Late Imperial Period,10,300,500,200,0.38189504
6266,Monte Piantangeli,A,Early Bronze Age,1,-2300,-1700,600,0.17702979
6266,Monte Piantangeli,B,Republican Period,7,-300,-30,270,0.17702979
6266,Monte Piantangeli,B,Early Imperial Period,8,-30,100,130,0.17702979
6266,Monte Piantangeli,B,Mid-Imperial Period,9,100,300,200,0.17702979
6266,Monte Piantangeli,B,Late Imperial Period,10,300,500,200,0.17702979
6267,Monte Piantangeli,A,Early Imperial Period,8,-30,100,130,0.25601497
6267,Monte Piantangeli,A,Mid-Imperial Period,9,100,300,200,0.25601497
6267,Monte Piantangeli,A,Late Imperial Period,10,300,500,200,0.25601497
6268,Bruttino,A,Late Iron Age,5,-600,-580,20,0.52625185
6268,Bruttino,A,Archaic Period,6,-580,-500,80,0.52625185
6268,Bruttino,B,Republican Period,7,-300,-30,270,0.52625185
6268,Bruttino,B,Early Imperial Period,8,-30,100,130,0.52625185
6268,Bruttino,B,Mid-Imperial Period,9,100,300,200,0.52625185
6268,Bruttino,B,Late Imperial Period,10,300,500,200,0.52625185
6269,,A,Late Bronze Age,3,-1200,-1020,180,0.25160095
6269,,A,Early Iron Age,4,-1020,-1000,20,0.25160095
6269,,B,Late Iron Age,5,-700,-580,120,0.25160095
6269,,B,Archaic Period,6,-580,-350,230,0.25160095
6269,,B,Republican Period,7,-350,-30,320,0.25160095
6269,,B,Early Imperial Period,8,-30,100,130,0.25160095
6269,,B,Mid-Imperial Period,9,100,300,200,0.25160095
6269,,B,Late Imperial Period,10,300,500,200,0.25160095
6270,Coste del Marano,A,Late Bronze Age,3,-1200,-1020,180,0.21354432
6270,Coste del Marano,A,Early Iron Age,4,-1020,-1000,20,0.21354432
6270,Coste del Marano,B,Late Iron Age,5,-700,-580,120,0.21354432
6270,Coste del Marano,B,Archaic Period,6,-580,-350,230,0.21354432
6270,Coste del Marano,B,Republican Period,7,-350,-300,50,0.21354432
6271,Poggio Pero,A,Early Imperial Period,8,-30,100,130,0.22652091
6271,Poggio Pero,A,Mid-Imperial Period,9,100,300,200,0.22652091
6271,Poggio Pero,A,Late Imperial Period,10,300,500,200,0.22652091
6272,,A,Republican Period,7,-300,-30,270,0.26409176
6272,,A,Early Imperial Period,8,-30,100,130,0.26409176
6272,,A,Mid-Imperial Period,9,100,300,200,0.26409176
6272,,A,Late Imperial Period,10,300,500,200,0.26409176
6273,,A,Late Iron Age,5,-650,-580,70,0.25487918
6273,,A,Archaic Period,6,-580,-550,30,0.25487918
6274,Poggio Pero,A,Republican Period,7,-100,-30,70,0.31791109
6274,Poggio Pero,A,Early Imperial Period,8,-30,100,130,0.31791109
6275,Pian Cisterna,A,Late Iron Age,5,-700,-580,120,0.29801261
6275,Pian Cisterna,A,Archaic Period,6,-580,-350,230,0.29801261
6275,Pian Cisterna,A,Republican Period,7,-350,-300,50,0.29801261
6275,Pian Cisterna,B,Early Imperial Period,8,-30,100,130,0.29801261
6275,Pian Cisterna,B,Mid-Imperial Period,9,100,300,200,0.29801261
6275,Pian Cisterna,B,Late Imperial Period,10,300,500,200,0.29801261
6276,Giuinzone,A,Republican Period,7,-100,-30,70,1.620279
6276,Giuinzone,A,Early Imperial Period,8,-30,100,130,1.620279
6276,Giuinzone,A,Mid-Imperial Period,9,100,300,200,1.620279
6276,Giuinzone,A,Late Imperial Period,10,300,500,200,1.620279
6277,Poggio Pero,A,Republican Period,7,-300,-30,270,0.17503642
6277,Poggio Pero,A,Early Imperial Period,8,-30,100,130,0.17503642
6277,Poggio Pero,A,Mid-Imperial Period,9,100,300,200,0.17503642
6277,Poggio Pero,A,Late Imperial Period,10,300,500,200,0.17503642
6278,Grotta Pinza,A,Late Iron Age,5,-700,-580,120,1.0977838
6278,Grotta Pinza,A,Archaic Period,6,-580,-350,230,1.0977838
6278,Grotta Pinza,B,Republican Period,7,-350,-30,320,1.0977838
6278,Grotta Pinza,B,Early Imperial Period,8,-30,100,130,1.0977838
6279,Castellina di Gallozzo/Poggio Cieco,A,Late Iron Age,5,-700,-580,120,0.76110965
6279,Castellina di Gallozzo/Poggio Cieco,A,Archaic Period,6,-580,-350,230,0.76110965
6279,Castellina di Gallozzo/Poggio Cieco,B,Republican Period,7,-350,-30,320,0.76110965
6279,Castellina di Gallozzo/Poggio Cieco,B,Early Imperial Period,8,-30,100,130,0.76110965
6279,Castellina di Gallozzo/Poggio Cieco,B,Mid-Imperial Period,9,100,300,200,0.76110965
6279,Castellina di Gallozzo/Poggio Cieco,B,Late Imperial Period,10,300,500,200,0.76110965
6280,,A,Republican Period,7,-300,-30,270,0.20084332
6280,,A,Early Imperial Period,8,-30,100,130,0.20084332
6280,,A,Mid-Imperial Period,9,100,300,200,0.20084332
6280,,A,Late Imperial Period,10,300,500,200,0.20084332
6281,Poggio del Molino,A,Republican Period,7,-100,-30,70,0.51267904
6281,Poggio del Molino,A,Early Imperial Period,8,-30,100,130,0.51267904
6281,Poggio del Molino,A,Mid-Imperial Period,9,100,300,200,0.51267904
6281,Poggio del Molino,A,Late Imperial Period,10,300,500,200,0.51267904
6282,Marcomora,A,Middle Bronze Age,2,-1700,-1500,200,0.25693652
6282,Marcomora,B,Early Imperial Period,8,-30,100,130,0.25693652
6282,Marcomora,B,Mid-Imperial Period,9,100,300,200,0.25693652
6282,Marcomora,B,Late Imperial Period,10,300,500,200,0.25693652
6283,Pontone Cavaliere,A,Middle Bronze Age,2,-1700,-1300,400,0.41699252
6283,Pontone Cavaliere,A,Late Bronze Age,3,-1300,-1020,280,0.41699252
6283,Pontone Cavaliere,A,Early Iron Age,4,-1020,-1000,20,0.41699252
6283,Pontone Cavaliere,B,Late Iron Age,5,-650,-580,70,0.41699252
6283,Pontone Cavaliere,B,Archaic Period,6,-580,-550,30,0.41699252
6283,Pontone Cavaliere,C,Mid-Imperial Period,9,100,300,200,0.19119544
6284,Le Macinelle,A,Early Imperial Period,8,-30,100,130,0.25071239
6284,Le Macinelle,A,Mid-Imperial Period,9,100,300,200,0.25071239
6285,Pontone della Sorca,A,Republican Period,7,-300,-30,270,0.28200287
6285,Pontone della Sorca,A,Early Imperial Period,8,-30,100,130,0.28200287
6285,Pontone della Sorca,A,Mid-Imperial Period,9,100,300,200,0.28200287
6285,Pontone della Sorca,A,Late Imperial Period,10,300,500,200,0.28200287
6286,Creta Bianca,A,Republican Period,7,-300,-30,270,0.33831424
6286,Creta Bianca,A,Early Imperial Period,8,-30,100,130,0.33831424
6287,Fontanile delle Macinelle,A,Late Iron Age,5,-700,-580,120,0.47825465
6287,Fontanile delle Macinelle,A,Archaic Period,6,-580,-350,230,0.47825465
6287,Fontanile delle Macinelle,A,Republican Period,7,-350,-300,50,0.47825465
6287,Fontanile delle Macinelle,B,Early Imperial Period,8,0,100,100,0.47825465
6287,Fontanile delle Macinelle,B,Mid-Imperial Period,9,100,300,200,0.47825465
6287,Fontanile delle Macinelle,B,Late Imperial Period,10,300,500,200,0.47825465
6288,Creta Bianca,A,Archaic Period,6,-400,-350,50,0.39435256
6288,Creta Bianca,A,Republican Period,7,-350,-30,320,0.39435256
6288,Creta Bianca,A,Early Imperial Period,8,-30,100,130,0.39435256
6288,Creta Bianca,A,Mid-Imperial Period,9,100,300,200,0.39435256
6288,Creta Bianca,A,Late Imperial Period,10,300,500,200,0.39435256
6289,Il Castagno,A,Republican Period,7,-300,-30,270,0.28127432
6289,Il Castagno,A,Early Imperial Period,8,-30,100,130,0.28127432
6289,Il Castagno,A,Mid-Imperial Period,9,100,300,200,0.28127432
6289,Il Castagno,A,Late Imperial Period,10,300,500,200,0.28127432
6290,Le Scogliere,A,Republican Period,7,-300,-30,270,0.27706543
6290,Le Scogliere,A,Early Imperial Period,8,-30,100,130,0.27706543
6290,Le Scogliere,A,Mid-Imperial Period,9,100,300,200,0.27706543
6290,Le Scogliere,A,Late Imperial Period,10,300,500,200,0.27706543
6291,,A,Archaic Period,6,-400,-350,50,0.31115711
6291,,B,Republican Period,7,-350,-30,320,0.31115711
6291,,B,Early Imperial Period,8,-30,100,130,0.31115711
6291,,B,Mid-Imperial Period,9,100,200,100,0.31115711
6291,,C,Late Imperial Period,10,300,500,200,0.31115711
6292,Le Scogliere,A,Republican Period,7,-300,-30,270,0.3126078
6292,Le Scogliere,A,Early Imperial Period,8,-30,100,130,0.3126078
6292,Le Scogliere,A,Mid-Imperial Period,9,100,300,200,0.3126078
6292,Le Scogliere,A,Late Imperial Period,10,300,500,200,0.3126078
6293,Macchia di Borgonero,A,Republican Period,7,-300,-30,270,0.42281848
6293,Macchia di Borgonero,A,Early Imperial Period,8,-30,100,130,0.42281848
6293,Macchia di Borgonero,A,Mid-Imperial Period,9,100,300,200,0.42281848
6293,Macchia di Borgonero,A,Late Imperial Period,10,300,500,200,0.42281848
6294,Casale Vacchereccia,A,Mid-Imperial Period,9,100,300,200,0.29069465
6295,Poggio Vacchereccia,A,Early Imperial Period,8,-30,100,130,0.3260121
6295,Poggio Vacchereccia,A,Mid-Imperial Period,9,100,300,200,0.3260121
6295,Poggio Vacchereccia,A,Late Imperial Period,10,300,500,200,0.3260121
6296,Macchia di Borgonero,A,Republican Period,7,-300,-30,270,0.20568439
6296,Macchia di Borgonero,A,Early Imperial Period,8,-30,100,130,0.20568439
6296,Macchia di Borgonero,A,Mid-Imperial Period,9,100,300,200,0.20568439
6296,Macchia di Borgonero,A,Late Imperial Period,10,300,500,200,0.20568439
6297,Poggio di Vacchereccia/Le Scogliere,A,Early Imperial Period,8,0,100,100,0.19885835
6297,Poggio di Vacchereccia/Le Scogliere,A,Mid-Imperial Period,9,100,300,200,0.19885835
6298,Poggio di Vacchereccia/Le Scogliere,A,Republican Period,7,-300,-30,270,0.3378562
6298,Poggio di Vacchereccia/Le Scogliere,A,Early Imperial Period,8,-30,100,130,0.3378562
6298,Poggio di Vacchereccia/Le Scogliere,A,Mid-Imperial Period,9,100,300,200,0.3378562
6298,Poggio di Vacchereccia/Le Scogliere,A,Late Imperial Period,10,300,500,200,0.3378562
6299,Poggio Tigliano,A,Republican Period,7,-300,-30,270,0.2693015
6299,Poggio Tigliano,A,Early Imperial Period,8,-30,100,130,0.2693015
6299,Poggio Tigliano,A,Mid-Imperial Period,9,100,300,200,0.2693015
6299,Poggio Tigliano,A,Late Imperial Period,10,300,500,200,0.2693015
6300,Lascone,A,Republican Period,7,-100,-30,70,0.34578434
6300,Lascone,A,Early Imperial Period,8,-30,100,130,0.34578434
6300,Lascone,A,Mid-Imperial Period,9,100,200,100,0.34578434
6301,Poggio Tigliano,A,Republican Period,7,-300,-30,270,0.11333991
6301,Poggio Tigliano,A,Early Imperial Period,8,-30,100,130,0.11333991
6301,Poggio Tigliano,A,Mid-Imperial Period,9,100,300,200,0.11333991
6301,Poggio Tigliano,A,Late Imperial Period,10,300,500,200,0.11333991
6302,Guadalavita,A,Early Imperial Period,8,0,100,100,1.75453
6302,Guadalavita,A,Mid-Imperial Period,9,100,300,200,1.75453
6303,La Scogliera/I Quadrelli,A,Republican Period,7,-300,-30,270,0.36671352
6303,La Scogliera/I Quadrelli,A,Early Imperial Period,8,-30,100,130,0.36671352
6303,La Scogliera/I Quadrelli,A,Mid-Imperial Period,9,100,300,200,0.36671352
6303,La Scogliera/I Quadrelli,A,Late Imperial Period,10,300,500,200,0.36671352
6304,La Crocetta,A,Early Imperial Period,8,-30,100,130,0.1806764
6305,Ara del Marmo,A,Late Iron Age,5,-700,-580,120,0.45480728
6305,Ara del Marmo,A,Archaic Period,6,-580,-350,230,0.45480728
6305,Ara del Marmo,A,Republican Period,7,-350,-30,320,0.45480728
6305,Ara del Marmo,A,Early Imperial Period,8,-30,100,130,0.45480728
6305,Ara del Marmo,A,Mid-Imperial Period,9,100,300,200,0.45480728
6305,Ara del Marmo,A,Late Imperial Period,10,300,500,200,0.45480728
6306,Monte Casella,A,Republican Period,7,-300,-30,270,0.1989844
6306,Monte Casella,A,Early Imperial Period,8,-30,100,130,0.1989844
6306,Monte Casella,A,Mid-Imperial Period,9,100,300,200,0.1989844
6306,Monte Casella,A,Late Imperial Period,10,300,500,200,0.1989844
6307,Monte Cuoco,A,Republican Period,7,-300,-30,270,0.24982543
6307,Monte Cuoco,A,Early Imperial Period,8,-30,100,130,0.24982543
6307,Monte Cuoco,A,Mid-Imperial Period,9,100,300,200,0.24982543
6307,Monte Cuoco,A,Late Imperial Period,10,300,500,200,0.24982543
6308,Castellina S. Nicola,A,Mid-Imperial Period,9,100,300,200,0.19261639
6309,Poggio Aschivelli,A,Early Imperial Period,8,0,100,100,0.17729388
6309,Poggio Aschivelli,A,Mid-Imperial Period,9,100,300,200,0.17729388
6311,Macchia delle Crete,A,Republican Period,7,-300,-30,270,0.25361481
6311,Macchia delle Crete,A,Early Imperial Period,8,-30,100,130,0.25361481
6311,Macchia delle Crete,A,Mid-Imperial Period,9,100,300,200,0.25361481
6311,Macchia delle Crete,A,Late Imperial Period,10,300,500,200,0.25361481
6312,Montarozzo,A,Republican Period,7,-300,-30,270,0.29918766
6312,Montarozzo,A,Early Imperial Period,8,-30,100,130,0.29918766
6312,Montarozzo,A,Mid-Imperial Period,9,100,300,200,0.29918766
6312,Montarozzo,A,Late Imperial Period,10,300,500,200,0.29918766
6313,Costa del Paganello,A,Republican Period,7,-300,-30,270,0.20548005
6313,Costa del Paganello,A,Early Imperial Period,8,-30,100,130,0.20548005
6313,Costa del Paganello,A,Mid-Imperial Period,9,100,300,200,0.20548005
6313,Costa del Paganello,A,Late Imperial Period,10,300,500,200,0.20548005
6314,Montarozzo,A,Early Imperial Period,8,-30,100,130,0.40823233
6314,Montarozzo,A,Mid-Imperial Period,9,100,300,200,0.40823233
6315,Castellina S. Nicola,A,Republican Period,7,-300,-30,270,0.26989934
6315,Castellina S. Nicola,A,Early Imperial Period,8,-30,100,130,0.26989934
6315,Castellina S. Nicola,A,Mid-Imperial Period,9,100,300,200,0.26989934
6315,Castellina S. Nicola,A,Late Imperial Period,10,300,500,200,0.26989934
6316,Poggio del Boccaccio,A,Republican Period,7,-330,-50,280,0.56051826
6317,Boscone,A,Early Iron Age,4,-800,-750,50,1.3026685
6317,Boscone,A,Late Iron Age,5,-750,-580,170,1.3026685
6317,Boscone,A,Archaic Period,6,-580,-350,230,1.3026685
6317,Boscone,A,Republican Period,7,-350,-50,300,1.3026685
6318,La Ripa,A,Late Iron Age,5,-600,-580,20,0.29767165
6318,La Ripa,A,Archaic Period,6,-580,-350,230,0.29767165
6318,La Ripa,A,Republican Period,7,-350,-200,150,0.29767165
6319,Poggio del Comune,A,Late Iron Age,5,-600,-580,20,0.29784492
6319,Poggio del Comune,A,Archaic Period,6,-580,-500,80,0.29784492
6320,La Rocca,A,Late Iron Age,5,-600,-580,20,0.35721895
6320,La Rocca,A,Archaic Period,6,-580,-470,110,0.35721895
6320,La Rocca,B,Republican Period,7,-330,-50,280,0.35721895
6321,Pugiano,A,Late Iron Age,5,-600,-580,20,0.12775533
6321,Pugiano,A,Archaic Period,6,-580,-500,80,0.12775533
6322,Quartaia,A,Late Iron Age,5,-600,-580,20,1.7877179
6322,Quartaia,B,Archaic Period,6,-580,-350,230,1.7877179
6322,Quartaia,B,Republican Period,7,-350,-300,50,1.7877179
6323,Lucciana,A,Early Iron Age,4,-900,-750,150,0.25402707
6323,Lucciana,A,Late Iron Age,5,-750,-700,50,0.25402707
6324,Campassini,A,Late Iron Age,5,-700,-580,120,2.6155856
6324,Campassini,A,Archaic Period,6,-580,-500,80,2.6155856
6325,Monistero,A,Republican Period,7,-330,-50,280,0.44907051
6326,Villa di Pascina 2,A,Republican Period,7,-330,-100,230,0.046614308
6327,Piano di Biricoccolo,A,Republican Period,7,-300,-50,250,0.10423809
6328,Rapale,A,Republican Period,7,-200,-30,170,0.41977456
6328,Rapale,A,Early Imperial Period,8,-30,100,130,0.41977456
6329,Montebenichi,A,Republican Period,7,-300,-50,250,0.070356056
6330,Podere Calvaiano,A,Republican Period,7,-200,-50,150,0.13862352
6331,Podere Materno,A,Late Iron Age,5,-600,-580,20,0.13863969
6331,Podere Materno,A,Archaic Period,6,-580,-500,80,0.13863969
6332,Podere Gattaresi,A,Late Iron Age,5,-600,-580,20,0.13866393
6332,Podere Gattaresi,A,Archaic Period,6,-580,-500,80,0.13866393
6333,Poggio Scapernata,A,Republican Period,7,-350,-200,150,0.13870138
6334,Podere Madonna a Olli,A,Late Iron Age,5,-600,-580,20,0.13870342
6334,Podere Madonna a Olli,A,Archaic Period,6,-580,-500,80,0.13870342
6335,Podere Nuovo,A,Late Iron Age,5,-600,-580,20,0.13871473
6335,Podere Nuovo,A,Archaic Period,6,-580,-500,80,0.13871473
6336,Podere Serracona di Sopra,A,Late Iron Age,5,-600,-580,20,0.13873272
6336,Podere Serracona di Sopra,A,Archaic Period,6,-580,-500,80,0.13873272
6337,Casa Nuova di Belforte,A,Republican Period,7,-200,-100,100,0.3512578
6338,Podere Mollerata,A,Late Iron Age,5,-600,-580,20,0.076508649
6338,Podere Mollerata,A,Archaic Period,6,-580,-500,80,0.076508649
6339,Pianacce,A,Early Iron Age,4,-900,-750,150,0.067321509
6339,Pianacce,A,Late Iron Age,5,-750,-700,50,0.067321509
6340,Mulino Vecchio delle Gallerie,A,Late Iron Age,5,-600,-580,20,0.067327671
6340,Mulino Vecchio delle Gallerie,A,Archaic Period,6,-580,-500,80,0.067327671
6341,Il Palazzo,A,Late Iron Age,5,-600,-580,20,0.067331344
6341,Il Palazzo,A,Archaic Period,6,-580,-500,80,0.067331344
6342,Val di Rosia 1,A,Late Iron Age,5,-600,-580,20,0.06728588
6342,Val di Rosia 1,A,Archaic Period,6,-580,-350,230,0.06728588
6342,Val di Rosia 1,A,Republican Period,7,-350,-50,300,0.06728588
6343,Val di Rosia 2,A,Late Iron Age,5,-600,-580,20,0.067298263
6343,Val di Rosia 2,A,Archaic Period,6,-580,-500,80,0.067298263
6344,Borgo Villanuova,A,Late Iron Age,5,-600,-580,20,0.067323156
6344,Borgo Villanuova,A,Archaic Period,6,-580,-400,180,0.067323156
6344,Borgo Villanuova,B,Republican Period,7,-300,-100,200,0.067323156
6345,Frosini 1,A,Republican Period,7,-300,-100,200,0.067327239
6346,Frosini 2,A,Late Iron Age,5,-600,-580,20,0.067326345
6346,Frosini 2,A,Archaic Period,6,-580,-500,80,0.067326345
6347,Frosini 3,A,Republican Period,7,-300,-100,200,0.067329526
6348,Poggio al Monte 1,A,Late Iron Age,5,-600,-580,20,0.067343898
6348,Poggio al Monte 1,A,Archaic Period,6,-580,-500,80,0.067343898
6349,Podere San Magno,A,Late Iron Age,5,-600,-580,20,0.06734024
6349,Podere San Magno,A,Archaic Period,6,-580,-500,80,0.06734024
6350,Poggio al Monte 1,A,Late Iron Age,5,-600,-580,20,0.067346737
6350,Poggio al Monte 1,A,Archaic Period,6,-580,-500,80,0.067346737
6351,Poggio al Monte 3,A,Late Iron Age,5,-600,-580,20,0.067347154
6351,Poggio al Monte 3,A,Archaic Period,6,-580,-500,80,0.067347154
6352,Le Morane,A,Republican Period,7,-300,-100,200,0.067341648
6353,Greppini,A,Late Iron Age,5,-600,-580,20,0.067341469
6353,Greppini,A,Archaic Period,6,-580,-500,80,0.067341469
6354,Papena IV,A,Republican Period,7,-300,-100,200,0.067342162
6355,Il Caggiolo 1,A,Late Iron Age,5,-600,-580,20,0.067350626
6355,Il Caggiolo 1,A,Archaic Period,6,-580,-500,80,0.067350626
6356,Il Caggiolo 2,A,Late Iron Age,5,-600,-580,20,0.067348316
6356,Il Caggiolo 2,A,Archaic Period,6,-580,-500,80,0.067348316
6357,La Battellona,A,Late Iron Age,5,-600,-580,20,0.067357101
6357,La Battellona,A,Archaic Period,6,-580,-500,80,0.067357101
6358,Il Casino 1,A,Late Iron Age,5,-600,-580,20,0.06735637
6358,Il Casino 1,A,Archaic Period,6,-580,-500,80,0.06735637
6359,Il Casino 1,A,Late Iron Age,5,-600,-580,20,0.067357399
6359,Il Casino 1,A,Archaic Period,6,-580,-500,80,0.067357399
6359,Il Casino 1,B,Republican Period,7,-200,-100,100,0.067357399
6360,Il Casino 2,A,Late Iron Age,5,-600,-580,20,0.067358747
6360,Il Casino 2,A,Archaic Period,6,-580,-500,80,0.067358747
6361,Frassini 1,A,Late Iron Age,5,-600,-580,20,0.067366876
6361,Frassini 1,A,Archaic Period,6,-580,-500,80,0.067366876
6362,Frassini 2,A,Late Iron Age,5,-600,-580,20,0.067365862
6362,Frassini 2,A,Archaic Period,6,-580,-500,80,0.067365862
6363,Fonte al Bonichi 1,A,Late Iron Age,5,-600,-580,20,0.06736552
6363,Fonte al Bonichi 1,A,Archaic Period,6,-580,-500,80,0.06736552
6364,Fonte al Bonichi 1,A,Late Iron Age,5,-600,-580,20,0.067364462
6364,Fonte al Bonichi 1,A,Archaic Period,6,-580,-500,80,0.067364462
6365,Podere S. Giovanni,A,Late Iron Age,5,-600,-580,20,0.067367084
6365,Podere S. Giovanni,A,Archaic Period,6,-580,-500,80,0.067367084
6366,Val di Feccia 1,A,Late Iron Age,5,-600,-580,20,0.067355372
6366,Val di Feccia 1,A,Archaic Period,6,-580,-500,80,0.067355372
6366,Val di Feccia 1,B,Republican Period,7,-300,-50,250,0.067355372
6367,Val di Feccia 2,A,Late Iron Age,5,-600,-580,20,0.067355275
6367,Val di Feccia 2,A,Archaic Period,6,-580,-500,80,0.067355275
6367,Val di Feccia 2,B,Republican Period,7,-300,-50,250,0.067355275
6368,Val di Feccia 3,A,Late Iron Age,5,-600,-580,20,0.067354813
6368,Val di Feccia 3,A,Archaic Period,6,-580,-500,80,0.067354813
6369,Val di Feccia 4,A,Late Iron Age,5,-600,-580,20,0.067348219
6369,Val di Feccia 4,A,Archaic Period,6,-580,-500,80,0.067348219
6370,Il Casino 5,A,Republican Period,7,-300,-100,200,0.06735979
6371,La Selva 1,A,Republican Period,7,-300,-100,200,0.067370623
6372,La Selva 2,A,Republican Period,7,-300,-100,200,0.067368582
6373,La Poggiarella,A,Late Iron Age,5,-600,-580,20,7.022727
6373,La Poggiarella,A,Archaic Period,6,-580,-350,230,7.022727
6373,La Poggiarella,A,Republican Period,7,-350,-100,250,7.022727
6374,Casette 1,A,Late Iron Age,5,-650,-600,50,0.067372084
6375,Casette 2,A,Late Iron Age,5,-600,-580,20,0.067370407
6375,Casette 2,A,Archaic Period,6,-580,-500,80,0.067370407
6376,Val di rosia 6,A,Early Iron Age,4,-800,-750,50,0.067267664
6376,Val di rosia 6,A,Late Iron Age,5,-750,-580,170,0.067267664
6376,Val di rosia 6,A,Archaic Period,6,-580,-500,80,0.067267664
6377,Val di rosia 7,A,Early Iron Age,4,-800,-750,50,0.067268364
6377,Val di rosia 7,A,Late Iron Age,5,-750,-580,170,0.067268364
6377,Val di rosia 7,A,Archaic Period,6,-580,-500,80,0.067268364
6378,Val di rosia 8,A,Early Iron Age,4,-800,-750,50,0.067270823
6378,Val di rosia 8,A,Late Iron Age,5,-750,-580,170,0.067270823
6378,Val di rosia 8,A,Archaic Period,6,-580,-500,80,0.067270823
6379,Cetinale,A,Early Iron Age,4,-800,-750,50,0.06727618
6379,Cetinale,A,Late Iron Age,5,-750,-700,50,0.06727618
6380,Poggio della Pigna,A,Late Iron Age,5,-700,-580,120,0.067266114
6380,Poggio della Pigna,A,Archaic Period,6,-580,-550,30,0.067266114
6380,Poggio della Pigna,B,Republican Period,7,-300,-100,200,0.067266114
6381,Monte Acuto,A,Late Bronze Age,3,-1100,-1020,80,0.06729576
6381,Monte Acuto,A,Early Iron Age,4,-1020,-900,120,0.06729576
6381,Monte Acuto,B,Late Iron Age,5,-700,-580,120,0.06729576
6381,Monte Acuto,B,Archaic Period,6,-580,-550,30,0.06729576
6381,Monte Acuto,C,Republican Period,7,-300,-100,200,0.06729576
6382,Poggio Siena Vecchia,A,Late Iron Age,5,-700,-580,120,0.34345156
6382,Poggio Siena Vecchia,A,Archaic Period,6,-580,-550,30,0.34345156
6382,Poggio Siena Vecchia,B,Republican Period,7,-300,-100,200,0.34345156
6383,Rigomorto,A,Late Iron Age,5,-700,-580,120,0.34342572
6383,Rigomorto,A,Archaic Period,6,-580,-550,30,0.34342572
6383,Rigomorto,B,Republican Period,7,-300,-100,200,0.34342572
6384,Orgia,A,Republican Period,7,-300,-100,200,0.34350803
6385,La Piana,A,Republican Period,7,-350,-200,150,0.067226917
6386,Campo Muri,A,Republican Period,7,-300,-100,200,1.1888686
6387,Bagnaia 1,A,Late Iron Age,5,-600,-580,20,0.067321092
6387,Bagnaia 1,A,Archaic Period,6,-580,-500,80,0.067321092
6388,Bagnaia 2,A,Late Iron Age,5,-600,-580,20,0.067322567
6388,Bagnaia 2,A,Archaic Period,6,-580,-500,80,0.067322567
6389,Filetta,A,Late Iron Age,5,-600,-580,20,0.067335397
6389,Filetta,B,Archaic Period,6,-580,-350,230,0.067335397
6389,Filetta,B,Republican Period,7,-350,-100,250,0.067335397
6390,Murlo,A,Late Iron Age,5,-600,-580,20,1.4043717
6390,Murlo,A,Archaic Period,6,-580,-350,230,1.4043717
6390,Murlo,A,Republican Period,7,-350,-50,300,1.4043717
6391,Castiglione del Bosco,A,Late Iron Age,5,-600,-580,20,0.067473248
6391,Castiglione del Bosco,A,Archaic Period,6,-580,-500,80,0.067473248
6392,Podere Monticello,A,Early Bronze Age,1,-2300,-1700,600,0.1
6393,Cimitero Vecchio di Chia,A,Middle Bronze Age,2,-1700,-1400,300,0.1
6393,Cimitero Vecchio di Chia,B,Late Iron Age,5,-600,-580,20,0.1
6393,Cimitero Vecchio di Chia,B,Archaic Period,6,-580,-500,80,0.1
6394,La Capriola,A,Middle Bronze Age,2,-1700,-1400,300,0.45465615
6394,La Capriola,B,Late Bronze Age,3,-1100,-1020,80,0.45465615
6394,La Capriola,B,Early Iron Age,4,-1020,-900,120,0.45465615
6394,La Capriola,C,Late Iron Age,5,-600,-580,20,0.45465615
6394,La Capriola,C,Archaic Period,6,-580,-500,80,0.45465615
6394,La Capriola,D,Republican Period,7,-100,-30,70,0.45465615
6394,La Capriola,D,Early Imperial Period,8,-30,100,130,0.45465615
6394,La Capriola,D,Mid-Imperial Period,9,100,300,200,0.45465615
6394,La Capriola,D,Late Imperial Period,10,300,500,200,0.45465615
6395,Masseto,A,Middle Bronze Age,2,-1700,-1400,300,1.5282815
6396,Monte Segnale,A,Middle Bronze Age,2,-1700,-1400,300,4.2453279
6397,Poggio di Sermugnano,A,Middle Bronze Age,2,-1700,-1400,300,0.69095898
6397,Poggio di Sermugnano,B,Late Bronze Age,3,-1300,-1020,280,0.69095898
6397,Poggio di Sermugnano,B,Early Iron Age,4,-1020,-750,270,0.69095898
6397,Poggio di Sermugnano,B,Late Iron Age,5,-750,-580,170,2.8305368
6397,Poggio di Sermugnano,B,Archaic Period,6,-580,-350,230,2.8305368
6397,Poggio di Sermugnano,B,Republican Period,7,-350,-30,320,1.6011493
6397,Poggio di Sermugnano,B,Early Imperial Period,8,-30,100,130,1.6011493
6397,Poggio di Sermugnano,B,Mid-Imperial Period,9,100,300,200,1.6011493
6397,Poggio di Sermugnano,B,Late Imperial Period,10,300,500,200,1.6011493
6398,Le Rocchette,A,Middle Bronze Age,2,-1700,-1300,400,4.0785861
6398,Le Rocchette,A,Late Bronze Age,3,-1300,-1020,280,4.0785861
6398,Le Rocchette,A,Early Iron Age,4,-1020,-1000,20,4.0785861
6398,Le Rocchette,B,Late Iron Age,5,-600,-580,20,4.0785861
6398,Le Rocchette,B,Archaic Period,6,-580,-350,230,4.0785861
6398,Le Rocchette,B,Republican Period,7,-350,-30,320,4.0785861
6398,Le Rocchette,B,Early Imperial Period,8,-30,100,130,4.0785861
6398,Le Rocchette,B,Mid-Imperial Period,9,100,300,200,4.0785861
6398,Le Rocchette,B,Late Imperial Period,10,300,500,200,4.0785861
6399,Castiglioni,A,Middle Bronze Age,2,-1400,-1300,100,1.657426
6399,Castiglioni,A,Late Bronze Age,3,-1300,-1020,280,1.657426
6399,Castiglioni,B,Early Iron Age,4,-1020,-800,220,1.657426
6399,Castiglioni,C,Late Iron Age,5,-600,-580,20,1.657426
6399,Castiglioni,C,Archaic Period,6,-580,-500,80,1.657426
6399,Castiglioni,D,Early Imperial Period,8,-30,100,130,1.657426
6399,Castiglioni,D,Mid-Imperial Period,9,100,300,200,1.657426
6399,Castiglioni,D,Late Imperial Period,10,300,500,200,1.657426
6400,La Casaccia,A,Middle Bronze Age,2,-1400,-1300,100,2.1776984
6400,La Casaccia,B,Late Iron Age,5,-600,-580,20,2.1776984
6400,La Casaccia,B,Archaic Period,6,-580,-350,230,2.1776984
6400,La Casaccia,B,Republican Period,7,-350,-30,320,2.1776984
6400,La Casaccia,B,Early Imperial Period,8,-30,100,130,2.1776984
6400,La Casaccia,B,Mid-Imperial Period,9,100,300,200,2.1776984
6400,La Casaccia,B,Late Imperial Period,10,300,500,200,2.1776984
6401,S. Silvestro,A,Middle Bronze Age,2,-1400,-1300,100,2.1795788
6402,Selva di Chia,A,Middle Bronze Age,2,-1400,-1300,100,2.1803589
6403,Fondaccio,A,Middle Bronze Age,2,-1400,-1300,100,10.714938
6403,Fondaccio,A,Late Bronze Age,3,-1300,-1020,280,10.714938
6403,Fondaccio,A,Early Iron Age,4,-1020,-750,270,10.714938
6403,Fondaccio,A,Late Iron Age,5,-750,-580,170,10.714938
6403,Fondaccio,A,Archaic Period,6,-580,-350,230,10.714938
6403,Fondaccio,A,Republican Period,7,-350,-100,250,10.714938
6404,Orte,A,Middle Bronze Age,2,-1400,-1300,100,3.8232744
6404,Orte,A,Late Bronze Age,3,-1300,-1020,280,3.8232744
6404,Orte,A,Early Iron Age,4,-1020,-1000,20,3.8232744
6404,Orte,B,Late Iron Age,5,-700,-580,120,7.8910947
6404,Orte,B,Archaic Period,6,-580,-350,230,7.8910947
6404,Orte,B,Republican Period,7,-350,-30,320,7.8910947
6404,Orte,B,Early Imperial Period,8,-30,100,130,7.8910947
6404,Orte,B,Mid-Imperial Period,9,100,300,200,7.8910947
6404,Orte,B,Late Imperial Period,10,300,500,200,7.8910947
6405,Civita di Bagnoregio,A,Late Bronze Age,3,-1300,-1020,280,2.0635083
6405,Civita di Bagnoregio,A,Early Iron Age,4,-1020,-750,270,2.0635083
6405,Civita di Bagnoregio,A,Late Iron Age,5,-750,-580,170,2.0635083
6405,Civita di Bagnoregio,A,Archaic Period,6,-580,-500,80,2.0635083
6406,Casale Marcello,A,Late Bronze Age,3,-1100,-1020,80,1.0649639
6406,Casale Marcello,A,Early Iron Age,4,-1020,-900,120,1.0649639
6407,Cornos,A,Late Bronze Age,3,-1100,-1020,80,6.7025437
6407,Cornos,A,Early Iron Age,4,-1020,-900,120,6.7025437
6407,Cornos,B,Republican Period,7,-100,-30,70,6.7025437
6407,Cornos,B,Early Imperial Period,8,-30,100,130,6.7025437
6407,Cornos,B,Mid-Imperial Period,9,100,300,200,6.7025437
6407,Cornos,B,Late Imperial Period,10,300,500,200,6.7025437
6408,Rocca Sberna,A,Late Bronze Age,3,-1100,-1020,80,1.0623769
6408,Rocca Sberna,B,Early Iron Age,4,-1020,-900,120,1.0623769
6408,Rocca Sberna,B,Late Iron Age,5,-600,-580,20,1.0623769
6408,Rocca Sberna,B,Archaic Period,6,-580,-500,80,1.0623769
6408,Rocca Sberna,C,Republican Period,7,-100,-30,70,1.0623769
6408,Rocca Sberna,C,Early Imperial Period,8,-30,100,130,1.0623769
6408,Rocca Sberna,C,Mid-Imperial Period,9,100,300,200,1.0623769
6408,Rocca Sberna,C,Late Imperial Period,10,300,500,200,1.0623769
6409,Vitorchiano,A,Late Bronze Age,3,-1100,-1020,80,2.7782788
6409,Vitorchiano,A,Early Iron Age,4,-1020,-900,120,2.7782788
6409,Vitorchiano,B,Late Iron Age,5,-600,-580,20,2.7782788
6409,Vitorchiano,B,Archaic Period,6,-580,-350,230,2.7782788
6409,Vitorchiano,B,Republican Period,7,-350,-100,250,2.7782788
6410,Montefiascone-Rocca,A,Late Bronze Age,3,-1100,-1020,80,5.4122605
6410,Montefiascone-Rocca,A,Early Iron Age,4,-1020,-750,270,5.4122605
6410,Montefiascone-Rocca,A,Late Iron Age,5,-750,-580,170,5.4122605
6410,Montefiascone-Rocca,A,Archaic Period,6,-580,-500,80,5.4122605
6411,Castellonchio,A,Late Bronze Age,3,-1100,-1020,80,0.3901917
6411,Castellonchio,A,Early Iron Age,4,-1020,-750,270,0.3901917
6411,Castellonchio,A,Late Iron Age,5,-750,-600,150,0.3901917
6411,Castellonchio,B,Archaic Period,6,-400,-350,50,43.084656
6411,Castellonchio,B,Republican Period,7,-350,-250,100,43.084656
6412,Grancaro,A,Early Bronze Age,1,-2000,-1700,300,0.84409857
6412,Grancaro,B,Late Bronze Age,3,-1300,-1020,280,0.84409857
6412,Grancaro,B,Early Iron Age,4,-1020,-800,220,0.84409857
6413,Civita d'Arlena,A,Early Iron Age,4,-900,-750,150,3.0394328
6413,Civita d'Arlena,A,Late Iron Age,5,-750,-600,150,3.0394328
6413,Civita d'Arlena,B,Republican Period,7,-350,-250,100,3.0394328
6414,Acquarossa,A,Late Iron Age,5,-700,-600,100,1.4522297
6415,Poggio della Penna,A,Late Iron Age,5,-700,-600,100,0.22653334
6416,San Salvatore-Piantorena,A,Late Iron Age,5,-600,-580,20,2.5898063
6416,San Salvatore-Piantorena,A,Archaic Period,6,-580,-350,230,2.5898063
6416,San Salvatore-Piantorena,A,Republican Period,7,-350,-30,320,2.5898063
6416,San Salvatore-Piantorena,A,Early Imperial Period,8,-30,100,130,2.5898063
6416,San Salvatore-Piantorena,A,Mid-Imperial Period,9,100,300,200,2.5898063
6416,San Salvatore-Piantorena,A,Late Imperial Period,10,300,500,200,2.5898063
6417,Casale della Colonna,A,Early Bronze Age,1,-2300,-1700,600,0.34528756
6417,Casale della Colonna,A,Middle Bronze Age,2,-1700,-1300,400,0.34528756
6417,Casale della Colonna,A,Late Bronze Age,3,-1300,-1020,280,0.34528756
6417,Casale della Colonna,A,Early Iron Age,4,-1020,-750,270,0.34528756
6417,Casale della Colonna,A,Late Iron Age,5,-750,-600,150,0.34528756
6417,Casale della Colonna,B,Archaic Period,6,-400,-350,50,0.34528756
6417,Casale della Colonna,B,Republican Period,7,-350,-200,150,0.34528756
6418,Scorcoli-Campo Mancini,A,Republican Period,7,-200,-30,170,2.4591091
6418,Scorcoli-Campo Mancini,A,Early Imperial Period,8,-30,100,130,2.4591091
6418,Scorcoli-Campo Mancini,A,Mid-Imperial Period,9,100,300,200,2.4591091
6418,Scorcoli-Campo Mancini,A,Late Imperial Period,10,300,500,200,2.4591091
6419,Scorcoli-Uliveto,A,Republican Period,7,-200,-30,170,0.5
6419,Scorcoli-Uliveto,A,Early Imperial Period,8,-30,100,130,0.5
6419,Scorcoli-Uliveto,A,Mid-Imperial Period,9,100,300,200,0.5
6419,Scorcoli-Uliveto,B,Late Imperial Period,10,300,500,200,0.5
6420,Cerveteri (Caere),A,Early Iron Age,4,-900,-750,150,13.136271
6420,Cerveteri (Caere),A,Late Iron Age,5,-750,-580,170,162.27945
6420,Cerveteri (Caere),A,Archaic Period,6,-580,-500,80,162.27945
6421,S. Bernardino,A,Archaic Period,6,-400,-350,50,0.44071943
6421,S. Bernardino,A,Republican Period,7,-350,-30,320,0.44071943
6421,S. Bernardino,A,Early Imperial Period,8,-30,100,130,0.44071943
6421,S. Bernardino,A,Mid-Imperial Period,9,100,300,200,0.44071943
6421,S. Bernardino,A,Late Imperial Period,10,300,500,200,0.44071943
6422,Piscina,A,Archaic Period,6,-400,-350,50,0.67204034
6422,Piscina,A,Republican Period,7,-350,-30,320,0.67204034
6422,Piscina,A,Early Imperial Period,8,-30,100,130,0.67204034
6422,Piscina,A,Mid-Imperial Period,9,100,300,200,0.67204034
6422,Piscina,A,Late Imperial Period,10,300,500,200,0.67204034
6423,Poggio del Capitano,A,Republican Period,7,-50,-30,20,0.50297338
6423,Poggio del Capitano,A,Early Imperial Period,8,-30,100,130,0.50297338
6423,Poggio del Capitano,A,Mid-Imperial Period,9,100,300,200,0.50297338
6423,Poggio del Capitano,A,Late Imperial Period,10,300,500,200,0.50297338
6424,Campo dei Morti,A,Archaic Period,6,-400,-350,50,0.97268182
6424,Campo dei Morti,A,Republican Period,7,-350,-30,320,0.97268182
6424,Campo dei Morti,A,Early Imperial Period,8,-30,100,130,0.97268182
6424,Campo dei Morti,A,Mid-Imperial Period,9,100,300,200,0.97268182
6424,Campo dei Morti,A,Late Imperial Period,10,300,500,200,0.97268182
6425,Bagnolo,A,Republican Period,7,-200,-30,170,0.58865649
6425,Bagnolo,A,Early Imperial Period,8,-30,100,130,0.58865649
6425,Bagnolo,A,Mid-Imperial Period,9,100,300,200,0.58865649
6425,Bagnolo,A,Late Imperial Period,10,300,500,200,0.58865649
6426,Fosso dei Tre Confini,A,Republican Period,7,-50,-30,20,0.55301064
6426,Fosso dei Tre Confini,A,Early Imperial Period,8,-30,100,130,0.55301064
6426,Fosso dei Tre Confini,A,Mid-Imperial Period,9,100,300,200,0.55301064
6426,Fosso dei Tre Confini,A,Late Imperial Period,10,300,500,200,0.55301064
6427,Castelluccio,A,Archaic Period,6,-400,-350,50,0.4794471
6427,Castelluccio,A,Republican Period,7,-350,-50,300,0.4794471
6428,Castelluccio,A,Archaic Period,6,-400,-350,50,0.42642161
6428,Castelluccio,A,Republican Period,7,-350,-30,320,0.42642161
6428,Castelluccio,A,Early Imperial Period,8,-30,100,130,0.42642161
6428,Castelluccio,A,Mid-Imperial Period,9,100,300,200,0.42642161
6428,Castelluccio,A,Late Imperial Period,10,300,500,200,0.42642161
6429,Fosso Cupo,A,Republican Period,7,-50,-30,20,0.54719675
6429,Fosso Cupo,A,Early Imperial Period,8,-30,100,130,0.54719675
6429,Fosso Cupo,A,Mid-Imperial Period,9,100,300,200,0.54719675
6429,Fosso Cupo,A,Late Imperial Period,10,300,500,200,0.54719675
6430,Macchia Tonda,A,Republican Period,7,-50,-30,20,0.68213117
6430,Macchia Tonda,A,Early Imperial Period,8,-30,100,130,0.68213117
6430,Macchia Tonda,A,Mid-Imperial Period,9,100,300,200,0.68213117
6430,Macchia Tonda,A,Late Imperial Period,10,300,500,200,0.68213117
6431,Macchia di Ruffo,A,Archaic Period,6,-400,-350,50,0.51428598
6431,Macchia di Ruffo,A,Republican Period,7,-350,-30,320,0.51428598
6431,Macchia di Ruffo,A,Early Imperial Period,8,-30,100,130,0.51428598
6431,Macchia di Ruffo,A,Mid-Imperial Period,9,100,300,200,0.51428598
6431,Macchia di Ruffo,A,Late Imperial Period,10,300,500,200,0.51428598
6432,Postiglione,A,Archaic Period,6,-400,-350,50,0.21729729
6432,Postiglione,A,Republican Period,7,-350,-30,320,0.21729729
6432,Postiglione,A,Early Imperial Period,8,-30,100,130,0.21729729
6432,Postiglione,A,Mid-Imperial Period,9,100,300,200,0.21729729
6432,Postiglione,A,Late Imperial Period,10,300,500,200,0.21729729
6433,Cataluccio,A,Archaic Period,6,-400,-350,50,0.34555694
6433,Cataluccio,A,Republican Period,7,-350,-50,300,0.34555694
6434,Origliano,A,Republican Period,7,-50,-30,20,0.24393606
6434,Origliano,A,Early Imperial Period,8,-30,100,130,0.24393606
6434,Origliano,A,Mid-Imperial Period,9,100,300,200,0.24393606
6434,Origliano,A,Late Imperial Period,10,300,500,200,0.24393606
6435,Rio Grande,A,Republican Period,7,-200,-30,170,0.41898507
6435,Rio Grande,A,Early Imperial Period,8,-30,100,130,0.41898507
6435,Rio Grande,A,Mid-Imperial Period,9,100,300,200,0.41898507
6435,Rio Grande,A,Late Imperial Period,10,300,500,200,0.41898507
6436,Colduano,A,Republican Period,7,-200,-30,170,0.41652015
6436,Colduano,A,Early Imperial Period,8,-30,100,130,0.41652015
6436,Colduano,A,Mid-Imperial Period,9,100,300,200,0.41652015
6436,Colduano,A,Late Imperial Period,10,300,500,200,0.41652015
6437,Aquilano,A,Republican Period,7,-200,-30,170,0.32728153
6437,Aquilano,A,Early Imperial Period,8,-30,100,130,0.32728153
6437,Aquilano,A,Mid-Imperial Period,9,100,300,200,0.32728153
6437,Aquilano,A,Late Imperial Period,10,300,500,200,0.32728153
6438,S. Angelo,A,Republican Period,7,-200,-30,170,0.56164742
6438,S. Angelo,A,Early Imperial Period,8,-30,100,130,0.56164742
6438,S. Angelo,A,Mid-Imperial Period,9,100,300,200,0.56164742
6438,S. Angelo,A,Late Imperial Period,10,300,500,200,0.56164742
6440,Forchetta del Sasso,A,Late Bronze Age,3,-1100,-1020,80,0.1
6440,Forchetta del Sasso,A,Early Iron Age,4,-1020,-900,120,0.1
6441,Monte Santo,A,Late Bronze Age,3,-1100,-1020,80,0.1
6441,Monte Santo,A,Early Iron Age,4,-1020,-900,120,0.1
6441,Monte Santo,B,Late Iron Age,5,-700,-580,120,0.1
6441,Monte Santo,B,Archaic Period,6,-580,-500,80,0.1
6442,Monte dei Pozzi,A,Late Iron Age,5,-600,-580,20,0.1
6442,Monte dei Pozzi,A,Archaic Period,6,-580,-350,230,0.1
6442,Monte dei Pozzi,A,Republican Period,7,-350,-200,150,0.1
6443,Monte Bischero,A,Late Iron Age,5,-700,-580,120,0.1
6443,Monte Bischero,A,Archaic Period,6,-580,-500,80,0.1
6444,Monte della Ginestra,A,Republican Period,7,-200,-30,170,0.2
6444,Monte della Ginestra,A,Early Imperial Period,8,-30,100,130,0.2
6444,Monte della Ginestra,A,Mid-Imperial Period,9,100,300,200,0.2
6444,Monte della Ginestra,A,Late Imperial Period,10,300,500,200,0.2
6445,Montetosto Alto,A,Late Bronze Age,3,-1100,-1020,80,0.1
6445,Montetosto Alto,A,Early Iron Age,4,-1020,-800,220,0.1
6446,Monte Tosto,A,Late Bronze Age,3,-1100,-1020,80,0.1
6446,Monte Tosto,A,Early Iron Age,4,-1020,-900,120,0.1
6446,Monte Tosto,B,Late Iron Age,5,-700,-580,120,0.1
6446,Monte Tosto,B,Archaic Period,6,-580,-500,80,0.1
6447,Monte Fontana,A,Late Iron Age,5,-600,-580,20,0.1
6447,Monte Fontana,A,Archaic Period,6,-580,-350,230,0.1
6447,Monte Fontana,A,Republican Period,7,-350,-30,320,0.1
6447,Monte Fontana,A,Early Imperial Period,8,-30,100,130,0.1
6447,Monte Fontana,A,Mid-Imperial Period,9,100,300,200,0.1
6447,Monte Fontana,A,Late Imperial Period,10,300,500,200,0.1
6448,Monte Fontana,A,Late Iron Age,5,-600,-580,20,0.1
6448,Monte Fontana,A,Archaic Period,6,-580,-350,230,0.1
6448,Monte Fontana,A,Republican Period,7,-350,-30,320,0.1
6448,Monte Fontana,A,Early Imperial Period,8,-30,100,130,0.1
6448,Monte Fontana,A,Mid-Imperial Period,9,100,300,200,0.1
6448,Monte Fontana,A,Late Imperial Period,10,300,500,200,0.1
6449,Vaccareccia,A,Late Iron Age,5,-700,-580,120,0.1
6449,Vaccareccia,A,Archaic Period,6,-580,-500,80,0.1
6450,Monte Paparano,A,Late Iron Age,5,-700,-580,120,0.1
6450,Monte Paparano,A,Archaic Period,6,-580,-500,80,0.1
6451,Riserva Baccala',A,Late Iron Age,5,-600,-580,20,0.1
6451,Riserva Baccala',A,Archaic Period,6,-580,-350,230,0.1
6451,Riserva Baccala',A,Republican Period,7,-350,-200,150,0.1
6452,Pianacce,A,Late Iron Age,5,-600,-580,20,0.1
6452,Pianacce,A,Archaic Period,6,-580,-350,230,0.1
6452,Pianacce,A,Republican Period,7,-350,-30,320,0.1
6452,Pianacce,A,Early Imperial Period,8,-30,100,130,0.1
6452,Pianacce,A,Mid-Imperial Period,9,100,300,200,0.1
6452,Pianacce,A,Late Imperial Period,10,300,500,200,0.1
6453,Monte Puglia,A,Late Iron Age,5,-600,-580,20,0.5
6453,Monte Puglia,A,Archaic Period,6,-580,-350,230,0.5
6453,Monte Puglia,A,Republican Period,7,-350,-30,320,0.5
6453,Monte Puglia,A,Early Imperial Period,8,-30,100,130,0.5
6453,Monte Puglia,A,Mid-Imperial Period,9,100,300,200,0.5
6453,Monte Puglia,A,Late Imperial Period,10,300,500,200,0.5
6454,Monte Capareccia,A,Late Iron Age,5,-600,-580,20,0.1
6454,Monte Capareccia,A,Archaic Period,6,-580,-350,230,0.1
6454,Monte Capareccia,A,Republican Period,7,-350,-200,150,0.1
6455,Monte Rastello,A,Late Iron Age,5,-600,-580,20,0.1
6455,Monte Rastello,A,Archaic Period,6,-580,-500,80,0.1
6456,Bucacce,A,Late Iron Age,5,-600,-580,20,0.1
6456,Bucacce,A,Archaic Period,6,-580,-500,80,0.1
6457,Bucacce,A,Late Iron Age,5,-600,-580,20,0.1
6457,Bucacce,A,Archaic Period,6,-580,-350,230,0.1
6457,Bucacce,A,Republican Period,7,-350,-200,150,0.1
6458,Monte Vittoria,A,Late Iron Age,5,-700,-580,120,0.1
6458,Monte Vittoria,A,Archaic Period,6,-580,-500,80,0.1
6459,Monte Lungo,A,Late Iron Age,5,-700,-580,120,0.1
6459,Monte Lungo,A,Archaic Period,6,-580,-500,80,0.1
6460,Pianciano,A,Late Iron Age,5,-600,-580,20,0.1
6460,Pianciano,A,Archaic Period,6,-580,-350,230,0.1
6460,Pianciano,A,Republican Period,7,-350,-30,320,0.1
6460,Pianciano,A,Early Imperial Period,8,-30,100,130,0.1
6460,Pianciano,A,Mid-Imperial Period,9,100,300,200,0.1
6460,Pianciano,A,Late Imperial Period,10,300,500,200,0.1
6461,Cerquabella,A,Republican Period,7,-200,-30,170,0.5
6461,Cerquabella,A,Early Imperial Period,8,-30,100,130,0.5
6461,Cerquabella,A,Mid-Imperial Period,9,100,300,200,0.5
6461,Cerquabella,A,Late Imperial Period,10,300,500,200,0.5
6462,Monte Muracciolo,A,Republican Period,7,-200,-30,170,0.30000001
6462,Monte Muracciolo,A,Early Imperial Period,8,-30,100,130,0.30000001
6462,Monte Muracciolo,A,Mid-Imperial Period,9,100,300,200,0.30000001
6462,Monte Muracciolo,A,Late Imperial Period,10,300,500,200,0.30000001
6463,Monte Muracciolo,A,Republican Period,7,-200,-30,170,0.30000001
6463,Monte Muracciolo,A,Early Imperial Period,8,-30,100,130,0.30000001
6463,Monte Muracciolo,A,Mid-Imperial Period,9,100,300,200,0.30000001
6463,Monte Muracciolo,A,Late Imperial Period,10,300,500,200,0.30000001
6464,Monte Muracciolo,A,Republican Period,7,-200,-30,170,0.30000001
6464,Monte Muracciolo,A,Early Imperial Period,8,-30,100,130,0.30000001
6464,Monte Muracciolo,A,Mid-Imperial Period,9,100,300,200,0.30000001
6464,Monte Muracciolo,A,Late Imperial Period,10,300,500,200,0.30000001
6465,Monte Muracciolo,A,Republican Period,7,-200,-30,170,0.30000001
6465,Monte Muracciolo,A,Early Imperial Period,8,-30,100,130,0.30000001
6465,Monte Muracciolo,A,Mid-Imperial Period,9,100,300,200,0.30000001
6465,Monte Muracciolo,A,Late Imperial Period,10,300,500,200,0.30000001
6466,Poggio Ponte Coperto,A,Late Iron Age,5,-600,-580,20,0.1
6466,Poggio Ponte Coperto,A,Archaic Period,6,-580,-350,230,0.1
6466,Poggio Ponte Coperto,A,Republican Period,7,-350,-200,150,0.1
6467,Monte dell'Oro-Ponte Coperto,A,Republican Period,7,-200,-30,170,0.30000001
6467,Monte dell'Oro-Ponte Coperto,A,Early Imperial Period,8,-30,100,130,0.30000001
6467,Monte dell'Oro-Ponte Coperto,A,Mid-Imperial Period,9,100,300,200,0.30000001
6467,Monte dell'Oro-Ponte Coperto,A,Late Imperial Period,10,300,500,200,0.30000001
6468,Casaletti,A,Republican Period,7,-200,-30,170,0.1
6468,Casaletti,A,Early Imperial Period,8,-30,100,130,0.1
6468,Casaletti,A,Mid-Imperial Period,9,100,300,200,0.1
6468,Casaletti,A,Late Imperial Period,10,300,500,200,0.1
6469,Riserva Le Caselle,A,Republican Period,7,-200,-30,170,0.30000001
6469,Riserva Le Caselle,A,Early Imperial Period,8,-30,100,130,0.30000001
6469,Riserva Le Caselle,A,Mid-Imperial Period,9,100,300,200,0.30000001
6469,Riserva Le Caselle,A,Late Imperial Period,10,300,500,200,0.30000001
6470,Tre Confini,A,Late Iron Age,5,-600,-580,20,0.30000001
6470,Tre Confini,A,Archaic Period,6,-580,-350,230,0.30000001
6470,Tre Confini,A,Republican Period,7,-350,-200,150,0.30000001
6471,Le Capanne,A,Republican Period,7,-200,-30,170,0.30000001
6471,Le Capanne,A,Early Imperial Period,8,-30,100,130,0.30000001
6471,Le Capanne,A,Mid-Imperial Period,9,100,300,200,0.30000001
6471,Le Capanne,A,Late Imperial Period,10,300,500,200,0.30000001
6472,Ceri,A,Late Bronze Age,3,-1100,-1020,80,0.5
6472,Ceri,B,Early Iron Age,4,-1020,-750,270,0.5
6472,Ceri,B,Late Iron Age,5,-750,-580,170,0.5
6472,Ceri,B,Archaic Period,6,-580,-500,80,0.5
6472,Ceri,C,Republican Period,7,-200,-30,170,0.5
6472,Ceri,C,Early Imperial Period,8,-30,100,130,0.5
6472,Ceri,C,Mid-Imperial Period,9,100,300,200,0.5
6472,Ceri,C,Late Imperial Period,10,300,500,200,0.5
6473,Il Pigno di Ceri,A,Late Iron Age,5,-700,-580,120,0.30000001
6473,Il Pigno di Ceri,A,Archaic Period,6,-580,-500,80,0.30000001
6473,Il Pigno di Ceri,B,Republican Period,7,-100,-30,70,0.30000001
6473,Il Pigno di Ceri,B,Early Imperial Period,8,-30,100,130,0.30000001
6473,Il Pigno di Ceri,B,Mid-Imperial Period,9,100,300,200,0.30000001
6473,Il Pigno di Ceri,B,Late Imperial Period,10,300,500,200,0.30000001
6474,M. Abbadone,A,Late Iron Age,5,-600,-580,20,0.7326169
6474,M. Abbadone,A,Archaic Period,6,-580,-500,80,0.7326169
6474,M. Abbadone,B,Republican Period,7,-200,-30,170,0.7326169
6474,M. Abbadone,B,Early Imperial Period,8,-30,100,130,0.7326169
6474,M. Abbadone,B,Mid-Imperial Period,9,100,300,200,0.7326169
6474,M. Abbadone,B,Late Imperial Period,10,300,400,100,0.7326169
6475,Monte Ceri,A,Early Imperial Period,8,0,100,100,0.30000001
6475,Monte Ceri,A,Mid-Imperial Period,9,100,200,100,0.30000001
6476,Quarto del Cecio,A,Republican Period,7,-200,-30,170,0.30000001
6476,Quarto del Cecio,A,Early Imperial Period,8,-30,100,130,0.30000001
6476,Quarto del Cecio,A,Mid-Imperial Period,9,100,300,200,0.30000001
6476,Quarto del Cecio,A,Late Imperial Period,10,300,500,200,0.30000001
6477,Castellaccio di Castel Campanile,A,Late Iron Age,5,-700,-580,120,0.5
6477,Castellaccio di Castel Campanile,A,Archaic Period,6,-580,-500,80,0.5
6477,Castellaccio di Castel Campanile,B,Republican Period,7,-200,-30,170,0.5
6477,Castellaccio di Castel Campanile,B,Early Imperial Period,8,-30,100,130,0.5
6477,Castellaccio di Castel Campanile,B,Mid-Imperial Period,9,100,300,200,0.5
6477,Castellaccio di Castel Campanile,B,Late Imperial Period,10,300,500,200,0.5
6478,Tenuta di Castel Campanile,A,Late Iron Age,5,-600,-580,20,0.30000001
6478,Tenuta di Castel Campanile,A,Archaic Period,6,-580,-350,230,0.30000001
6478,Tenuta di Castel Campanile,A,Republican Period,7,-350,-200,150,0.30000001
6479,Moscone,A,Republican Period,7,-300,-30,270,2.1295149
6479,Moscone,A,Early Imperial Period,8,-30,100,130,2.1295149
6479,Moscone,A,Mid-Imperial Period,9,100,300,200,2.1295149
6479,Moscone,A,Late Imperial Period,10,300,500,200,2.1295149
6479,Moscone,A,Late Antique Period,11,500,600,100,2.1295149
6480,Quartaccio,A,Republican Period,7,-200,-30,170,0.1
6480,Quartaccio,A,Early Imperial Period,8,-30,100,130,0.1
6480,Quartaccio,A,Mid-Imperial Period,9,100,300,200,0.1
6480,Quartaccio,A,Late Imperial Period,10,300,500,200,0.1
6481,Selva La Rocca,A,Late Iron Age,5,-700,-580,120,0.5
6481,Selva La Rocca,A,Archaic Period,6,-580,-500,80,0.5
6482,Valle Canneto,A,Late Iron Age,5,-600,-580,20,1.4089526
6482,Valle Canneto,A,Archaic Period,6,-580,-500,80,1.4089526
6482,Valle Canneto,B,Republican Period,7,-200,-30,170,1.4089526
6482,Valle Canneto,B,Early Imperial Period,8,-30,100,130,1.4089526
6482,Valle Canneto,B,Mid-Imperial Period,9,100,300,200,1.4089526
6483,Pogggio Elceto,A,Late Bronze Age,3,-1100,-1020,80,0.1
6483,Pogggio Elceto,A,Early Iron Age,4,-1020,-900,120,0.1
6484,Pian del Pero,A,Late Bronze Age,3,-1100,-1020,80,0.1
6484,Pian del Pero,A,Early Iron Age,4,-1020,-900,120,0.1
6485,Monte Tolfaccia,A,Late Bronze Age,3,-1100,-1020,80,0.1
6485,Monte Tolfaccia,B,Early Iron Age,4,-1020,-750,270,0.1
6485,Monte Tolfaccia,B,Late Iron Age,5,-750,-700,50,0.1
6486,La Marina,A,Republican Period,7,-100,-30,70,0.1
6486,La Marina,A,Early Imperial Period,8,-30,100,130,0.1
6486,La Marina,A,Mid-Imperial Period,9,100,300,200,0.1
6486,La Marina,A,Late Imperial Period,10,300,500,200,0.1
6487,Mandra Cherubini,A,Republican Period,7,-100,-30,70,0.40000001
6487,Mandra Cherubini,A,Early Imperial Period,8,-30,100,130,0.40000001
6487,Mandra Cherubini,A,Mid-Imperial Period,9,100,300,200,0.40000001
6487,Mandra Cherubini,A,Late Imperial Period,10,300,500,200,0.40000001
6488,Mandra Ciolli,A,Mid-Imperial Period,9,100,300,200,0.1
6488,Mandra Ciolli,A,Late Imperial Period,10,300,400,100,0.1
6489,Campo Morto,A,Republican Period,7,-100,-30,70,0.1
6489,Campo Morto,A,Early Imperial Period,8,-30,100,130,0.1
6490,Campo Morto,A,Early Imperial Period,8,-30,100,130,0.1
6490,Campo Morto,A,Mid-Imperial Period,9,100,300,200,0.1
6491,Tenuta Pian d'Arcione,A,Late Iron Age,5,-700,-580,120,0.1
6491,Tenuta Pian d'Arcione,A,Archaic Period,6,-580,-350,230,0.1
6491,Tenuta Pian d'Arcione,A,Republican Period,7,-350,-200,150,0.1
6492,Tenuta Pian d'Arcione,A,Republican Period,7,-300,-30,270,1
6492,Tenuta Pian d'Arcione,A,Early Imperial Period,8,-30,100,130,1
6492,Tenuta Pian d'Arcione,A,Mid-Imperial Period,9,100,300,200,1
6492,Tenuta Pian d'Arcione,A,Late Imperial Period,10,300,400,100,1
6493,Tenuta Pian d'Arcione,A,Early Imperial Period,8,-30,100,130,0.1
6493,Tenuta Pian d'Arcione,A,Mid-Imperial Period,9,100,300,200,0.1
6493,Tenuta Pian d'Arcione,A,Late Imperial Period,10,300,500,200,0.1
6494,Lestra d'Asti,A,Republican Period,7,-50,-30,20,0.02
6494,Lestra d'Asti,A,Early Imperial Period,8,-30,100,130,0.02
6495,Tenuta Pian d'Arcione,A,Republican Period,7,-350,-200,150,0.02
6496,Macchia Pian d'Arcione,A,Early Imperial Period,8,0,100,100,0.1
6497,Tenuta Pian d'Arcione,A,Republican Period,7,-300,-30,270,0.02
6498,Bosco delle Cavalline,A,Republican Period,7,-300,-30,270,0.039999999
6499,Bosco delle Cavalline,A,Late Iron Age,5,-700,-580,120,0.059999999
6499,Bosco delle Cavalline,A,Archaic Period,6,-580,-350,230,0.059999999
6499,Bosco delle Cavalline,A,Republican Period,7,-350,-300,50,0.059999999
6500,Porto delle Murelle,A,Republican Period,7,-100,-30,70,0.30000001
6500,Porto delle Murelle,A,Early Imperial Period,8,-30,100,130,0.30000001
6500,Porto delle Murelle,A,Mid-Imperial Period,9,100,300,200,0.30000001
6500,Porto delle Murelle,A,Late Imperial Period,10,300,500,200,0.30000001
6501,Mandra Ceroti,A,Republican Period,7,-300,-30,270,0.2
6501,Mandra Ceroti,A,Early Imperial Period,8,-30,100,130,0.2
6501,Mandra Ceroti,A,Mid-Imperial Period,9,100,200,100,0.2
6502,Mandra Ceroti,A,Late Imperial Period,10,300,500,200,0.059999999
6503,Mandra Ceroti,A,Republican Period,7,-100,-30,70,0.039999999
6503,Mandra Ceroti,A,Early Imperial Period,8,-30,100,130,0.039999999
6503,Mandra Ceroti,A,Mid-Imperial Period,9,100,200,100,0.039999999
6504,Mandra Ceroti,A,Mid-Imperial Period,9,100,300,200,0.5
6504,Mandra Ceroti,A,Late Imperial Period,10,300,500,200,0.5
6505,Mandra Grande,A,Republican Period,7,-300,-30,270,0.039999999
6506,Mandra Grande,A,Republican Period,7,-300,-30,270,0.2
6506,Mandra Grande,A,Early Imperial Period,8,-30,100,130,0.2
6506,Mandra Grande,A,Mid-Imperial Period,9,100,300,200,0.2
6506,Mandra Grande,A,Late Imperial Period,10,300,500,200,0.2
6507,Tenuta Pian d'Arcione Tarquinia,A,Republican Period,7,-350,-30,320,0.1
6507,Tenuta Pian d'Arcione Tarquinia,A,Early Imperial Period,8,-30,100,130,0.1
6508,Tenuta Pian d'Arcione,A,Early Imperial Period,8,-30,100,130,2
6508,Tenuta Pian d'Arcione,A,Mid-Imperial Period,9,100,300,200,2
6508,Tenuta Pian d'Arcione,A,Late Imperial Period,10,300,500,200,2
6509,La Piana di S. Pietro,A,Republican Period,7,-300,-30,270,0.5
6509,La Piana di S. Pietro,A,Early Imperial Period,8,-30,100,130,0.5
6509,La Piana di S. Pietro,A,Mid-Imperial Period,9,100,300,200,0.5
6509,La Piana di S. Pietro,A,Late Imperial Period,10,300,500,200,0.5
6510,Valfragida,A,Republican Period,7,-300,-30,270,0.029999999
6511,Bosco delle Cavalline,A,Republican Period,7,-300,-30,270,0.039999999
6512,Selvaccia,A,Republican Period,7,-100,-30,70,0.1
6512,Selvaccia,A,Early Imperial Period,8,-30,100,130,0.1
6513,Selvaccia,A,Archaic Period,6,-400,-350,50,0.02
6513,Selvaccia,A,Republican Period,7,-350,-200,150,0.02
6514,Valfragida,A,Republican Period,7,-100,-30,70,0.1
6514,Valfragida,A,Early Imperial Period,8,-30,100,130,0.1
6515,Valfragida,A,Republican Period,7,-300,-30,270,0.2
6515,Valfragida,A,Early Imperial Period,8,-30,100,130,0.2
6515,Valfragida,A,Mid-Imperial Period,9,100,200,100,0.2
6516,Selvaccia,A,Republican Period,7,-300,-30,270,0.039999999
6517,Bosco delle Cavalline,A,Republican Period,7,-50,-30,20,0.1
6517,Bosco delle Cavalline,A,Early Imperial Period,8,-30,100,130,0.1
6517,Bosco delle Cavalline,A,Mid-Imperial Period,9,100,200,100,0.1
6518,Lestra d'Asti,A,Republican Period,7,-100,-30,70,0.69999999
6518,Lestra d'Asti,A,Early Imperial Period,8,-30,100,130,0.69999999
6518,Lestra d'Asti,A,Mid-Imperial Period,9,100,300,200,0.69999999
6518,Lestra d'Asti,A,Late Imperial Period,10,300,500,200,0.69999999
6519,Bosco delle Cavalline,A,Republican Period,7,-300,-100,200,0.059999999
6520,Selvaccia,A,Republican Period,7,-300,-30,270,0.01
6521,Bosco delle Cavalline,A,Republican Period,7,-200,-30,170,0.1
6521,Bosco delle Cavalline,A,Early Imperial Period,8,-30,100,130,0.1
6522,Selvaccia,A,Republican Period,7,-100,-30,70,0.1
6522,Selvaccia,A,Early Imperial Period,8,-30,100,130,0.1
6523,Selvaccia,A,Republican Period,7,-300,-30,270,0.029999999
6524,Selvaccia,A,Late Iron Age,5,-600,-580,20,0.029999999
6524,Selvaccia,A,Archaic Period,6,-580,-350,230,0.029999999
6524,Selvaccia,A,Republican Period,7,-350,-200,150,0.029999999
6525,Selvaccia,A,Republican Period,7,-200,-30,170,0.1
6525,Selvaccia,A,Early Imperial Period,8,-30,100,130,0.1
6526,Selvaccia,A,Republican Period,7,-300,-30,270,0.039999999
6527,Bosco delle Cavalline,A,Republican Period,7,-200,-100,100,0.039999999
6528,Lestra dell'Ospedale,A,Republican Period,7,-300,-30,270,0.039999999
6529,Lestra dell'Ospedale,A,Republican Period,7,-300,-30,270,0.050000001
6530,Il Poderino,A,Republican Period,7,-300,-30,270,0.1
6530,Il Poderino,A,Early Imperial Period,8,-30,100,130,0.1
6531,Podere Arrone,A,Mid-Imperial Period,9,100,300,200,0.2
6532,Valfragida,A,Republican Period,7,-300,-30,270,0.1
6533,Selvaccia,A,Republican Period,7,-200,-30,170,0.039999999
6534,Selvaccia,A,Republican Period,7,-300,-30,270,0.059999999
6535,Selvaccia,A,Republican Period,7,-300,-100,200,0.1
6536,Selvaccia,A,Republican Period,7,-100,-30,70,0.039999999
6536,Selvaccia,A,Early Imperial Period,8,-30,100,130,0.039999999
6537,Valfragida,A,Republican Period,7,-300,-200,100,0.02
6538,Valfragida,A,Republican Period,7,-100,-30,70,0.079999998
6538,Valfragida,A,Early Imperial Period,8,-30,100,130,0.079999998
6538,Valfragida,A,Mid-Imperial Period,9,100,200,100,0.079999998
6539,Valfragida,A,Republican Period,7,-100,-30,70,0.039999999
6539,Valfragida,A,Early Imperial Period,8,-30,100,130,0.039999999
6540,I Due Ponti,A,Republican Period,7,-300,-30,270,1.5
6540,I Due Ponti,A,Early Imperial Period,8,-30,100,130,1.5
6540,I Due Ponti,A,Mid-Imperial Period,9,100,300,200,1.5
6540,I Due Ponti,A,Late Imperial Period,10,300,500,200,1.5
6541,Gramiccia,A,Republican Period,7,-200,-30,170,0.059999999
6542,Gramiccia,A,Republican Period,7,-300,-30,270,0.050000001
6543,Spinicci,A,Early Imperial Period,8,-30,100,130,0.059999999
6543,Spinicci,A,Mid-Imperial Period,9,100,300,200,0.059999999
6543,Spinicci,A,Late Imperial Period,10,300,500,200,0.059999999
6544,Spinicci,A,Late Iron Age,5,-600,-580,20,0.039999999
6544,Spinicci,A,Archaic Period,6,-580,-350,230,0.039999999
6544,Spinicci,A,Republican Period,7,-350,-30,320,0.039999999
6544,Spinicci,A,Early Imperial Period,8,-30,100,130,0.039999999
6544,Spinicci,A,Mid-Imperial Period,9,100,300,200,0.039999999
6544,Spinicci,A,Late Imperial Period,10,300,500,200,0.039999999
6545,Spinicci,A,Republican Period,7,-300,-30,270,0.1
6546,Tenuta Vaccareccia,A,Republican Period,7,-100,-30,70,0.1
6546,Tenuta Vaccareccia,A,Early Imperial Period,8,-30,100,130,0.1
6546,Tenuta Vaccareccia,A,Mid-Imperial Period,9,100,300,200,0.1
6547,Capannone,A,Republican Period,7,-300,-30,270,0.01
6548,Tenuta Vaccareccia,A,Republican Period,7,-300,-30,270,0.2
6549,Il Gesso,A,Republican Period,7,-200,-30,170,0.30000001
6549,Il Gesso,A,Early Imperial Period,8,-30,100,130,0.30000001
6549,Il Gesso,A,Mid-Imperial Period,9,100,300,200,0.30000001
6549,Il Gesso,A,Late Imperial Period,10,300,400,100,0.30000001
6550,Il Gesso,A,Republican Period,7,-300,-30,270,0.1
6551,Tenuta Vaccareccia,A,Republican Period,7,-100,-30,70,0.1
6551,Tenuta Vaccareccia,A,Early Imperial Period,8,-30,100,130,0.1
6552,La Cesa,A,Republican Period,7,-300,-30,270,0.059999999
6553,La Cesa,A,Late Iron Age,5,-600,-580,20,0.039999999
6553,La Cesa,A,Archaic Period,6,-580,-350,230,0.039999999
6553,La Cesa,A,Republican Period,7,-350,-300,50,0.039999999
6554,Cazzanello,A,Republican Period,7,-100,-30,70,0.5
6554,Cazzanello,A,Early Imperial Period,8,-30,100,130,0.5
6554,Cazzanello,A,Mid-Imperial Period,9,100,300,200,0.5
6554,Cazzanello,A,Late Imperial Period,10,300,500,200,0.5
6555,Cazzanello,A,Mid-Imperial Period,9,100,300,200,0.1
6556,Vaccareccia,A,Late Iron Age,5,-600,-580,20,0.40000001
6556,Vaccareccia,A,Archaic Period,6,-580,-350,230,0.40000001
6556,Vaccareccia,A,Republican Period,7,-350,-30,320,0.40000001
6557,Tenuta Vaccareccia,A,Republican Period,7,-300,-100,200,0.1
6558,Piatanete,A,Republican Period,7,-200,-30,170,0.1
6559,Piatanete,A,Republican Period,7,-100,-30,70,0.1
6560,Piatanete,A,Republican Period,7,-200,-30,170,0.1
6561,Il Gesso,A,Republican Period,7,-100,-30,70,0.039999999
6561,Il Gesso,A,Early Imperial Period,8,-30,100,130,0.039999999
6561,Il Gesso,A,Mid-Imperial Period,9,100,300,200,0.039999999
6561,Il Gesso,A,Late Imperial Period,10,300,400,100,0.039999999
6562,Valliardo,A,Republican Period,7,-100,-30,70,0.2
6562,Valliardo,A,Early Imperial Period,8,-30,100,130,0.2
6562,Valliardo,A,Mid-Imperial Period,9,100,300,200,0.2
6563,Valliardo,A,Republican Period,7,-100,-30,70,0.050000001
6563,Valliardo,A,Early Imperial Period,8,-30,100,130,0.050000001
6564,Valliardo,A,Republican Period,7,-300,-100,200,0.059999999
6565,Valliardo,A,Republican Period,7,-100,-30,70,0.2
6565,Valliardo,A,Early Imperial Period,8,-30,100,130,0.2
6565,Valliardo,A,Mid-Imperial Period,9,100,300,200,0.2
6565,Valliardo,A,Late Imperial Period,10,300,400,100,0.2
6566,Valliardo,A,Republican Period,7,-100,-30,70,0.1
6566,Valliardo,A,Early Imperial Period,8,-30,100,130,0.1
6566,Valliardo,A,Mid-Imperial Period,9,100,300,200,0.1
6566,Valliardo,A,Late Imperial Period,10,300,350,50,0.1
6567,Valliardo,A,Republican Period,7,-100,-30,70,0.2
6567,Valliardo,A,Early Imperial Period,8,-30,100,130,0.2
6568,Valliardo,A,Republican Period,7,-200,-30,170,0.30000001
6568,Valliardo,A,Early Imperial Period,8,-30,100,130,0.30000001
6568,Valliardo,A,Mid-Imperial Period,9,100,200,100,0.30000001
6569,Pian di Spille,A,Republican Period,7,-300,-30,270,0.059999999
6570,Pian di Spille,A,Republican Period,7,-100,-30,70,0.039999999
6570,Pian di Spille,A,Early Imperial Period,8,-30,100,130,0.039999999
6570,Pian di Spille,A,Mid-Imperial Period,9,100,200,100,0.039999999
6571,Pian di Spille,A,Republican Period,7,-300,-30,270,0.2
6571,Pian di Spille,A,Early Imperial Period,8,-30,100,130,0.2
6571,Pian di Spille,A,Mid-Imperial Period,9,100,300,200,0.2
6571,Pian di Spille,A,Late Imperial Period,10,300,400,100,0.2
6572,Voltone,A,Republican Period,7,-100,-30,70,0.029999999
6573,Casale Voltone,A,Republican Period,7,-100,-30,70,0.69999999
6573,Casale Voltone,A,Early Imperial Period,8,-30,100,130,0.69999999
6573,Casale Voltone,A,Mid-Imperial Period,9,100,300,200,0.69999999
6573,Casale Voltone,A,Late Imperial Period,10,300,400,100,0.69999999
6574,Voltone,A,Republican Period,7,-100,-30,70,0.40000001
6574,Voltone,A,Early Imperial Period,8,-30,100,130,0.40000001
6574,Voltone,A,Mid-Imperial Period,9,100,300,200,0.40000001
6575,Arcipretura,A,Republican Period,7,-300,-30,270,0.1
6575,Arcipretura,A,Early Imperial Period,8,-30,100,130,0.1
6575,Arcipretura,A,Mid-Imperial Period,9,100,300,200,0.1
6575,Arcipretura,A,Late Imperial Period,10,300,500,200,0.1
6576,Procoio,A,Republican Period,7,-300,-30,270,0.079999998
6576,Procoio,A,Early Imperial Period,8,-30,50,80,0.079999998
6577,Brocchialone,A,Republican Period,7,-300,-30,270,0.090000004
6577,Brocchialone,A,Early Imperial Period,8,-30,50,80,0.090000004
6578,Portaccia,A,Republican Period,7,-300,-30,270,0.090000004
6578,Portaccia,A,Early Imperial Period,8,-30,50,80,0.090000004
6579,Portaccia,A,Republican Period,7,-300,-30,270,0.090000004
6579,Portaccia,A,Early Imperial Period,8,-30,50,80,0.090000004
6580,Portaccia,A,Republican Period,7,-300,-30,270,0.12
6580,Portaccia,A,Early Imperial Period,8,-30,100,130,0.12
6581,Piane del Mignone,A,Republican Period,7,-300,-30,270,0.1
6581,Piane del Mignone,A,Early Imperial Period,8,-30,100,130,0.1
6581,Piane del Mignone,A,Mid-Imperial Period,9,100,300,200,0.1
6581,Piane del Mignone,A,Late Imperial Period,10,300,500,200,0.1
6582,Poggio della Nebbia,A,Republican Period,7,-300,-30,270,0.5
6582,Poggio della Nebbia,A,Early Imperial Period,8,-30,100,130,0.5
6582,Poggio della Nebbia,A,Mid-Imperial Period,9,100,300,200,0.5
6582,Poggio della Nebbia,A,Late Imperial Period,10,300,500,200,0.5
6583,Monna Felice,A,Republican Period,7,-300,-30,270,0.1
6583,Monna Felice,A,Early Imperial Period,8,-30,100,130,0.1
6583,Monna Felice,A,Mid-Imperial Period,9,100,300,200,0.1
6583,Monna Felice,A,Late Imperial Period,10,300,500,200,0.1
6584,Fontana di Campo Reale,A,Republican Period,7,-300,-30,270,0.079999998
6584,Fontana di Campo Reale,A,Early Imperial Period,8,-30,100,130,0.079999998
6584,Fontana di Campo Reale,A,Mid-Imperial Period,9,100,300,200,0.079999998
6584,Fontana di Campo Reale,A,Late Imperial Period,10,300,500,200,0.079999998
6585,Torre Valdaliga,A,Early Imperial Period,8,-30,100,130,4.5
6585,Torre Valdaliga,A,Mid-Imperial Period,9,100,300,200,4.5
6585,Torre Valdaliga,A,Late Imperial Period,10,300,500,200,4.5
6586,Frassinello,A,Republican Period,7,-300,-30,270,0.090000004
6586,Frassinello,A,Early Imperial Period,8,-30,100,130,0.090000004
6586,Frassinello,A,Mid-Imperial Period,9,100,300,200,0.090000004
6586,Frassinello,A,Late Imperial Period,10,300,500,200,0.090000004
6587,Monna Felice,A,Republican Period,7,-300,-30,270,0.079999998
6587,Monna Felice,A,Early Imperial Period,8,-30,50,80,0.079999998
6588,Campo Reale,A,Republican Period,7,-300,-30,270,0.079999998
6588,Campo Reale,A,Early Imperial Period,8,-30,100,130,0.079999998
6589,Campo Reale,A,Republican Period,7,-300,-30,270,0.079999998
6589,Campo Reale,A,Early Imperial Period,8,-30,50,80,0.079999998
6590,Pontone di Valle,A,Republican Period,7,-300,-30,270,0.5
6590,Pontone di Valle,A,Early Imperial Period,8,-30,100,130,0.5
6590,Pontone di Valle,A,Mid-Imperial Period,9,100,300,200,0.5
6590,Pontone di Valle,A,Late Imperial Period,10,300,500,200,0.5
6591,Riserva delle Capanne,A,Republican Period,7,-300,-30,270,0.2
6591,Riserva delle Capanne,A,Early Imperial Period,8,-30,100,130,0.2
6591,Riserva delle Capanne,A,Mid-Imperial Period,9,100,300,200,0.2
6591,Riserva delle Capanne,A,Late Imperial Period,10,300,500,200,0.2
6592,Mandorleto,A,Republican Period,7,-300,-30,270,0.079999998
6592,Mandorleto,A,Early Imperial Period,8,-30,50,80,0.079999998
6593,Chiusi (Clusium),A,Late Bronze Age,3,-1200,-1020,180,20.282118
6593,Chiusi (Clusium),A,Early Iron Age,4,-1020,-750,270,20.282118
6593,Chiusi (Clusium),A,Late Iron Age,5,-750,-580,170,20.282118
6593,Chiusi (Clusium),A,Archaic Period,6,-580,-350,230,20.282118
6593,Chiusi (Clusium),A,Republican Period,7,-350,-30,320,20.282118
6593,Chiusi (Clusium),A,Early Imperial Period,8,-30,100,130,20.282118
6593,Chiusi (Clusium),A,Mid-Imperial Period,9,100,300,200,20.282118
6593,Chiusi (Clusium),A,Late Imperial Period,10,300,500,200,20.282118
6594,Passo Corese,A,Early Imperial Period,8,-30,100,130,0.15000001
6594,Passo Corese,A,Mid-Imperial Period,9,100,300,200,0.15000001
6594,Passo Corese,A,Late Imperial Period,10,300,500,200,0.15000001
6595,Passo Corese,A,Republican Period,7,-300,-30,270,0.2
6595,Passo Corese,A,Early Imperial Period,8,-30,100,130,0.2
6595,Passo Corese,A,Mid-Imperial Period,9,100,200,100,0.2
6596,Casacotta (Eretum),A,Early Iron Age,4,-800,-750,50,17.946911
6596,Casacotta (Eretum),A,Late Iron Age,5,-750,-580,170,17.946911
6596,Casacotta (Eretum),A,Archaic Period,6,-580,-350,230,17.946911
6596,Casacotta (Eretum),A,Republican Period,7,-350,-300,50,17.946911
6597,Valle della Mola,A,Republican Period,7,-300,-30,270,1.5623657
6597,Valle della Mola,A,Early Imperial Period,8,-30,100,130,1.5623657
6597,Valle della Mola,A,Mid-Imperial Period,9,100,300,200,1.5623657
6597,Valle della Mola,A,Late Imperial Period,10,300,500,200,1.5623657
6598,Valle della Mola,A,Late Iron Age,5,-600,-580,20,0.71313858
6598,Valle della Mola,A,Archaic Period,6,-580,-500,80,0.71313858
6598,Valle della Mola,B,Republican Period,7,-300,-100,200,0.71313858
6598,Valle della Mola,C,Early Imperial Period,8,0,100,100,0.71313858
6599,Aviatina,A,Late Iron Age,5,-700,-580,120,0.18678774
6599,Aviatina,A,Archaic Period,6,-580,-500,80,0.18678774
6599,Aviatina,B,Early Imperial Period,8,0,100,100,0.18678774
6599,Aviatina,B,Mid-Imperial Period,9,100,200,100,0.18678774
6600,Aviatina,A,Late Iron Age,5,-600,-580,20,0.057711057
6600,Aviatina,A,Archaic Period,6,-580,-500,80,0.057711057
6600,Aviatina,B,Republican Period,7,-300,-100,200,0.057711057
6601,Poggio dell'Asino,A,Late Bronze Age,3,-1200,-1020,180,0.066929542
6601,Poggio dell'Asino,A,Early Iron Age,4,-1020,-1000,20,0.066929542
6601,Poggio dell'Asino,B,Late Iron Age,5,-700,-600,100,0.066929542
6601,Poggio dell'Asino,C,Republican Period,7,-300,-100,200,0.066929542
6602,Migliore di Zambria,A,Mid-Imperial Period,9,200,300,100,0.038272869
6602,Migliore di Zambria,A,Late Imperial Period,10,300,500,200,0.038272869
6603,Migliore di Zambria,A,Republican Period,7,-200,-30,170,0.25997028
6603,Migliore di Zambria,A,Early Imperial Period,8,-30,100,130,0.25997028
6603,Migliore di Zambria,A,Mid-Imperial Period,9,100,200,100,0.25997028
6604,Madonna del Canneto,A,Republican Period,7,-200,-30,170,0.72383016
6604,Madonna del Canneto,A,Early Imperial Period,8,-30,100,130,0.72383016
6604,Madonna del Canneto,A,Mid-Imperial Period,9,100,300,200,0.72383016
6604,Madonna del Canneto,A,Late Imperial Period,10,300,400,100,0.72383016
6605,Prato dei Cavalieri,A,Republican Period,7,-200,-30,170,0.089655586
6605,Prato dei Cavalieri,A,Early Imperial Period,8,-30,100,130,0.089655586
6605,Prato dei Cavalieri,A,Mid-Imperial Period,9,100,300,200,0.089655586
6605,Prato dei Cavalieri,A,Late Imperial Period,10,300,500,200,0.089655586
6606,Polledrara,A,Republican Period,7,-300,-30,270,0.045970894
6606,Polledrara,A,Early Imperial Period,8,-30,100,130,0.045970894
6607,Polledrara,A,Republican Period,7,-300,-30,270,1.6196343
6607,Polledrara,A,Early Imperial Period,8,-30,100,130,1.6196343
6607,Polledrara,A,Mid-Imperial Period,9,100,300,200,1.6196343
6607,Polledrara,A,Late Imperial Period,10,300,500,200,1.6196343
6608,Polledrara,A,Late Iron Age,5,-600,-580,20,0.10269883
6608,Polledrara,A,Archaic Period,6,-580,-350,230,0.10269883
6608,Polledrara,A,Republican Period,7,-350,-30,320,0.10269883
6609,M. Abbadone,A,Republican Period,7,-200,-30,170,0.15714106
6609,M. Abbadone,A,Early Imperial Period,8,-30,100,130,0.15714106
6609,M. Abbadone,A,Mid-Imperial Period,9,100,200,100,0.15714106
6610,Migliorie di S. Paolo,A,Late Iron Age,5,-700,-580,120,0.4938114
6610,Migliorie di S. Paolo,A,Archaic Period,6,-580,-500,80,0.4938114
6610,Migliorie di S. Paolo,B,Republican Period,7,-300,-30,270,0.4938114
6610,Migliorie di S. Paolo,B,Early Imperial Period,8,-30,100,130,0.4938114
6610,Migliorie di S. Paolo,B,Mid-Imperial Period,9,100,300,200,0.4938114
6610,Migliorie di S. Paolo,B,Late Imperial Period,10,300,500,200,0.4938114
6611,Ponte Stretto,A,Republican Period,7,-200,-30,170,0.24095973
6611,Ponte Stretto,A,Early Imperial Period,8,-30,100,130,0.24095973
6611,Ponte Stretto,A,Mid-Imperial Period,9,100,300,200,0.24095973
6612,M. Abbadone,A,Late Iron Age,5,-700,-580,120,0.1978409
6612,M. Abbadone,A,Archaic Period,6,-580,-500,80,0.1978409
6612,M. Abbadone,B,Republican Period,7,-300,-30,270,0.1978409
6612,M. Abbadone,B,Early Imperial Period,8,-30,100,130,0.1978409
6612,M. Abbadone,B,Mid-Imperial Period,9,100,300,200,0.1978409
6612,M. Abbadone,B,Late Imperial Period,10,300,500,200,0.1978409
6613,M. Abbadone,A,Late Iron Age,5,-600,-580,20,0.43471521
6613,M. Abbadone,A,Archaic Period,6,-580,-400,180,0.43471521
6614,M. Abbadone,A,Republican Period,7,-300,-100,200,0.066748932
6615,Ponte Stretto,A,Late Iron Age,5,-600,-580,20,0.037771106
6615,Ponte Stretto,A,Archaic Period,6,-580,-400,180,0.037771106
6616,Fosso dei Due Ponti,A,Late Iron Age,5,-600,-580,20,0.027953088
6616,Fosso dei Due Ponti,A,Archaic Period,6,-580,-500,80,0.027953088
6617,Fosso dei Due Ponti,A,Early Bronze Age,1,-2300,-1700,600,0.048688151
6617,Fosso dei Due Ponti,A,Middle Bronze Age,2,-1700,-1300,400,0.048688151
6617,Fosso dei Due Ponti,A,Late Bronze Age,3,-1300,-1020,280,0.048688151
6617,Fosso dei Due Ponti,A,Early Iron Age,4,-1020,-1000,20,0.048688151
6618,Fosso dei Due Ponti,A,Middle Bronze Age,2,-1700,-1300,400,0.081970878
6619,Fosso dei Due Ponti,A,Middle Bronze Age,2,-1700,-1300,400,0.041367777
6620,Fosso dei Due Ponti,A,Early Bronze Age,1,-2300,-1700,600,0.037133422
6620,Fosso dei Due Ponti,A,Middle Bronze Age,2,-1700,-1300,400,0.037133422
6620,Fosso dei Due Ponti,A,Late Bronze Age,3,-1300,-1020,280,0.037133422
6620,Fosso dei Due Ponti,A,Early Iron Age,4,-1020,-1000,20,0.037133422
6621,Fosso dei Due Ponti,A,Republican Period,7,-100,-30,70,0.10735383
6621,Fosso dei Due Ponti,A,Early Imperial Period,8,-30,100,130,0.10735383
6622,M. Abbadone,A,Late Iron Age,5,-600,-580,20,0.06445007
6622,M. Abbadone,A,Archaic Period,6,-580,-500,80,0.06445007
6623,M. Abbadone,A,Republican Period,7,-300,-100,200,0.12504266
6623,M. Abbadone,B,Early Imperial Period,8,0,100,100,0.12504266
6624,Fosso della Maddalena,A,Early Bronze Age,1,-2300,-1700,600,0.028289877
6624,Fosso della Maddalena,A,Middle Bronze Age,2,-1700,-1300,400,0.028289877
6624,Fosso della Maddalena,A,Late Bronze Age,3,-1300,-1020,280,0.028289877
6624,Fosso della Maddalena,A,Early Iron Age,4,-1020,-1000,20,0.028289877
6624,Fosso della Maddalena,B,Late Iron Age,5,-600,-580,20,0.028289877
6624,Fosso della Maddalena,B,Archaic Period,6,-580,-500,80,0.028289877
6624,Fosso della Maddalena,C,Republican Period,7,-300,-200,100,0.028289877
6625,Fosso della Maddalena,A,Late Iron Age,5,-600,-580,20,0.033918709
6625,Fosso della Maddalena,A,Archaic Period,6,-580,-500,80,0.033918709
6625,Fosso della Maddalena,B,Mid-Imperial Period,9,100,300,200,0.033918709
6626,fosso della Maddalena,A,Early Bronze Age,1,-2300,-1700,600,0.19001637
6626,fosso della Maddalena,B,Late Bronze Age,3,-1200,-1020,180,0.19001637
6626,fosso della Maddalena,B,Early Iron Age,4,-1020,-1000,20,0.19001637
6626,fosso della Maddalena,C,Late Iron Age,5,-700,-600,100,0.19001637
6626,fosso della Maddalena,D,Early Imperial Period,8,0,100,100,0.19001637
6627,Macchia della Signora,A,Early Imperial Period,8,0,100,100,0.10195358
6628,Macchia della Signora,A,Late Bronze Age,3,-1300,-1020,280,0.11795206
6628,Macchia della Signora,A,Early Iron Age,4,-1020,-1000,20,0.11795206
6628,Macchia della Signora,B,Late Iron Age,5,-700,-580,120,0.11795206
6628,Macchia della Signora,B,Archaic Period,6,-580,-500,80,0.11795206
6628,Macchia della Signora,C,Republican Period,7,-300,-100,200,0.11795206
6628,Macchia della Signora,D,Early Imperial Period,8,0,100,100,0.11795206
6629,M. Abbadoncino,A,Republican Period,7,-300,-30,270,0.25604665
6629,M. Abbadoncino,A,Early Imperial Period,8,-30,100,130,0.25604665
6629,M. Abbadoncino,A,Mid-Imperial Period,9,100,300,200,0.25604665
6629,M. Abbadoncino,A,Late Imperial Period,10,300,500,200,0.25604665
6630,Valle del Ferraccio,A,Late Iron Age,5,-600,-580,20,0.045208745
6630,Valle del Ferraccio,A,Archaic Period,6,-580,-500,80,0.045208745
6630,Valle del Ferraccio,B,Early Imperial Period,8,0,100,100,0.045208745
6630,Valle del Ferraccio,B,Mid-Imperial Period,9,100,200,100,0.045208745
6631,I Due Ponti,A,Middle Bronze Age,2,-1700,-1300,400,0.028620385
6632,M. Abbadone,A,Early Bronze Age,1,-2300,-1700,600,0.048469868
6632,M. Abbadone,A,Middle Bronze Age,2,-1700,-1300,400,0.048469868
6632,M. Abbadone,A,Late Bronze Age,3,-1300,-1020,280,0.048469868
6632,M. Abbadone,A,Early Iron Age,4,-1020,-1000,20,0.048469868
6632,M. Abbadone,B,Late Iron Age,5,-600,-580,20,0.048469868
6632,M. Abbadone,B,Archaic Period,6,-580,-500,80,0.048469868
6633,Migliorie di S. Paolo,A,Late Iron Age,5,-600,-580,20,0.036033887
6633,Migliorie di S. Paolo,A,Archaic Period,6,-580,-500,80,0.036033887
6633,Migliorie di S. Paolo,B,Early Imperial Period,8,0,100,100,0.036033887
6633,Migliorie di S. Paolo,B,Mid-Imperial Period,9,100,200,100,0.036033887
6634,Ponte Stretto,A,Late Iron Age,5,-600,-580,20,0.052828781
6634,Ponte Stretto,A,Archaic Period,6,-580,-500,80,0.052828781
6634,Ponte Stretto,B,Republican Period,7,-300,-100,200,0.052828781
6635,Macchia della Signora,A,Late Iron Age,5,-600,-580,20,0.066581123
6635,Macchia della Signora,A,Archaic Period,6,-580,-500,80,0.066581123
6635,Macchia della Signora,B,Republican Period,7,-300,-100,200,0.066581123
6636,Migliorie di S. Paolo,A,Late Iron Age,5,-700,-580,120,0.056385867
6636,Migliorie di S. Paolo,A,Archaic Period,6,-580,-500,80,0.056385867
6636,Migliorie di S. Paolo,B,Republican Period,7,-300,-100,200,0.056385867
6637,Migliorie di S. Paolo,A,Late Iron Age,5,-600,-580,20,0.075816184
6637,Migliorie di S. Paolo,A,Archaic Period,6,-580,-500,80,0.075816184
6637,Migliorie di S. Paolo,B,Early Imperial Period,8,0,100,100,0.075816184
6637,Migliorie di S. Paolo,B,Mid-Imperial Period,9,100,300,200,0.075816184
6637,Migliorie di S. Paolo,B,Late Imperial Period,10,300,400,100,0.075816184
6638,Migliorie di Passo di Palo,A,Late Iron Age,5,-600,-580,20,0.039642472
6638,Migliorie di Passo di Palo,A,Archaic Period,6,-580,-500,80,0.039642472
6638,Migliorie di Passo di Palo,B,Republican Period,7,-300,-100,200,0.039642472
6639,Migliorie di Passo di Palo,A,Late Iron Age,5,-600,-580,20,0.031320792
6639,Migliorie di Passo di Palo,A,Archaic Period,6,-580,-500,80,0.031320792
6639,Migliorie di Passo di Palo,B,Republican Period,7,-200,-100,100,0.031320792
6640,Migliorie di Passo di Palo,A,Late Iron Age,5,-600,-580,20,0.02751972
6640,Migliorie di Passo di Palo,A,Archaic Period,6,-580,-500,80,0.02751972
6641,Migliorie di S. Paolo,A,Late Iron Age,5,-600,-580,20,0.035311915
6641,Migliorie di S. Paolo,A,Archaic Period,6,-580,-500,80,0.035311915
6641,Migliorie di S. Paolo,B,Republican Period,7,-300,-30,270,0.035311915
6641,Migliorie di S. Paolo,B,Early Imperial Period,8,-30,100,130,0.035311915
6641,Migliorie di S. Paolo,B,Mid-Imperial Period,9,100,300,200,0.035311915
6641,Migliorie di S. Paolo,B,Late Imperial Period,10,300,500,200,0.035311915
6642,Migliorie di Passo di Palo,A,Late Iron Age,5,-600,-580,20,0.040126421
6642,Migliorie di Passo di Palo,A,Archaic Period,6,-580,-500,80,0.040126421
6642,Migliorie di Passo di Palo,B,Republican Period,7,-300,-100,200,0.040126421
6643,Migliorie di S. Paolo,A,Republican Period,7,-300,-30,270,0.092157163
6643,Migliorie di S. Paolo,A,Early Imperial Period,8,-30,100,130,0.092157163
6643,Migliorie di S. Paolo,A,Mid-Imperial Period,9,100,300,200,0.092157163
6643,Migliorie di S. Paolo,A,Late Imperial Period,10,300,400,100,0.092157163
6644,Migliorie di S. Paolo,A,Late Iron Age,5,-600,-580,20,0.044064224
6644,Migliorie di S. Paolo,A,Archaic Period,6,-580,-500,80,0.044064224
6645,Migliorie di Passo di Paolo,A,Late Iron Age,5,-600,-580,20,0.062733106
6645,Migliorie di Passo di Paolo,A,Archaic Period,6,-580,-500,80,0.062733106
6645,Migliorie di Passo di Paolo,B,Republican Period,7,-300,-100,200,0.062733106
6646,Migliorie di Passo di Palo,A,Late Iron Age,5,-600,-580,20,0.13777119
6646,Migliorie di Passo di Palo,A,Archaic Period,6,-580,-500,80,0.13777119
6646,Migliorie di Passo di Palo,B,Republican Period,7,-300,-100,200,0.13777119
6647,Infernaccio,A,Late Iron Age,5,-600,-580,20,0.061817165
6647,Infernaccio,A,Archaic Period,6,-580,-500,80,0.061817165
6647,Infernaccio,B,Republican Period,7,-300,-200,100,0.061817165
6647,Infernaccio,C,Mid-Imperial Period,9,100,300,200,0.061817165
6648,Porrazzetta,A,Late Iron Age,5,-600,-580,20,0.16626741
6648,Porrazzetta,A,Archaic Period,6,-580,-500,80,0.16626741
6648,Porrazzetta,B,Republican Period,7,-300,-30,270,0.16626741
6648,Porrazzetta,B,Early Imperial Period,8,-30,100,130,0.16626741
6648,Porrazzetta,B,Mid-Imperial Period,9,100,300,200,0.16626741
6649,Porrazzetta,A,Early Bronze Age,1,-2300,-1700,600,0.037620146
6649,Porrazzetta,A,Middle Bronze Age,2,-1700,-1300,400,0.037620146
6649,Porrazzetta,A,Late Bronze Age,3,-1300,-1020,280,0.037620146
6649,Porrazzetta,A,Early Iron Age,4,-1020,-1000,20,0.037620146
6650,Porrazzetta,A,Republican Period,7,-300,-30,270,0.51974458
6650,Porrazzetta,A,Early Imperial Period,8,-30,100,130,0.51974458
6650,Porrazzetta,A,Mid-Imperial Period,9,100,300,200,0.51974458
6650,Porrazzetta,A,Late Imperial Period,10,300,400,100,0.51974458
6651,La Croce Bianca,A,Early Imperial Period,8,-30,100,130,0.15142918
6651,La Croce Bianca,A,Mid-Imperial Period,9,100,300,200,0.15142918
6652,La Croce Bianca,A,Republican Period,7,-200,-30,170,1.4633455
6652,La Croce Bianca,A,Early Imperial Period,8,-30,100,130,1.4633455
6652,La Croce Bianca,A,Mid-Imperial Period,9,100,300,200,1.4633455
6652,La Croce Bianca,A,Late Imperial Period,10,300,500,200,1.4633455
6653,Porrazeta,A,Late Iron Age,5,-600,-580,20,0.076595709
6653,Porrazeta,A,Archaic Period,6,-580,-500,80,0.076595709
6653,Porrazeta,B,Early Imperial Period,8,0,100,100,0.076595709
6654,Porazzeta,A,Early Imperial Period,8,0,100,100,0.032763336
6654,Porazzeta,A,Mid-Imperial Period,9,100,300,200,0.032763336
6655,Porazzetta,A,Late Iron Age,5,-600,-580,20,0.026940158
6655,Porazzetta,A,Archaic Period,6,-580,-500,80,0.026940158
6655,Porazzetta,B,Republican Period,7,-300,-30,270,0.026940158
6655,Porazzetta,B,Early Imperial Period,8,-30,100,130,0.026940158
6655,Porazzetta,B,Mid-Imperial Period,9,100,300,200,0.026940158
6655,Porazzetta,B,Late Imperial Period,10,300,500,200,0.026940158
6656,Porazzetta,A,Late Iron Age,5,-600,-580,20,0.041132256
6656,Porazzetta,A,Archaic Period,6,-580,-500,80,0.041132256
6656,Porazzetta,B,Early Imperial Period,8,0,100,100,0.041132256
6657,Porrazzeta,A,Early Imperial Period,8,0,100,100,0.048448678
6657,Porrazzeta,A,Mid-Imperial Period,9,100,200,100,0.048448678
6658,Porrazzeta,A,Late Iron Age,5,-600,-580,20,0.14791168
6658,Porrazzeta,A,Archaic Period,6,-580,-500,80,0.14791168
6658,Porrazzeta,B,Republican Period,7,-300,-30,270,0.14791168
6658,Porrazzeta,B,Early Imperial Period,8,-30,100,130,0.14791168
6658,Porrazzeta,B,Mid-Imperial Period,9,100,200,100,0.14791168
6659,Porrazzeta,A,Late Iron Age,5,-600,-580,20,0.39685339
6659,Porrazzeta,A,Archaic Period,6,-580,-500,80,0.39685339
6659,Porrazzeta,B,Republican Period,7,-200,-30,170,0.39685339
6659,Porrazzeta,B,Early Imperial Period,8,-30,100,130,0.39685339
6659,Porrazzeta,B,Mid-Imperial Period,9,100,200,100,0.39685339
6660,Porrazzeta,A,Late Iron Age,5,-600,-580,20,0.040605474
6660,Porrazzeta,A,Archaic Period,6,-580,-350,230,0.040605474
6660,Porrazzeta,B,Republican Period,7,-350,-30,320,0.040605474
6660,Porrazzeta,B,Early Imperial Period,8,-30,100,130,0.040605474
6661,Porrazzeta,A,Late Iron Age,5,-600,-580,20,0.056820329
6661,Porrazzeta,A,Archaic Period,6,-580,-500,80,0.056820329
6662,Porrazzeta,A,Late Iron Age,5,-600,-580,20,0.057730384
6662,Porrazzeta,A,Archaic Period,6,-580,-500,80,0.057730384
6662,Porrazzeta,B,Republican Period,7,-300,-30,270,0.057730384
6662,Porrazzeta,B,Early Imperial Period,8,-30,100,130,0.057730384
6662,Porrazzeta,B,Mid-Imperial Period,9,100,300,200,0.057730384
6662,Porrazzeta,B,Late Imperial Period,10,300,500,200,0.057730384
6663,Fontanile Muggiasca,A,Late Iron Age,5,-600,-580,20,0.037472226
6663,Fontanile Muggiasca,A,Archaic Period,6,-580,-500,80,0.037472226
6663,Fontanile Muggiasca,B,Republican Period,7,-300,-30,270,0.037472226
6663,Fontanile Muggiasca,B,Early Imperial Period,8,-30,100,130,0.037472226
6663,Fontanile Muggiasca,B,Mid-Imperial Period,9,100,300,200,0.037472226
6663,Fontanile Muggiasca,B,Late Imperial Period,10,300,500,200,0.037472226
6664,Pian Cerese,A,Late Iron Age,5,-600,-580,20,0.24081898
6664,Pian Cerese,A,Archaic Period,6,-580,-500,80,0.24081898
6664,Pian Cerese,B,Early Imperial Period,8,0,100,100,0.24081898
6664,Pian Cerese,B,Mid-Imperial Period,9,100,300,200,0.24081898
6665,Piano Sanguinara,A,Late Iron Age,5,-700,-580,120,0.11338722
6665,Piano Sanguinara,A,Archaic Period,6,-580,-500,80,0.11338722
6666,Piano Sanguinara,A,Mid-Imperial Period,9,100,300,200,0.21291728
6666,Piano Sanguinara,A,Late Imperial Period,10,300,400,100,0.21291728
6667,Poggio,A,Late Iron Age,5,-600,-580,20,0.053319465
6667,Poggio,A,Archaic Period,6,-580,-400,180,0.053319465
6668,La Sentinella,A,Late Iron Age,5,-600,-580,20,0.46908921
6668,La Sentinella,A,Archaic Period,6,-580,-500,80,0.46908921
6668,La Sentinella,B,Republican Period,7,-200,-30,170,0.46908921
6668,La Sentinella,B,Early Imperial Period,8,-30,100,130,0.46908921
6668,La Sentinella,B,Mid-Imperial Period,9,100,200,100,0.46908921
6669,Statua,A,Early Imperial Period,8,-30,100,130,3.0568321
6669,Statua,A,Mid-Imperial Period,9,100,300,200,3.0568321
6669,Statua,A,Late Imperial Period,10,300,500,200,3.0568321
6670,Ponte del Lupo,A,Late Iron Age,5,-700,-580,120,0.83945644
6670,Ponte del Lupo,A,Archaic Period,6,-580,-350,230,0.83945644
6670,Ponte del Lupo,A,Republican Period,7,-350,-300,50,0.83945644
6671,Grottoni,A,Mid-Imperial Period,9,100,300,200,0.14608252
6671,Grottoni,A,Late Imperial Period,10,300,500,200,0.14608252
6671,Grottoni,A,Late Antique Period,11,500,600,100,0.14608252
6672,Ponte del Lupo,A,Late Iron Age,5,-600,-580,20,0.64811885
6672,Ponte del Lupo,A,Archaic Period,6,-580,-500,80,0.64811885
6672,Ponte del Lupo,B,Republican Period,7,-200,-30,170,0.64811885
6672,Ponte del Lupo,B,Early Imperial Period,8,-30,100,130,0.64811885
6672,Ponte del Lupo,B,Mid-Imperial Period,9,100,300,200,0.64811885
6673,Ponte del Lupo,A,Late Iron Age,5,-600,-580,20,0.87574512
6673,Ponte del Lupo,A,Archaic Period,6,-580,-500,80,0.87574512
6674,S. Nicola,A,Late Iron Age,5,-700,-580,120,0.059746888
6674,S. Nicola,A,Archaic Period,6,-580,-350,230,0.059746888
6674,S. Nicola,A,Republican Period,7,-350,-30,320,0.059746888
6674,S. Nicola,A,Early Imperial Period,8,-30,100,130,0.059746888
6674,S. Nicola,A,Mid-Imperial Period,9,100,300,200,0.059746888
6674,S. Nicola,A,Late Imperial Period,10,300,500,200,0.059746888
6675,S. Nicola,A,Republican Period,7,-300,-30,270,0.09771879
6675,S. Nicola,A,Early Imperial Period,8,-30,100,130,0.09771879
6675,S. Nicola,A,Mid-Imperial Period,9,100,300,200,0.09771879
6676,S. Nicola,A,Late Iron Age,5,-600,-580,20,0.062058546
6676,S. Nicola,A,Archaic Period,6,-580,-500,80,0.062058546
6677,fosso Cupino,A,Archaic Period,6,-400,-350,50,0.050884899
6677,fosso Cupino,A,Republican Period,7,-350,-200,150,0.050884899
6677,fosso Cupino,B,Early Imperial Period,8,0,100,100,0.050884899
6677,fosso Cupino,B,Mid-Imperial Period,9,100,200,100,0.050884899
6678,Quarticciolo,A,Late Iron Age,5,-600,-580,20,0.078260258
6678,Quarticciolo,A,Archaic Period,6,-580,-500,80,0.078260258
6678,Quarticciolo,B,Early Imperial Period,8,0,100,100,0.078260258
6678,Quarticciolo,B,Mid-Imperial Period,9,100,200,100,0.078260258
6679,Quarticciolo,A,Republican Period,7,-200,-30,170,0.07941433
6679,Quarticciolo,A,Early Imperial Period,8,-30,100,130,0.07941433
6679,Quarticciolo,A,Mid-Imperial Period,9,100,300,200,0.07941433
6680,Quarticciolo,A,Early Imperial Period,8,0,100,100,0.15654992
6680,Quarticciolo,A,Mid-Imperial Period,9,100,200,100,0.15654992
6681,S. Nicola,A,Early Bronze Age,1,-2300,-1700,600,0.042064968
6681,S. Nicola,A,Middle Bronze Age,2,-1700,-1300,400,0.042064968
6681,S. Nicola,A,Late Bronze Age,3,-1300,-1020,280,0.042064968
6681,S. Nicola,A,Early Iron Age,4,-1020,-1000,20,0.042064968
6681,S. Nicola,B,Late Iron Age,5,-600,-580,20,0.042064968
6681,S. Nicola,B,Archaic Period,6,-580,-500,80,0.042064968
6682,S. Nicola,A,Late Iron Age,5,-600,-580,20,0.066104621
6682,S. Nicola,A,Archaic Period,6,-580,-500,80,0.066104621
6682,S. Nicola,B,Late Imperial Period,10,300,500,200,0.066104621
6683,S. Nicola,A,Late Iron Age,5,-600,-580,20,0.061477944
6683,S. Nicola,A,Archaic Period,6,-580,-500,80,0.061477944
6684,Palo,A,Late Iron Age,5,-600,-580,20,0.13157497
6684,Palo,A,Archaic Period,6,-580,-500,80,0.13157497
6684,Palo,B,Early Imperial Period,8,0,100,100,0.13157497
6684,Palo,B,Mid-Imperial Period,9,100,200,100,0.13157497
6685,Parco di Palo,A,Late Iron Age,5,-700,-580,120,0.058485948
6685,Parco di Palo,A,Archaic Period,6,-580,-500,80,0.058485948
6686,Parco di Palo,A,Late Iron Age,5,-700,-580,120,0.033818524
6686,Parco di Palo,A,Archaic Period,6,-580,-500,80,0.033818524
6687,Parco di Palo,A,Late Iron Age,5,-600,-580,20,0.047644205
6687,Parco di Palo,A,Archaic Period,6,-580,-500,80,0.047644205
6688,Parco di Palo,A,Late Iron Age,5,-600,-580,20,0.25372076
6688,Parco di Palo,A,Archaic Period,6,-580,-400,180,0.25372076
6689,Parco di Palo,A,Mid-Imperial Period,9,100,300,200,0.030204574
6690,Fosso Sanguinara,A,Early Imperial Period,8,0,100,100,5.6105227
6690,Fosso Sanguinara,A,Mid-Imperial Period,9,100,300,200,5.6105227
6691,Cava di Pietra,A,Late Iron Age,5,-600,-580,20,0.066624314
6691,Cava di Pietra,A,Archaic Period,6,-580,-500,80,0.066624314
6691,Cava di Pietra,B,Early Imperial Period,8,0,100,100,0.066624314
6691,Cava di Pietra,B,Mid-Imperial Period,9,100,200,100,0.066624314
6692,S. Nicola,A,Republican Period,7,-100,-30,70,9.7831068
6692,S. Nicola,A,Early Imperial Period,8,-30,100,130,9.7831068
6692,S. Nicola,A,Mid-Imperial Period,9,100,300,200,9.7831068
6692,S. Nicola,A,Late Imperial Period,10,300,500,200,9.7831068
6692,S. Nicola,A,Late Antique Period,11,500,600,100,9.7831068
6693,Palo (Alsium),A,Republican Period,7,-250,-30,220,4.8979225
6693,Palo (Alsium),A,Early Imperial Period,8,-30,100,130,4.8979225
6693,Palo (Alsium),A,Mid-Imperial Period,9,100,300,200,4.8979225
6693,Palo (Alsium),A,Late Imperial Period,10,300,500,200,4.8979225
6693,Palo (Alsium),A,Late Antique Period,11,500,550,50,4.8979225
6694,Infernaccio,A,Late Iron Age,5,-600,-580,20,0.023860859
6694,Infernaccio,A,Archaic Period,6,-580,-500,80,0.023860859
6695,Pian Cerese,A,Late Iron Age,5,-600,-580,20,0.092518024
6695,Pian Cerese,A,Archaic Period,6,-580,-500,80,0.092518024
6695,Pian Cerese,B,Republican Period,7,-200,-30,170,0.092518024
6695,Pian Cerese,B,Early Imperial Period,8,-30,100,130,0.092518024
6695,Pian Cerese,B,Mid-Imperial Period,9,100,300,200,0.092518024
6696,Cervaro,A,Early Imperial Period,8,0,100,100,0.094432093
6696,Cervaro,A,Mid-Imperial Period,9,100,300,200,0.094432093
6697,Le Fornaci,A,Late Iron Age,5,-600,-580,20,0.034907021
6697,Le Fornaci,A,Archaic Period,6,-580,-500,80,0.034907021
6698,Cervaro,A,Early Imperial Period,8,0,100,100,0.058087129
6698,Cervaro,A,Mid-Imperial Period,9,100,300,200,0.058087129
6698,Cervaro,A,Late Imperial Period,10,300,500,200,0.058087129
6699,Le Fornaci,A,Early Imperial Period,8,0,100,100,0.90755022
6699,Le Fornaci,A,Mid-Imperial Period,9,100,300,200,0.90755022
6699,Le Fornaci,A,Late Imperial Period,10,300,500,200,0.90755022
6700,Cervaro,A,Late Iron Age,5,-600,-580,20,0.091560118
6700,Cervaro,A,Archaic Period,6,-580,-350,230,0.091560118
6700,Cervaro,A,Republican Period,7,-350,-300,50,0.091560118
6700,Cervaro,B,Early Imperial Period,8,0,100,100,0.091560118
6701,Il Pigno,A,Late Iron Age,5,-600,-580,20,0.055211458
6701,Il Pigno,A,Archaic Period,6,-580,-500,80,0.055211458
6702,S. Sebastiano,A,Late Iron Age,5,-600,-580,20,0.080031894
6702,S. Sebastiano,A,Archaic Period,6,-580,-500,80,0.080031894
6703,S. Martino,A,Republican Period,7,-200,-30,170,3.9730575
6703,S. Martino,A,Early Imperial Period,8,-30,100,130,3.9730575
6703,S. Martino,A,Mid-Imperial Period,9,100,300,200,3.9730575
6703,S. Martino,A,Late Imperial Period,10,300,500,200,3.9730575
6704,S. Martino,A,Late Iron Age,5,-600,-580,20,0.043104839
6704,S. Martino,A,Archaic Period,6,-580,-500,80,0.043104839
6705,S. Sebastiano,A,Late Iron Age,5,-600,-580,20,0.054062504
6705,S. Sebastiano,A,Archaic Period,6,-580,-500,80,0.054062504
6706,S. Sebastiano,A,Late Iron Age,5,-600,-580,20,0.32259926
6706,S. Sebastiano,A,Archaic Period,6,-580,-500,80,0.32259926
6706,S. Sebastiano,B,Republican Period,7,-300,-100,200,0.32259926
6706,S. Sebastiano,C,Mid-Imperial Period,9,100,300,200,0.32259926
6707,Migliorie di S. Paolo,A,Late Iron Age,5,-600,-580,20,0.071978159
6707,Migliorie di S. Paolo,A,Archaic Period,6,-580,-500,80,0.071978159
6708,Casale Caraffa,A,Late Iron Age,5,-600,-580,20,0.07871902
6708,Casale Caraffa,A,Archaic Period,6,-580,-500,80,0.07871902
6709,Casale Caraffa,A,Late Iron Age,5,-600,-580,20,0.056155153
6709,Casale Caraffa,A,Archaic Period,6,-580,-500,80,0.056155153
6710,Casale Caraffa,A,Late Iron Age,5,-600,-580,20,0.056155909
6710,Casale Caraffa,A,Archaic Period,6,-580,-500,80,0.056155909
6711,Casale Caraffa,A,Late Iron Age,5,-600,-580,20,0.13608924
6711,Casale Caraffa,A,Archaic Period,6,-580,-350,230,0.13608924
6711,Casale Caraffa,A,Republican Period,7,-350,-30,320,0.13608924
6711,Casale Caraffa,A,Early Imperial Period,8,-30,100,130,0.13608924
6711,Casale Caraffa,A,Mid-Imperial Period,9,100,300,200,0.13608924
6712,S. Felice,A,Late Iron Age,5,-600,-580,20,0.05000871
6712,S. Felice,A,Archaic Period,6,-580,-350,230,0.05000871
6712,S. Felice,A,Republican Period,7,-350,-30,320,0.05000871
6712,S. Felice,A,Early Imperial Period,8,-30,100,130,0.05000871
6712,S. Felice,A,Mid-Imperial Period,9,100,300,200,0.05000871
6712,S. Felice,A,Late Imperial Period,10,300,400,100,0.05000871
6713,Cervaro,A,Republican Period,7,-300,-30,270,0.19292472
6713,Cervaro,A,Early Imperial Period,8,-30,100,130,0.19292472
6713,Cervaro,A,Mid-Imperial Period,9,100,300,200,0.19292472
6714,Cervaro,A,Late Iron Age,5,-600,-580,20,0.071559004
6714,Cervaro,A,Archaic Period,6,-580,-500,80,0.071559004
6714,Cervaro,B,Republican Period,7,-300,-100,200,0.071559004
6714,Cervaro,A,Late Imperial Period,10,300,400,100,0.071559004
6715,Cervaro,A,Late Iron Age,5,-700,-580,120,0.063480556
6715,Cervaro,A,Archaic Period,6,-580,-500,80,0.063480556
6715,Cervaro,B,Early Imperial Period,8,0,100,100,0.063480556
6715,Cervaro,B,Mid-Imperial Period,9,100,300,200,0.063480556
6716,Cervaro,A,Late Iron Age,5,-600,-580,20,0.055017315
6716,Cervaro,A,Archaic Period,6,-580,-500,80,0.055017315
6717,S. Felice,A,Late Iron Age,5,-600,-580,20,0.11503797
6717,S. Felice,A,Archaic Period,6,-580,-500,80,0.11503797
6718,Casalone di Ceri,A,Late Iron Age,5,-600,-580,20,0.076185681
6718,Casalone di Ceri,A,Archaic Period,6,-580,-500,80,0.076185681
6718,Casalone di Ceri,B,Early Imperial Period,8,0,100,100,0.076185681
6719,Procoio di Ceri,A,Late Iron Age,5,-600,-580,20,0.077188842
6719,Procoio di Ceri,A,Archaic Period,6,-580,-350,230,0.077188842
6719,Procoio di Ceri,A,Republican Period,7,-350,-100,250,0.077188842
6720,Procoio di Ceri,A,Early Imperial Period,8,0,100,100,0.077189252
6720,Procoio di Ceri,A,Mid-Imperial Period,9,100,300,200,0.077189252
6721,Piano Sanguinara,A,Late Iron Age,5,-600,-580,20,0.07874193
6721,Piano Sanguinara,A,Archaic Period,6,-580,-500,80,0.07874193
6722,Piano Sanguinara,A,Late Iron Age,5,-600,-580,20,0.14669974
6722,Piano Sanguinara,A,Archaic Period,6,-580,-350,230,0.14669974
6722,Piano Sanguinara,A,Republican Period,7,-350,-200,150,0.14669974
6723,Piano Sanguinara,A,Late Iron Age,5,-600,-580,20,0.066612244
6723,Piano Sanguinara,A,Archaic Period,6,-580,-500,80,0.066612244
6724,Quarto di Montelungo,A,Late Iron Age,5,-600,-580,20,0.063859381
6724,Quarto di Montelungo,A,Archaic Period,6,-580,-350,230,0.063859381
6724,Quarto di Montelungo,A,Republican Period,7,-350,-200,150,0.063859381
6725,Quarto di Montelungo,A,Early Imperial Period,8,0,100,100,0.058090135
6726,Quarto di Montelungo,A,Late Iron Age,5,-700,-600,100,0.062329482
6726,Quarto di Montelungo,B,Early Imperial Period,8,0,100,100,0.062329482
6726,Quarto di Montelungo,B,Mid-Imperial Period,9,100,200,100,0.062329482
6727,Quarto di Montelungo,A,Early Imperial Period,8,0,100,100,0.08253523
6727,Quarto di Montelungo,A,Mid-Imperial Period,9,100,200,100,0.08253523
6728,Casalone di Ceri,A,Republican Period,7,-200,-30,170,0.097931325
6728,Casalone di Ceri,A,Early Imperial Period,8,-30,100,130,0.097931325
6728,Casalone di Ceri,A,Mid-Imperial Period,9,100,300,200,0.097931325
6728,Casalone di Ceri,A,Late Imperial Period,10,300,500,200,0.097931325
6729,Casalone di Ceri,A,Late Iron Age,5,-600,-580,20,0.060609292
6729,Casalone di Ceri,A,Archaic Period,6,-580,-500,80,0.060609292
6729,Casalone di Ceri,B,Republican Period,7,-300,-30,270,0.060609292
6729,Casalone di Ceri,B,Early Imperial Period,8,-30,100,130,0.060609292
6729,Casalone di Ceri,B,Mid-Imperial Period,9,100,300,200,0.060609292
6729,Casalone di Ceri,B,Late Imperial Period,10,300,500,200,0.060609292
6730,Casalone di Ceri,A,Late Iron Age,5,-600,-580,20,0.084857456
6730,Casalone di Ceri,A,Archaic Period,6,-580,-500,80,0.084857456
6730,Casalone di Ceri,B,Early Imperial Period,8,0,100,100,0.084857456
6730,Casalone di Ceri,B,Mid-Imperial Period,9,100,200,100,0.084857456
6731,Casalone di Ceri,A,Late Iron Age,5,-600,-580,20,0.057538178
6731,Casalone di Ceri,A,Archaic Period,6,-580,-500,80,0.057538178
6731,Casalone di Ceri,B,Republican Period,7,-300,-100,200,0.057538178
6731,Casalone di Ceri,C,Mid-Imperial Period,9,100,200,100,0.057538178
6732,Quarto del Cecio,A,Late Iron Age,5,-600,-580,20,0.044070847
6732,Quarto del Cecio,A,Archaic Period,6,-580,-500,80,0.044070847
6732,Quarto del Cecio,B,Early Imperial Period,8,0,100,100,0.044070847
6732,Quarto del Cecio,B,Mid-Imperial Period,9,100,300,200,0.044070847
6733,Quarto del Cecio,A,Late Iron Age,5,-700,-580,120,0.06851615
6733,Quarto del Cecio,A,Archaic Period,6,-580,-500,80,0.06851615
6734,Quarto del Cecio,A,Late Iron Age,5,-600,-580,20,0.068516918
6734,Quarto del Cecio,A,Archaic Period,6,-580,-500,80,0.068516918
6734,Quarto del Cecio,B,Republican Period,7,-300,-100,200,0.068516918
6735,Quarto del Cecio,A,Late Iron Age,5,-600,-580,20,0.065441787
6735,Quarto del Cecio,A,Archaic Period,6,-580,-500,80,0.065441787
6736,Quarto del Cecio,A,Republican Period,7,-200,-30,170,0.058708441
6736,Quarto del Cecio,A,Early Imperial Period,8,-30,100,130,0.058708441
6736,Quarto del Cecio,A,Mid-Imperial Period,9,100,300,200,0.058708441
6736,Quarto del Cecio,A,Late Imperial Period,10,300,500,200,0.058708441
6737,Quarto del Cecio,A,Late Iron Age,5,-600,-580,20,0.04677489
6737,Quarto del Cecio,A,Archaic Period,6,-580,-500,80,0.04677489
6737,Quarto del Cecio,B,Republican Period,7,-300,-30,270,0.04677489
6737,Quarto del Cecio,B,Early Imperial Period,8,-30,100,130,0.04677489
6737,Quarto del Cecio,B,Mid-Imperial Period,9,100,300,200,0.04677489
6737,Quarto del Cecio,B,Late Imperial Period,10,300,500,200,0.04677489
6738,Piano Sanguinara,A,Late Iron Age,5,-600,-580,20,0.046733949
6738,Piano Sanguinara,A,Archaic Period,6,-580,-500,80,0.046733949
6739,Piano Sanguinara,A,Early Imperial Period,8,0,100,100,0.064395502
6739,Piano Sanguinara,A,Mid-Imperial Period,9,100,300,200,0.064395502
6740,Quarto di Montelungo,A,Mid-Imperial Period,9,100,200,100,0.22397538
6741,Quarto di Montelungo,A,Early Imperial Period,8,0,100,100,0.073882535
6741,Quarto di Montelungo,A,Mid-Imperial Period,9,100,300,200,0.073882535
6741,Quarto di Montelungo,A,Late Imperial Period,10,300,400,100,0.073882535
6742,Casalone di Ceri,A,Late Iron Age,5,-600,-580,20,0.099474691
6742,Casalone di Ceri,A,Archaic Period,6,-580,-500,80,0.099474691
6742,Casalone di Ceri,B,Republican Period,7,-300,-200,100,0.099474691
6742,Casalone di Ceri,C,Early Imperial Period,8,0,100,100,0.099474691
6742,Casalone di Ceri,C,Mid-Imperial Period,9,100,300,200,0.099474691
6742,Casalone di Ceri,C,Late Imperial Period,10,300,400,100,0.099474691
6743,Quarto di Montelungo,A,Late Iron Age,5,-600,-580,20,0.053692404
6743,Quarto di Montelungo,A,Archaic Period,6,-580,-500,80,0.053692404
6743,Quarto di Montelungo,B,Republican Period,7,-200,-30,170,0.053692404
6743,Quarto di Montelungo,B,Early Imperial Period,8,-30,100,130,0.053692404
6743,Quarto di Montelungo,B,Mid-Imperial Period,9,100,300,200,0.053692404
6743,Quarto di Montelungo,B,Late Imperial Period,10,300,400,100,0.053692404
6744,Quarto di Montelungo,A,Early Imperial Period,8,0,100,100,0.12662971
6744,Quarto di Montelungo,A,Mid-Imperial Period,9,100,200,100,0.12662971
6745,Quarto del Cecio,A,Early Imperial Period,8,0,100,100,0.072192237
6745,Quarto del Cecio,A,Mid-Imperial Period,9,100,200,100,0.072192237
6746,Quarto del Cecio,A,Late Iron Age,5,-600,-580,20,1.0311418
6746,Quarto del Cecio,A,Archaic Period,6,-580,-500,80,1.0311418
6746,Quarto del Cecio,B,Early Imperial Period,8,0,100,100,1.0311418
6746,Quarto del Cecio,B,Mid-Imperial Period,9,100,300,200,1.0311418
6746,Quarto del Cecio,B,Late Imperial Period,10,300,400,100,1.0311418
6747,Quarto del Cecio,A,Early Imperial Period,8,0,100,100,0.08430218
6747,Quarto del Cecio,A,Mid-Imperial Period,9,100,300,200,0.08430218
6748,S. Martino,A,Late Iron Age,5,-600,-580,20,0.060040437
6748,S. Martino,A,Archaic Period,6,-580,-350,230,0.060040437
6748,S. Martino,A,Republican Period,7,-350,-30,320,0.060040437
6748,S. Martino,A,Early Imperial Period,8,-30,100,130,0.060040437
6749,S. Martino,A,Late Iron Age,5,-600,-580,20,0.055806521
6749,S. Martino,A,Archaic Period,6,-580,-500,80,0.055806521
6750,S. Martino,A,Late Iron Age,5,-600,-580,20,0.042532343
6750,S. Martino,A,Archaic Period,6,-580,-500,80,0.042532343
6751,Fontanile di S. Martino,A,Late Iron Age,5,-600,-580,20,0.13318096
6751,Fontanile di S. Martino,A,Archaic Period,6,-580,-350,230,0.13318096
6751,Fontanile di S. Martino,A,Republican Period,7,-350,-200,150,0.13318096
6752,S. Martino,A,Republican Period,7,-300,-30,270,0.066581987
6752,S. Martino,A,Early Imperial Period,8,-30,100,130,0.066581987
6752,S. Martino,A,Mid-Imperial Period,9,100,300,200,0.066581987
6752,S. Martino,A,Late Imperial Period,10,300,500,200,0.066581987
6753,Quarto del Cecio,A,Late Iron Age,5,-600,-580,20,0.32191241
6753,Quarto del Cecio,A,Archaic Period,6,-580,-400,180,0.32191241
6753,Quarto del Cecio,B,Republican Period,7,-300,-30,270,0.32191241
6753,Quarto del Cecio,B,Early Imperial Period,8,-30,100,130,0.32191241
6753,Quarto del Cecio,B,Mid-Imperial Period,9,100,200,100,0.32191241
6754,Quarto del Cecio,A,Early Imperial Period,8,0,100,100,0.61470622
6754,Quarto del Cecio,A,Mid-Imperial Period,9,100,300,200,0.61470622
6754,Quarto del Cecio,A,Late Imperial Period,10,300,400,100,0.61470622
6755,Quarto del Cecio,A,Republican Period,7,-300,-30,270,0.066443406
6755,Quarto del Cecio,A,Early Imperial Period,8,-30,100,130,0.066443406
6755,Quarto del Cecio,A,Mid-Imperial Period,9,100,300,200,0.066443406
6755,Quarto del Cecio,A,Late Imperial Period,10,300,500,200,0.066443406
6756,Quarto del Cecio,A,Late Iron Age,5,-600,-580,20,0.059891108
6756,Quarto del Cecio,A,Archaic Period,6,-580,-500,80,0.059891108
6756,Quarto del Cecio,B,Republican Period,7,-300,-100,200,0.059891108
6757,Quarto del Cecio,A,Late Iron Age,5,-600,-580,20,0.088208027
6757,Quarto del Cecio,A,Archaic Period,6,-580,-500,80,0.088208027
6758,Valle Canneto,A,Late Imperial Period,10,400,500,100,0.069915354
6759,Valle Canneto,A,Early Imperial Period,8,0,100,100,0.24152689
6759,Valle Canneto,A,Mid-Imperial Period,9,100,300,200,0.24152689
6759,Valle Canneto,A,Late Imperial Period,10,300,400,100,0.24152689
6760,Valle Canneto,A,Late Iron Age,5,-600,-580,20,0.064910658
6760,Valle Canneto,A,Archaic Period,6,-580,-500,80,0.064910658
6760,Valle Canneto,B,Republican Period,7,-300,-100,200,0.064910658
6761,Valle Canneto,A,Late Iron Age,5,-600,-580,20,0.069341473
6761,Valle Canneto,A,Archaic Period,6,-580,-400,180,0.069341473
6762,Valle Canneto,A,Early Imperial Period,8,0,100,100,0.1612221
6762,Valle Canneto,A,Mid-Imperial Period,9,100,200,100,0.1612221
6763,Valle Canneto,A,Late Iron Age,5,-600,-580,20,0.049507651
6763,Valle Canneto,A,Archaic Period,6,-580,-500,80,0.049507651
6764,Valle Canneto,A,Late Iron Age,5,-600,-580,20,0.056252778
6764,Valle Canneto,A,Archaic Period,6,-580,-500,80,0.056252778
6765,Valle Canneto,A,Early Imperial Period,8,0,100,100,0.054713871
6765,Valle Canneto,A,Mid-Imperial Period,9,100,300,200,0.054713871
6766,Quarto del Cecio,A,Late Iron Age,5,-600,-580,20,0.088167183
6766,Quarto del Cecio,A,Archaic Period,6,-580,-500,80,0.088167183
6766,Quarto del Cecio,B,Mid-Imperial Period,9,100,200,100,0.088167183
6767,Quarto del Cecio,A,Late Iron Age,5,-600,-580,20,0.10781839
6767,Quarto del Cecio,A,Archaic Period,6,-580,-500,80,0.10781839
6767,Quarto del Cecio,B,Early Imperial Period,8,0,100,100,0.10781839
6767,Quarto del Cecio,B,Mid-Imperial Period,9,100,200,100,0.10781839
6768,Quarto del Cecio,A,Late Iron Age,5,-600,-580,20,0.10474738
6768,Quarto del Cecio,A,Archaic Period,6,-580,-500,80,0.10474738
6769,Quarto del Cecio,A,Late Iron Age,5,-600,-580,20,0.077607401
6769,Quarto del Cecio,A,Archaic Period,6,-580,-500,80,0.077607401
6769,Quarto del Cecio,B,Mid-Imperial Period,9,100,300,200,0.077607401
6770,Quarto del Cecio,A,Mid-Imperial Period,9,100,300,200,0.64638978
6771,Quarto del Cecio,A,Republican Period,7,-200,-30,170,0.51244694
6771,Quarto del Cecio,A,Early Imperial Period,8,-30,100,130,0.51244694
6771,Quarto del Cecio,A,Mid-Imperial Period,9,100,300,200,0.51244694
6771,Quarto del Cecio,A,Late Imperial Period,10,300,400,100,0.51244694
6772,Quarto del Cecio,A,Late Iron Age,5,-600,-580,20,0.061027944
6772,Quarto del Cecio,A,Archaic Period,6,-580,-500,80,0.061027944
6772,Quarto del Cecio,B,Republican Period,7,-300,-100,200,0.061027944
6773,Quarto del Cecio,A,Late Iron Age,5,-600,-580,20,0.058528055
6773,Quarto del Cecio,A,Archaic Period,6,-580,-500,80,0.058528055
6774,Quarto del Cecio,A,Late Iron Age,5,-600,-580,20,0.057374559
6774,Quarto del Cecio,A,Archaic Period,6,-580,-500,80,0.057374559
6775,Quarto del Cecio,A,Late Iron Age,5,-600,-580,20,0.052180495
6775,Quarto del Cecio,A,Archaic Period,6,-580,-500,80,0.052180495
6776,Quarto del Cecio,A,Middle Bronze Age,2,-1700,-1300,400,0.05873071
6776,Quarto del Cecio,B,Late Iron Age,5,-700,-580,120,0.05873071
6776,Quarto del Cecio,B,Archaic Period,6,-580,-500,80,0.05873071
6777,Quarto del Cecio,A,Early Bronze Age,1,-2300,-1700,600,0.069512196
6778,Quarto del Cecio,A,Republican Period,7,-200,-30,170,0.88957
6778,Quarto del Cecio,A,Early Imperial Period,8,-30,100,130,0.88957
6778,Quarto del Cecio,A,Mid-Imperial Period,9,100,300,200,0.88957
6778,Quarto del Cecio,A,Late Imperial Period,10,300,500,200,0.88957
6779,Quarto del Cecio,A,Late Iron Age,5,-600,-580,20,0.069319926
6779,Quarto del Cecio,A,Archaic Period,6,-580,-500,80,0.069319926
6779,Quarto del Cecio,B,Republican Period,7,-300,-200,100,0.069319926
6780,Quarto del Cecio,A,Late Iron Age,5,-600,-580,20,0.08126054
6780,Quarto del Cecio,A,Archaic Period,6,-580,-500,80,0.08126054
6780,Quarto del Cecio,B,Republican Period,7,-300,-100,200,0.08126054
6781,Quarto del Cecio,A,Late Iron Age,5,-600,-580,20,0.068170339
6781,Quarto del Cecio,A,Archaic Period,6,-580,-500,80,0.068170339
6782,Valcanneto,A,Early Imperial Period,8,0,100,100,0.046040252
6782,Valcanneto,A,Mid-Imperial Period,9,100,200,100,0.046040252
6783,Valcanneto,A,Republican Period,7,-200,-30,170,0.16066585
6783,Valcanneto,A,Early Imperial Period,8,-30,100,130,0.16066585
6783,Valcanneto,A,Mid-Imperial Period,9,100,300,200,0.16066585
6783,Valcanneto,A,Late Imperial Period,10,300,400,100,0.16066585
6784,Casale del Pineto,A,Republican Period,7,-200,-30,170,0.32525402
6784,Casale del Pineto,A,Early Imperial Period,8,-30,100,130,0.32525402
6784,Casale del Pineto,A,Mid-Imperial Period,9,100,300,200,0.32525402
6784,Casale del Pineto,A,Late Imperial Period,10,300,400,100,0.32525402
6785,Quartaccio,A,Republican Period,7,-200,-30,170,0.15791847
6785,Quartaccio,A,Early Imperial Period,8,-30,100,130,0.15791847
6785,Quartaccio,A,Mid-Imperial Period,9,100,300,200,0.15791847
6785,Quartaccio,A,Late Imperial Period,10,300,500,200,0.15791847
6786,Quartaccio,A,Late Iron Age,5,-600,-580,20,0.080120638
6786,Quartaccio,A,Archaic Period,6,-580,-500,80,0.080120638
6786,Quartaccio,B,Republican Period,7,-300,-100,200,0.080120638
6787,Quartaccio,A,Late Iron Age,5,-600,-580,20,0.051043078
6787,Quartaccio,A,Archaic Period,6,-580,-500,80,0.051043078
6788,fosso del Quartaccio,A,Late Iron Age,5,-600,-580,20,0.047771726
6788,fosso del Quartaccio,A,Archaic Period,6,-580,-500,80,0.047771726
6789,Il Pineto,A,Late Iron Age,5,-600,-580,20,0.22594036
6789,Il Pineto,A,Archaic Period,6,-580,-500,80,0.22594036
6789,Il Pineto,B,Republican Period,7,-200,-30,170,0.22594036
6789,Il Pineto,B,Early Imperial Period,8,-30,100,130,0.22594036
6789,Il Pineto,B,Mid-Imperial Period,9,100,300,200,0.22594036
6789,Il Pineto,B,Late Imperial Period,10,300,400,100,0.22594036
6790,Il Pineto,A,Republican Period,7,-200,-30,170,0.83954972
6790,Il Pineto,A,Early Imperial Period,8,-30,100,130,0.83954972
6790,Il Pineto,A,Mid-Imperial Period,9,100,300,200,0.83954972
6790,Il Pineto,A,Late Imperial Period,10,300,500,200,0.83954972
6790,Il Pineto,A,Late Antique Period,11,500,600,100,0.83954972
6791,Il Pineto,A,Republican Period,7,-200,-30,170,0.57171625
6791,Il Pineto,A,Early Imperial Period,8,-30,100,130,0.57171625
6791,Il Pineto,A,Mid-Imperial Period,9,100,300,200,0.57171625
6791,Il Pineto,A,Late Imperial Period,10,300,500,200,0.57171625
6792,Il Pineto,A,Late Iron Age,5,-600,-580,20,0.070889562
6792,Il Pineto,A,Archaic Period,6,-580,-500,80,0.070889562
6793,Quartaccio,A,Late Iron Age,5,-600,-580,20,0.077985421
6793,Quartaccio,A,Archaic Period,6,-580,-500,80,0.077985421
6794,Quartaccio,A,Republican Period,7,-200,-30,170,0.27611879
6794,Quartaccio,A,Early Imperial Period,8,-30,100,130,0.27611879
6794,Quartaccio,A,Mid-Imperial Period,9,100,300,200,0.27611879
6794,Quartaccio,A,Late Imperial Period,10,300,400,100,0.27611879
6795,Quartaccio,A,Late Iron Age,5,-600,-580,20,0.053721145
6795,Quartaccio,A,Archaic Period,6,-580,-350,230,0.053721145
6795,Quartaccio,A,Republican Period,7,-350,-200,150,0.053721145
6796,Quartaccio,A,Late Iron Age,5,-600,-580,20,0.081256889
6796,Quartaccio,A,Archaic Period,6,-580,-350,230,0.081256889
6796,Quartaccio,A,Republican Period,7,-350,-200,150,0.081256889
6797,Quartaccio,A,Late Iron Age,5,-600,-580,20,0.049290597
6797,Quartaccio,A,Archaic Period,6,-580,-500,80,0.049290597
6798,Quartaccio,A,Late Iron Age,5,-600,-580,20,0.057186898
6798,Quartaccio,A,Archaic Period,6,-580,-500,80,0.057186898
6799,Quartaccio,A,Late Iron Age,5,-600,-580,20,0.040049963
6799,Quartaccio,A,Archaic Period,6,-580,-500,80,0.040049963
6799,Quartaccio,B,Republican Period,7,-200,-100,100,0.040049963
6800,Quartaccio,A,Late Iron Age,5,-600,-580,20,0.049292572
6800,Quartaccio,A,Archaic Period,6,-580,-500,80,0.049292572
6801,Quartaccio,A,Late Iron Age,5,-600,-580,20,0.096477874
6801,Quartaccio,A,Archaic Period,6,-580,-500,80,0.096477874
6801,Quartaccio,B,Republican Period,7,-200,-30,170,0.096477874
6801,Quartaccio,B,Early Imperial Period,8,-30,100,130,0.096477874
6802,Quartaccio,A,Late Iron Age,5,-600,-580,20,0.12169757
6802,Quartaccio,A,Archaic Period,6,-580,-500,80,0.12169757
6802,Quartaccio,B,Republican Period,7,-200,-30,170,0.12169757
6802,Quartaccio,B,Early Imperial Period,8,-30,100,130,0.12169757
6802,Quartaccio,B,Mid-Imperial Period,9,100,300,200,0.12169757
6802,Quartaccio,B,Late Imperial Period,10,300,400,100,0.12169757
6803,Quartaccio,A,Late Iron Age,5,-600,-580,20,0.068166874
6803,Quartaccio,A,Archaic Period,6,-580,-500,80,0.068166874
6803,Quartaccio,B,Early Imperial Period,8,0,100,100,0.068166874
6804,Quartaccio,A,Late Iron Age,5,-600,-580,20,0.053726625
6804,Quartaccio,A,Archaic Period,6,-580,-500,80,0.053726625
6805,Quartaccio,A,Early Imperial Period,8,0,100,100,0.049830265
6805,Quartaccio,A,Mid-Imperial Period,9,100,300,200,0.049830265
6806,Quartaccio,A,Late Iron Age,5,-600,-580,20,0.033990867
6806,Quartaccio,A,Archaic Period,6,-580,-500,80,0.033990867
6806,Quartaccio,B,Republican Period,7,-300,-100,200,0.033990867
6807,Quartaccio,A,Early Bronze Age,1,-2300,-1700,600,0.08764039
6807,Quartaccio,A,Middle Bronze Age,2,-1700,-1300,400,0.08764039
6807,Quartaccio,A,Late Bronze Age,3,-1300,-1020,280,0.08764039
6807,Quartaccio,A,Early Iron Age,4,-1020,-1000,20,0.08764039
6807,Quartaccio,B,Late Iron Age,5,-600,-580,20,0.08764039
6807,Quartaccio,B,Archaic Period,6,-580,-500,80,0.08764039
6807,Quartaccio,C,Republican Period,7,-200,-30,170,0.08764039
6807,Quartaccio,C,Early Imperial Period,8,-30,100,130,0.08764039
6807,Quartaccio,C,Mid-Imperial Period,9,100,300,200,0.08764039
6807,Quartaccio,C,Late Imperial Period,10,300,500,200,0.08764039
6808,Quartaccio,A,Late Iron Age,5,-600,-580,20,0.25920165
6808,Quartaccio,A,Archaic Period,6,-580,-350,230,0.25920165
6808,Quartaccio,A,Republican Period,7,-350,-200,150,0.25920165
6809,Quartaccio,A,Late Iron Age,5,-600,-580,20,0.08549808
6809,Quartaccio,A,Archaic Period,6,-580,-500,80,0.08549808
6809,Quartaccio,B,Early Imperial Period,8,0,100,100,0.08549808
6809,Quartaccio,B,Mid-Imperial Period,9,100,300,200,0.08549808
6810,Quartaccio,A,Late Iron Age,5,-600,-580,20,0.068353869
6810,Quartaccio,A,Archaic Period,6,-580,-350,230,0.068353869
6810,Quartaccio,A,Republican Period,7,-350,-30,320,0.068353869
6810,Quartaccio,A,Early Imperial Period,8,-30,100,130,0.068353869
6811,Moscone,A,Late Iron Age,5,-600,-580,20,0.072966889
6811,Moscone,A,Archaic Period,6,-580,-500,80,0.072966889
6812,S. Martino,A,Late Iron Age,5,-600,-580,20,0.073339298
6812,S. Martino,A,Archaic Period,6,-580,-350,230,0.073339298
6812,S. Martino,A,Republican Period,7,-350,-100,250,0.073339298
6813,S. Martino,A,Late Iron Age,5,-600,-580,20,0.046198089
6813,S. Martino,A,Archaic Period,6,-580,-500,80,0.046198089
6814,S. Martino,A,Late Iron Age,5,-600,-580,20,0.046199277
6814,S. Martino,A,Archaic Period,6,-580,-500,80,0.046199277
6815,Moscone,A,Late Iron Age,5,-600,-580,20,0.075851776
6815,Moscone,A,Archaic Period,6,-580,-400,180,0.075851776
6815,Moscone,B,Early Imperial Period,8,0,100,100,0.075851776
6816,Birbo,A,Late Iron Age,5,-600,-580,20,0.063734315
6816,Birbo,A,Archaic Period,6,-580,-500,80,0.063734315
6816,Birbo,B,Early Imperial Period,8,0,100,100,0.063734315
6816,Birbo,B,Mid-Imperial Period,9,100,200,100,0.063734315
6817,Birbo,A,Late Iron Age,5,-600,-580,20,0.045443304
6817,Birbo,A,Archaic Period,6,-580,-500,80,0.045443304
6818,Mosconcino,A,Late Iron Age,5,-600,-580,20,0.59987158
6818,Mosconcino,A,Archaic Period,6,-580,-500,80,0.59987158
6818,Mosconcino,B,Republican Period,7,-300,-30,270,0.59987158
6819,Mosconcino,A,Late Iron Age,5,-600,-580,20,0.076036446
6819,Mosconcino,A,Archaic Period,6,-580,-500,80,0.076036446
6820,Mosconcino,A,Late Iron Age,5,-600,-580,20,0.073145032
6820,Mosconcino,A,Archaic Period,6,-580,-500,80,0.073145032
6820,Mosconcino,B,Early Imperial Period,8,0,100,100,0.073145032
6820,Mosconcino,B,Mid-Imperial Period,9,100,300,200,0.073145032
6821,Mosconcino,A,Late Iron Age,5,-700,-580,120,0.05697713
6821,Mosconcino,A,Archaic Period,6,-580,-500,80,0.05697713
6822,Mosconcino,A,Early Imperial Period,8,0,100,100,0.072767474
6822,Mosconcino,A,Mid-Imperial Period,9,100,200,100,0.072767474
6823,Mosconcino,A,Late Iron Age,5,-700,-580,120,0.058518566
6823,Mosconcino,A,Archaic Period,6,-580,-500,80,0.058518566
6824,Carlottine,A,Early Imperial Period,8,0,100,100,0.065613389
6824,Carlottine,A,Mid-Imperial Period,9,100,200,100,0.065613389
6825,Carlottine,A,Late Iron Age,5,-700,-580,120,0.059649043
6825,Carlottine,A,Archaic Period,6,-580,-500,80,0.059649043
6826,Carlottine,A,Late Iron Age,5,-600,-580,20,0.073119774
6826,Carlottine,A,Archaic Period,6,-580,-500,80,0.073119774
6827,Carlottine,A,Late Iron Age,5,-700,-580,120,0.10313512
6827,Carlottine,A,Archaic Period,6,-580,-500,80,0.10313512
6828,Carlottine,A,Late Iron Age,5,-600,-580,20,0.069275394
6828,Carlottine,A,Archaic Period,6,-580,-500,80,0.069275394
6828,Carlottine,B,Republican Period,7,-300,-100,200,0.069275394
6829,Carlottine,A,Late Iron Age,5,-600,-580,20,0.087176114
6829,Carlottine,A,Archaic Period,6,-580,-500,80,0.087176114
6829,Carlottine,B,Early Imperial Period,8,0,100,100,0.087176114
6829,Carlottine,B,Mid-Imperial Period,9,100,300,200,0.087176114
6830,Pantanella,A,Late Iron Age,5,-600,-580,20,0.054467678
6830,Pantanella,A,Archaic Period,6,-580,-500,80,0.054467678
6831,F.le di S. Martino,A,Republican Period,7,-200,-30,170,0.14183851
6831,F.le di S. Martino,A,Early Imperial Period,8,-30,100,130,0.14183851
6831,F.le di S. Martino,A,Mid-Imperial Period,9,100,200,100,0.14183851
6832,F.le di S. Martino,A,Late Iron Age,5,-700,-600,100,0.090843186
6832,F.le di S. Martino,B,Mid-Imperial Period,9,200,300,100,0.090843186
6832,F.le di S. Martino,B,Late Imperial Period,10,300,500,200,0.090843186
6832,F.le di S. Martino,B,Late Antique Period,11,500,600,100,0.090843186
6833,Moscone,A,Late Iron Age,5,-600,-580,20,0.094513968
6833,Moscone,A,Archaic Period,6,-580,-500,80,0.094513968
6833,Moscone,B,Republican Period,7,-100,-30,70,0.094513968
6833,Moscone,B,Early Imperial Period,8,-30,100,130,0.094513968
6834,Sughere,A,Late Iron Age,5,-600,-580,20,0.097703673
6834,Sughere,A,Archaic Period,6,-580,-500,80,0.097703673
6835,Sughere,A,Late Iron Age,5,-600,-580,20,0.1184868
6835,Sughere,A,Archaic Period,6,-580,-500,80,0.1184868
6836,Tenuta di Castel Campanile,A,Republican Period,7,-200,-30,170,0.22323538
6836,Tenuta di Castel Campanile,A,Early Imperial Period,8,-30,100,130,0.22323538
6836,Tenuta di Castel Campanile,A,Mid-Imperial Period,9,100,300,200,0.22323538
6836,Tenuta di Castel Campanile,A,Late Imperial Period,10,300,400,100,0.22323538
6837,Tenuta di Castel Campanile,A,Late Iron Age,5,-600,-580,20,0.043109976
6837,Tenuta di Castel Campanile,A,Archaic Period,6,-580,-350,230,0.043109976
6837,Tenuta di Castel Campanile,A,Republican Period,7,-350,-200,150,0.043109976
6838,Quarticciolo,A,Late Iron Age,5,-600,-580,20,0.075402215
6838,Quarticciolo,A,Archaic Period,6,-580,-500,80,0.075402215
6838,Quarticciolo,B,Early Imperial Period,8,0,100,100,0.075402215
6838,Quarticciolo,B,Mid-Imperial Period,9,100,200,100,0.075402215
6839,Quarticciolo,A,Late Iron Age,5,-600,-580,20,0.075402498
6839,Quarticciolo,A,Archaic Period,6,-580,-500,80,0.075402498
6839,Quarticciolo,B,Early Imperial Period,8,0,100,100,0.075402498
6840,Quarticciolo,A,Late Iron Age,5,-600,-580,20,0.078868218
6840,Quarticciolo,A,Archaic Period,6,-580,-500,80,0.078868218
6840,Quarticciolo,B,Early Imperial Period,8,0,100,100,0.078868218
6840,Quarticciolo,B,Mid-Imperial Period,9,100,200,100,0.078868218
6841,Quarticciolo,A,Republican Period,7,-300,-30,270,0.14216076
6841,Quarticciolo,A,Early Imperial Period,8,-30,100,130,0.14216076
6841,Quarticciolo,A,Mid-Imperial Period,9,100,200,100,0.14216076
6842,Le Macchiozze,A,Late Iron Age,5,-600,-580,20,0.47387934
6842,Le Macchiozze,A,Archaic Period,6,-580,-500,80,0.47387934
6842,Le Macchiozze,B,Republican Period,7,-300,-30,270,0.47387934
6842,Le Macchiozze,B,Early Imperial Period,8,-30,100,130,0.47387934
6842,Le Macchiozze,B,Mid-Imperial Period,9,100,300,200,0.47387934
6842,Le Macchiozze,B,Late Imperial Period,10,300,500,200,0.47387934
6842,Le Macchiozze,B,Late Antique Period,11,500,600,100,0.47387934
6843,Le Macchiozze,A,Early Imperial Period,8,0,100,100,0.12237154
6843,Le Macchiozze,A,Mid-Imperial Period,9,100,300,200,0.12237154
6844,Le Macchiozze,A,Early Imperial Period,8,-30,100,130,0.065040931
6844,Le Macchiozze,A,Mid-Imperial Period,9,100,300,200,0.065040931
6844,Le Macchiozze,A,Late Imperial Period,10,300,500,200,0.065040931
6845,Le Macchiozze,A,Late Iron Age,5,-600,-580,20,0.088526092
6845,Le Macchiozze,A,Archaic Period,6,-580,-500,80,0.088526092
6845,Le Macchiozze,B,Republican Period,7,-200,-30,170,0.088526092
6845,Le Macchiozze,B,Early Imperial Period,8,-30,100,130,0.088526092
6845,Le Macchiozze,B,Mid-Imperial Period,9,100,300,200,0.088526092
6846,Le Macchiozze,A,Mid-Imperial Period,9,100,300,200,0.11681173
6847,Le Macchiozze,A,Late Iron Age,5,-600,-580,20,0.082751967
6847,Le Macchiozze,A,Archaic Period,6,-580,-500,80,0.082751967
6847,Le Macchiozze,B,Mid-Imperial Period,9,100,300,200,0.082751967
6847,Le Macchiozze,C,Late Antique Period,11,500,600,100,0.082751967
6848,Casale del Castellaccio,A,Early Imperial Period,8,0,100,100,0.60176277
6848,Casale del Castellaccio,A,Mid-Imperial Period,9,100,300,200,0.60176277
6848,Casale del Castellaccio,A,Late Imperial Period,10,300,500,200,0.60176277
6849,Casale del Castellaccio,A,Late Bronze Age,3,-1200,-1020,180,0.12878513
6849,Casale del Castellaccio,A,Early Iron Age,4,-1020,-1000,20,0.12878513
6850,Tenuta di Castel Campanile,A,Early Imperial Period,8,0,100,100,0.076212883
6850,Tenuta di Castel Campanile,A,Mid-Imperial Period,9,100,300,200,0.076212883
6850,Tenuta di Castel Campanile,A,Late Imperial Period,10,300,400,100,0.076212883
6851,Tenuta di Castel Campanile,A,Early Imperial Period,8,0,100,100,0.1233786
6851,Tenuta di Castel Campanile,A,Mid-Imperial Period,9,100,300,200,0.1233786
6851,Tenuta di Castel Campanile,A,Late Imperial Period,10,300,400,100,0.1233786
6852,Tenuta di Castel Campanile,A,Early Bronze Age,1,-2300,-1700,600,0.092974059
6853,Tenuta di Castel Campanile,A,Republican Period,7,-100,-30,70,0.13898161
6853,Tenuta di Castel Campanile,A,Early Imperial Period,8,-30,100,130,0.13898161
6854,Casale del Castellaccio,A,Early Imperial Period,8,0,100,100,0.11510687
6854,Casale del Castellaccio,A,Mid-Imperial Period,9,100,300,200,0.11510687
6855,Casale del Castellaccio,A,Mid-Imperial Period,9,200,300,100,0.041007817
6855,Casale del Castellaccio,A,Late Imperial Period,10,300,400,100,0.041007817
6856,Tenuta di Castel Campanile,A,Republican Period,7,-300,-30,270,0.068938106
6856,Tenuta di Castel Campanile,A,Early Imperial Period,8,-30,100,130,0.068938106
6856,Tenuta di Castel Campanile,A,Mid-Imperial Period,9,100,300,200,0.068938106
6856,Tenuta di Castel Campanile,A,Late Imperial Period,10,300,500,200,0.068938106
6857,Pascolareto,A,Late Iron Age,5,-600,-580,20,0.050260536
6857,Pascolareto,A,Archaic Period,6,-580,-500,80,0.050260536
6857,Pascolareto,B,Republican Period,7,-300,-100,200,0.050260536
6858,Pascolareto,A,Early Imperial Period,8,0,100,100,0.1625354
6858,Pascolareto,A,Mid-Imperial Period,9,100,200,100,0.1625354
6859,M. Bozzetta,A,Late Iron Age,5,-600,-580,20,0.14400995
6859,M. Bozzetta,A,Archaic Period,6,-580,-350,230,0.14400995
6859,M. Bozzetta,A,Republican Period,7,-350,-30,320,0.14400995
6859,M. Bozzetta,A,Early Imperial Period,8,-30,100,130,0.14400995
6860,S. Antonio,A,Early Iron Age,4,-1000,-800,200,0.075805299
6861,Pascolareto,A,Late Iron Age,5,-600,-580,20,0.052094456
6861,Pascolareto,A,Archaic Period,6,-580,-500,80,0.052094456
6862,Pascolareto,A,Republican Period,7,-200,-30,170,0.76982909
6862,Pascolareto,A,Early Imperial Period,8,-30,100,130,0.76982909
6862,Pascolareto,A,Mid-Imperial Period,9,100,300,200,0.76982909
6862,Pascolareto,A,Late Imperial Period,10,300,500,200,0.76982909
6862,Pascolareto,A,Late Antique Period,11,500,600,100,0.76982909
6863,Casale di Castel Campanile,A,Late Iron Age,5,-600,-580,20,0.10419586
6863,Casale di Castel Campanile,A,Archaic Period,6,-580,-500,80,0.10419586
6864,Casale di Castel Campanile,A,Late Iron Age,5,-600,-580,20,0.05412126
6864,Casale di Castel Campanile,A,Archaic Period,6,-580,-500,80,0.05412126
6865,L'Ovile,A,Late Iron Age,5,-600,-580,20,0.54938501
6865,L'Ovile,A,Archaic Period,6,-580,-350,230,0.54938501
6865,L'Ovile,A,Republican Period,7,-350,-30,320,0.54938501
6865,L'Ovile,A,Early Imperial Period,8,-30,100,130,0.54938501
6866,L'Ovile,A,Early Imperial Period,8,0,100,100,0.15412198
6866,L'Ovile,A,Mid-Imperial Period,9,100,200,100,0.15412198
6867,Casale Fornace,A,Late Iron Age,5,-600,-580,20,0.95260572
6867,Casale Fornace,A,Archaic Period,6,-580,-500,80,0.95260572
6868,Cave di Calcare,A,Late Iron Age,5,-600,-580,20,0.042588633
6868,Cave di Calcare,A,Archaic Period,6,-580,-500,80,0.042588633
6869,Cave di Calcare,A,Early Imperial Period,8,0,100,100,0.060509078
6869,Cave di Calcare,A,Mid-Imperial Period,9,100,300,200,0.060509078
6870,Cave di Calcare,A,Late Iron Age,5,-700,-580,120,0.084409893
6870,Cave di Calcare,A,Archaic Period,6,-580,-500,80,0.084409893
6870,Cave di Calcare,B,Mid-Imperial Period,9,100,300,200,1.2707742
6871,Casale del Cecio,A,Late Iron Age,5,-600,-580,20,0.085698456
6871,Casale del Cecio,A,Archaic Period,6,-580,-500,80,0.085698456
6872,Casale di Castel Campanile,A,Late Iron Age,5,-600,-580,20,0.067359589
6872,Casale di Castel Campanile,A,Archaic Period,6,-580,-500,80,0.067359589
6872,Casale di Castel Campanile,B,Early Imperial Period,8,0,100,100,0.067359589
6873,Selva La Rocca,A,Early Imperial Period,8,0,100,100,0.084310234
6873,Selva La Rocca,A,Mid-Imperial Period,9,100,300,200,0.084310234
6874,Selva La Rocca,A,Late Imperial Period,10,300,400,100,0.044059772
6875,Il Castellaccio,A,Middle Bronze Age,2,-1700,-1300,400,0.56650454
6875,Il Castellaccio,B,Late Iron Age,5,-700,-580,120,0.56650454
6875,Il Castellaccio,B,Archaic Period,6,-580,-500,80,0.56650454
6875,Il Castellaccio,C,Mid-Imperial Period,9,100,300,200,0.56650454
6876,Casale Selva La Rocca,A,Early Imperial Period,8,0,100,100,1.0361013
6876,Casale Selva La Rocca,A,Mid-Imperial Period,9,100,300,200,1.0361013
6876,Casale Selva La Rocca,A,Late Imperial Period,10,300,500,200,1.0361013
6877,Centro Mentuccia,A,Late Iron Age,5,-700,-580,120,0.070123002
6877,Centro Mentuccia,A,Archaic Period,6,-580,-500,80,0.070123002
6877,Centro Mentuccia,B,Republican Period,7,-300,-100,200,0.070123002
6878,Centro Mentuccia,A,Late Iron Age,5,-600,-580,20,0.055293068
6878,Centro Mentuccia,A,Archaic Period,6,-580,-500,80,0.055293068
6879,Casale Porcareccia,A,Early Imperial Period,8,-30,100,130,0.077264562
6879,Casale Porcareccia,A,Mid-Imperial Period,9,100,300,200,0.077264562
6879,Casale Porcareccia,A,Late Imperial Period,10,300,500,200,0.077264562
6880,Casale Porcareccia,A,Late Iron Age,5,-600,-580,20,0.047783796
6880,Casale Porcareccia,A,Archaic Period,6,-580,-500,80,0.047783796
6881,Casale Porcareccia,A,Republican Period,7,-200,-30,170,0.3100377
6881,Casale Porcareccia,A,Early Imperial Period,8,-30,100,130,0.3100377
6881,Casale Porcareccia,A,Mid-Imperial Period,9,100,300,200,0.3100377
6881,Casale Porcareccia,A,Late Imperial Period,10,300,500,200,0.3100377
6881,Casale Porcareccia,A,Late Antique Period,11,500,600,100,0.3100377
6882,Statua,A,Late Iron Age,5,-600,-580,20,0.064940602
6882,Statua,A,Archaic Period,6,-580,-500,80,0.064940602
6883,Casale Porcareccia,A,Late Iron Age,5,-600,-580,20,0.080940016
6883,Casale Porcareccia,A,Archaic Period,6,-580,-500,80,0.080940016
6883,Casale Porcareccia,B,Mid-Imperial Period,9,100,300,200,0.080940016
6884,Centro Capanna,A,Late Iron Age,5,-600,-580,20,0.092479102
6884,Centro Capanna,A,Archaic Period,6,-580,-500,80,0.092479102
6885,Osteriaccia,A,Republican Period,7,-200,-30,170,2.8477244
6885,Osteriaccia,A,Early Imperial Period,8,-30,100,130,2.8477244
6885,Osteriaccia,A,Mid-Imperial Period,9,100,300,200,2.8477244
6885,Osteriaccia,A,Late Imperial Period,10,300,500,200,2.8477244
6885,Osteriaccia,A,Late Antique Period,11,500,600,100,2.8477244
6886,Osteriaccia,A,Early Imperial Period,8,0,100,100,0.091547422
6886,Osteriaccia,A,Mid-Imperial Period,9,100,300,200,0.091547422
6887,Contrada S. Angelo,A,Early Bronze Age,1,-2300,-1700,600,0.045394655
6887,Contrada S. Angelo,A,Middle Bronze Age,2,-1700,-1300,400,0.045394655
6888,S. Antonio,A,Early Bronze Age,1,-2300,-1700,600,0.050584286
6888,S. Antonio,A,Middle Bronze Age,2,-1700,-1300,400,0.050584286
6888,S. Antonio,A,Late Bronze Age,3,-1300,-1020,280,0.050584286
6888,S. Antonio,A,Early Iron Age,4,-1020,-1000,20,0.050584286
6889,Selva La Rocca,A,Republican Period,7,-200,-30,170,0.19050945
6889,Selva La Rocca,A,Early Imperial Period,8,-30,100,130,0.19050945
6889,Selva La Rocca,A,Mid-Imperial Period,9,100,300,200,0.19050945
6890,Centro Pascolare della Selva,A,Republican Period,7,-200,-30,170,0.12521295
6890,Centro Pascolare della Selva,A,Early Imperial Period,8,-30,100,130,0.12521295
6890,Centro Pascolare della Selva,A,Mid-Imperial Period,9,100,200,100,0.12521295
6891,Centro Capanno,A,Late Iron Age,5,-600,-580,20,0.072061449
6891,Centro Capanno,A,Archaic Period,6,-580,-500,80,0.072061449
6891,Centro Capanno,B,Republican Period,7,-300,-100,200,0.072061449
6892,Casale Prato Antico,A,Early Imperial Period,8,0,100,100,0.11560338
6892,Casale Prato Antico,A,Mid-Imperial Period,9,100,200,100,0.11560338
6893,Casale di Castel Campanile,A,Early Imperial Period,8,0,100,100,0.41829574
6893,Casale di Castel Campanile,A,Mid-Imperial Period,9,100,300,200,0.41829574
6893,Casale di Castel Campanile,A,Late Imperial Period,10,300,400,100,0.41829574
6894,L'Ovile,A,Late Iron Age,5,-600,-580,20,0.12077232
6894,L'Ovile,A,Archaic Period,6,-580,-500,80,0.12077232
6894,L'Ovile,B,Early Imperial Period,8,0,100,100,0.12077232
6894,L'Ovile,B,Mid-Imperial Period,9,100,300,200,0.12077232
6895,fosso di Castel Campanile,A,Mid-Imperial Period,9,100,300,200,0.084391028
6896,fosso di Castel Campanile,A,Late Iron Age,5,-600,-580,20,0.058387287
6896,fosso di Castel Campanile,A,Archaic Period,6,-580,-500,80,0.058387287
6896,fosso di Castel Campanile,B,Republican Period,7,-300,-30,270,0.058387287
6896,fosso di Castel Campanile,B,Early Imperial Period,8,-30,100,130,0.058387287
6896,fosso di Castel Campanile,B,Mid-Imperial Period,9,100,300,200,0.058387287
6896,fosso di Castel Campanile,B,Late Imperial Period,10,300,500,200,0.058387287
6897,S. Angelo,A,Early Imperial Period,8,0,100,100,0.19885659
6897,S. Angelo,A,Mid-Imperial Period,9,100,200,100,0.19885659
6898,Cava di Pietra,A,Republican Period,7,-200,-30,170,1.9419968
6898,Cava di Pietra,A,Early Imperial Period,8,-30,100,130,1.9419968
6898,Cava di Pietra,A,Mid-Imperial Period,9,100,300,200,1.9419968
6898,Cava di Pietra,A,Late Imperial Period,10,300,500,200,1.9419968
6899,Cava di Pietra,A,Early Imperial Period,8,0,100,100,0.10928637
6899,Cava di Pietra,A,Mid-Imperial Period,9,100,200,100,0.10928637
6900,Cava di Pietra,A,Early Imperial Period,8,0,100,100,0.12393639
6900,Cava di Pietra,A,Mid-Imperial Period,9,100,300,200,0.12393639
6900,Cava di Pietra,A,Late Imperial Period,10,300,400,100,0.12393639
6901,Centro Arenaro,A,Late Iron Age,5,-600,-580,20,0.062845752
6901,Centro Arenaro,A,Archaic Period,6,-580,-500,80,0.062845752
6902,Centro Arenaro,A,Early Imperial Period,8,0,100,100,0.36343378
6902,Centro Arenaro,A,Mid-Imperial Period,9,100,300,200,0.36343378
6902,Centro Arenaro,A,Late Imperial Period,10,300,400,100,0.36343378
6903,Centro Falconiere,A,Republican Period,7,-200,-30,170,0.51629555
6903,Centro Falconiere,A,Early Imperial Period,8,-30,100,130,0.51629555
6903,Centro Falconiere,A,Mid-Imperial Period,9,100,200,100,0.51629555
6904,Centro Falconiere,A,Early Imperial Period,8,0,100,100,0.12031624
6904,Centro Falconiere,A,Mid-Imperial Period,9,100,300,200,0.12031624
6905,Centro Tre Denari,A,Early Bronze Age,1,-2300,-1700,600,0.11607759
6905,Centro Tre Denari,A,Middle Bronze Age,2,-1700,-1300,400,0.11607759
6905,Centro Tre Denari,A,Late Bronze Age,3,-1300,-1020,280,0.11607759
6905,Centro Tre Denari,A,Early Iron Age,4,-1020,-1000,20,0.11607759
6906,Statua,A,Late Iron Age,5,-600,-580,20,0.22606091
6906,Statua,A,Archaic Period,6,-580,-500,80,0.22606091
6906,Statua,B,Early Imperial Period,8,0,100,100,0.22606091
6906,Statua,B,Mid-Imperial Period,9,100,300,200,0.22606091
6907,Fosso della Mentuccia,A,Late Iron Age,5,-600,-580,20,0.060905259
6907,Fosso della Mentuccia,A,Archaic Period,6,-580,-400,180,0.060905259
6908,fosso della Mentuccia,A,Late Iron Age,5,-600,-580,20,0.091167971
6908,fosso della Mentuccia,A,Archaic Period,6,-580,-500,80,0.091167971
6909,Granaretto,A,Late Iron Age,5,-700,-580,120,0.31307763
6909,Granaretto,A,Archaic Period,6,-580,-500,80,0.31307763
6910,Statua,A,Early Imperial Period,8,0,100,100,0.081712537
6910,Statua,A,Mid-Imperial Period,9,100,300,200,0.081712537
6911,Santo Spirito,A,Early Imperial Period,8,0,100,100,0.057437018
6911,Santo Spirito,A,Mid-Imperial Period,9,100,200,100,0.057437018
6912,Santo Spirito,A,Republican Period,7,-200,-30,170,1.5206606
6912,Santo Spirito,A,Early Imperial Period,8,-30,100,130,1.5206606
6912,Santo Spirito,A,Mid-Imperial Period,9,100,300,200,1.5206606
6912,Santo Spirito,A,Late Imperial Period,10,300,400,100,1.5206606
6913,Santo Spirito,A,Early Bronze Age,1,-2300,-1700,600,0.11067317
6913,Santo Spirito,B,Late Iron Age,5,-600,-580,20,0.11067317
6913,Santo Spirito,B,Archaic Period,6,-580,-500,80,0.11067317
6914,Santo Spirito,A,Late Iron Age,5,-600,-580,20,0.10601581
6914,Santo Spirito,A,Archaic Period,6,-580,-500,80,0.10601581
6915,Santo Spirito,A,Late Iron Age,5,-700,-580,120,0.096183717
6915,Santo Spirito,A,Archaic Period,6,-580,-500,80,0.096183717
6916,Santo Spirito,A,Republican Period,7,-250,-100,150,0.13127384
6917,Santo Spirito,A,Republican Period,7,-100,-30,70,0.37338483
6917,Santo Spirito,A,Early Imperial Period,8,-30,100,130,0.37338483
6917,Santo Spirito,A,Mid-Imperial Period,9,100,250,150,0.37338483
6918,Santo Spirito,A,Early Imperial Period,8,0,100,100,0.12124365
6918,Santo Spirito,A,Mid-Imperial Period,9,100,200,100,0.12124365
6919,fosso del Quartaccio,A,Late Iron Age,5,-600,-580,20,0.061852224
6919,fosso del Quartaccio,A,Archaic Period,6,-580,-350,230,0.061852224
6919,fosso del Quartaccio,A,Republican Period,7,-350,-300,50,0.061852224
6920,,A,Late Iron Age,5,-600,-580,20,0.083636299
6920,,A,Archaic Period,6,-580,-500,80,0.083636299
6921,,A,Late Iron Age,5,-600,-580,20,0.076892115
6921,,A,Archaic Period,6,-580,-500,80,0.076892115
6921,,B,Early Imperial Period,8,0,100,100,0.076892115
6921,,B,Mid-Imperial Period,9,100,200,100,0.076892115
6922,,A,Late Iron Age,5,-600,-580,20,0.092502788
6922,,A,Archaic Period,6,-580,-500,80,0.092502788
6922,,B,Republican Period,7,-300,-100,200,0.092502788
6923,Casale al Vento,A,Late Iron Age,5,-600,-580,20,0.11171404
6923,Casale al Vento,A,Archaic Period,6,-580,-400,180,0.11171404
6924,Casale al Vento,A,Republican Period,7,-100,-30,70,0.22902334
6924,Casale al Vento,A,Early Imperial Period,8,-30,100,130,0.22902334
6924,Casale al Vento,A,Mid-Imperial Period,9,100,300,200,0.22902334
6925,Monteroni,A,Republican Period,7,-200,-30,170,0.39411411
6925,Monteroni,A,Early Imperial Period,8,-30,100,130,0.39411411
6925,Monteroni,A,Mid-Imperial Period,9,100,300,200,0.39411411
6925,Monteroni,A,Late Imperial Period,10,300,500,200,0.39411411
6926,Monteroni,A,Late Iron Age,5,-700,-580,120,0.064146422
6926,Monteroni,A,Archaic Period,6,-580,-500,80,0.064146422
6927,Casale al Vento,A,Late Iron Age,5,-600,-580,20,0.087250262
6927,Casale al Vento,A,Archaic Period,6,-580,-500,80,0.087250262
6928,Casale al Vento,A,Early Imperial Period,8,0,100,100,0.056432363
6928,Casale al Vento,A,Mid-Imperial Period,9,100,300,200,0.056432363
6929,C. Sanguinara,A,Republican Period,7,-300,-30,270,0.058353879
6929,C. Sanguinara,A,Early Imperial Period,8,-30,100,130,0.058353879
6929,C. Sanguinara,A,Mid-Imperial Period,9,100,300,200,0.058353879
6929,C. Sanguinara,A,Late Imperial Period,10,300,500,200,0.058353879
6930,C. Olmetto,A,Early Imperial Period,8,0,100,100,0.070103101
6930,C. Olmetto,A,Mid-Imperial Period,9,100,200,100,0.070103101
6931,Boietto,A,Late Iron Age,5,-600,-580,20,0.063156322
6931,Boietto,A,Archaic Period,6,-580,-500,80,0.063156322
6932,Boietto,A,Late Iron Age,5,-600,-580,20,0.035430014
6932,Boietto,A,Archaic Period,6,-580,-500,80,0.035430014
6932,Boietto,B,Republican Period,7,-300,-100,200,0.035430014
6933,Boietto,A,Late Iron Age,5,-600,-580,20,0.11455905
6933,Boietto,A,Archaic Period,6,-580,-500,80,0.11455905
6934,Boietto,A,Early Imperial Period,8,0,100,100,0.11359498
6934,Boietto,A,Mid-Imperial Period,9,100,300,200,0.11359498
6935,Boietto,A,Late Iron Age,5,-600,-580,20,0.24896893
6935,Boietto,A,Archaic Period,6,-580,-350,230,0.24896893
6935,Boietto,A,Republican Period,7,-350,-200,150,0.24896893
6936,Pianaccio,A,Late Iron Age,5,-600,-580,20,0.051224478
6936,Pianaccio,A,Archaic Period,6,-580,-500,80,0.051224478
6936,Pianaccio,B,Republican Period,7,-300,-30,270,0.051224478
6936,Pianaccio,B,Early Imperial Period,8,-30,100,130,0.051224478
6936,Pianaccio,B,Mid-Imperial Period,9,100,300,200,0.051224478
6936,Pianaccio,B,Late Imperial Period,10,300,500,200,0.051224478
6937,Il Muraccio,A,Late Iron Age,5,-600,-580,20,0.2137861
6937,Il Muraccio,A,Archaic Period,6,-580,-500,80,0.2137861
6937,Il Muraccio,B,Republican Period,7,-200,-30,170,0.2137861
6937,Il Muraccio,B,Early Imperial Period,8,-30,100,130,0.2137861
6938,Il Muraccio,A,Republican Period,7,-200,-30,170,0.60704923
6938,Il Muraccio,A,Early Imperial Period,8,-30,100,130,0.60704923
6938,Il Muraccio,A,Mid-Imperial Period,9,100,300,200,0.60704923
6938,Il Muraccio,A,Late Imperial Period,10,300,400,100,0.60704923
6939,Il Muraccio,A,Republican Period,7,-200,-30,170,0.20394255
6939,Il Muraccio,A,Early Imperial Period,8,-30,100,130,0.20394255
6939,Il Muraccio,A,Mid-Imperial Period,9,100,200,100,0.20394255
6940,Osteria Nuova,A,Early Imperial Period,8,0,100,100,0.042364821
6940,Osteria Nuova,A,Mid-Imperial Period,9,100,200,100,0.042364821
6941,Osteria Nuova,A,Late Iron Age,5,-600,-580,20,0.08126691
6941,Osteria Nuova,A,Archaic Period,6,-580,-500,80,0.08126691
6942,Tenuta di Palo,A,Republican Period,7,-200,-30,170,0.62009442
6942,Tenuta di Palo,A,Early Imperial Period,8,-30,100,130,0.62009442
6942,Tenuta di Palo,A,Mid-Imperial Period,9,100,300,200,0.62009442
6943,Tenuta di Palo,A,Early Imperial Period,8,0,100,100,0.087080009
6943,Tenuta di Palo,A,Mid-Imperial Period,9,100,300,200,0.087080009
6944,Tenuta di Palo,A,Late Iron Age,5,-600,-580,20,0.045660462
6944,Tenuta di Palo,A,Archaic Period,6,-580,-500,80,0.045660462
6945,Tenuta di Palo,A,Republican Period,7,-200,-30,170,0.69541341
6945,Tenuta di Palo,A,Early Imperial Period,8,-30,100,130,0.69541341
6945,Tenuta di Palo,A,Mid-Imperial Period,9,100,300,200,0.69541341
6945,Tenuta di Palo,A,Late Imperial Period,10,300,500,200,0.69541341
6945,Tenuta di Palo,A,Late Antique Period,11,500,600,100,0.69541341
6946,Tenuta di Palo,A,Early Imperial Period,8,0,100,100,0.072591327
6946,Tenuta di Palo,A,Mid-Imperial Period,9,100,200,100,0.072591327
6947,Tenuta di Palo,A,Late Iron Age,5,-600,-580,20,0.15602109
6947,Tenuta di Palo,A,Archaic Period,6,-580,-350,230,0.15602109
6947,Tenuta di Palo,A,Republican Period,7,-350,-200,150,0.15602109
6948,Tenuta di Palo,A,Late Iron Age,5,-600,-580,20,0.055471126
6948,Tenuta di Palo,A,Archaic Period,6,-580,-500,80,0.055471126
6949,Tenuta di Palo,A,Late Iron Age,5,-600,-580,20,0.077248462
6949,Tenuta di Palo,A,Archaic Period,6,-580,-350,230,0.077248462
6949,Tenuta di Palo,A,Republican Period,7,-350,-30,320,0.077248462
6949,Tenuta di Palo,A,Early Imperial Period,8,-30,100,130,0.077248462
6950,Ceri,A,Republican Period,7,-300,-30,270,0.15424348
6950,Ceri,A,Early Imperial Period,8,-30,100,130,0.15424348
6950,Ceri,A,Mid-Imperial Period,9,100,300,200,0.15424348
6950,Ceri,A,Late Imperial Period,10,300,500,200,0.15424348
6951,fosso dei Due Ponti,A,Late Iron Age,5,-600,-580,20,0.029448321
6951,fosso dei Due Ponti,A,Archaic Period,6,-580,-500,80,0.029448321
6952,Osteria Nuova,A,Late Iron Age,5,-700,-580,120,0.047565702
6952,Osteria Nuova,A,Archaic Period,6,-580,-500,80,0.047565702
6953,Osteria Nuova,A,Late Iron Age,5,-600,-580,20,0.044875078
6953,Osteria Nuova,A,Archaic Period,6,-580,-500,80,0.044875078
6954,Tenuta di Palo,A,Early Imperial Period,8,-30,100,130,0.092256978
6954,Tenuta di Palo,A,Mid-Imperial Period,9,100,300,200,0.092256978
6954,Tenuta di Palo,A,Late Imperial Period,10,300,400,100,0.092256978
6955,Tenuta di Palo,A,Late Iron Age,5,-600,-580,20,0.10671006
6955,Tenuta di Palo,A,Archaic Period,6,-580,-500,80,0.10671006
6955,Tenuta di Palo,B,Republican Period,7,-300,-100,200,0.10671006
6956,Tenuta di Palo,A,Late Iron Age,5,-600,-580,20,0.082056716
6956,Tenuta di Palo,A,Archaic Period,6,-580,-400,180,0.082056716
6957,Piana Vaccina/Cerreto,A,Late Iron Age,5,-600,-580,20,0.067570306
6957,Piana Vaccina/Cerreto,A,Archaic Period,6,-580,-500,80,0.067570306
6958,,A,Late Iron Age,5,-600,-580,20,0.046973743
6958,,A,Archaic Period,6,-580,-500,80,0.046973743
6958,,B,Republican Period,7,-300,-30,270,0.046973743
6958,,B,Early Imperial Period,8,-30,100,130,0.046973743
6958,,B,Mid-Imperial Period,9,100,300,200,0.046973743
6958,,B,Late Imperial Period,10,300,500,200,0.046973743
6959,Cerreto,A,Late Iron Age,5,-700,-580,120,0.42595792
6959,Cerreto,A,Archaic Period,6,-580,-500,80,0.42595792
6960,Infernaccio,A,Early Imperial Period,8,0,100,100,0.06736099
6960,Infernaccio,A,Mid-Imperial Period,9,100,300,200,0.06736099
6961,Infernaccio,A,Late Iron Age,5,-600,-580,20,0.046571277
6961,Infernaccio,A,Archaic Period,6,-580,-500,80,0.046571277
6962,Infernaccio,A,Late Iron Age,5,-600,-580,20,0.068512231
6962,Infernaccio,A,Archaic Period,6,-580,-350,230,0.068512231
6962,Infernaccio,A,Republican Period,7,-350,-100,250,0.068512231
6963,Infernaccio,A,Late Iron Age,5,-600,-580,20,0.15530893
6963,Infernaccio,A,Archaic Period,6,-580,-500,80,0.15530893
6963,Infernaccio,B,Republican Period,7,-300,-30,270,0.15530893
6963,Infernaccio,B,Early Imperial Period,8,-30,100,130,0.15530893
6963,Infernaccio,B,Mid-Imperial Period,9,100,300,200,0.15530893
6964,Muracci di Vaccina,A,Republican Period,7,-200,-30,170,0.42213392
6964,Muracci di Vaccina,A,Early Imperial Period,8,-30,100,130,0.42213392
6965,Sorgente la Cannella,A,Late Iron Age,5,-600,-580,20,0.039262928
6965,Sorgente la Cannella,A,Archaic Period,6,-580,-500,80,0.039262928
6966,Sorgente la Cannella,A,Late Iron Age,5,-600,-580,20,0.054468207
6966,Sorgente la Cannella,A,Archaic Period,6,-580,-500,80,0.054468207
6966,Sorgente la Cannella,B,Mid-Imperial Period,9,100,300,200,0.054468207
6967,Rimessa Nuova,A,Republican Period,7,-300,-30,270,0.61400038
6967,Rimessa Nuova,A,Early Imperial Period,8,-30,100,130,0.61400038
6967,Rimessa Nuova,A,Mid-Imperial Period,9,100,300,200,0.61400038
6967,Rimessa Nuova,A,Late Imperial Period,10,300,400,100,0.61400038
6968,Muracci di Vaccina,A,Late Iron Age,5,-600,-580,20,0.032534793
6968,Muracci di Vaccina,A,Archaic Period,6,-580,-500,80,0.032534793
6968,Muracci di Vaccina,B,Republican Period,7,-300,-100,200,0.032534793
6969,,A,Republican Period,7,-100,-30,70,0.028541142
6969,,A,Early Imperial Period,8,-30,100,130,0.028541142
6969,,A,Mid-Imperial Period,9,100,300,200,0.028541142
6970,Muracci di Vaccina,A,Late Iron Age,5,-600,-580,20,0.034793988
6970,Muracci di Vaccina,A,Archaic Period,6,-580,-500,80,0.034793988
6971,Casali dei due ponti,A,Early Imperial Period,8,0,100,100,0.065703839
6971,Casali dei due ponti,A,Mid-Imperial Period,9,100,300,200,0.065703839
6971,Casali dei due ponti,A,Late Imperial Period,10,300,400,100,0.065703839
6972,Casali dei Due Ponti,A,Republican Period,7,-200,-30,170,0.29025134
6972,Casali dei Due Ponti,A,Early Imperial Period,8,-30,100,130,0.29025134
6972,Casali dei Due Ponti,A,Mid-Imperial Period,9,100,300,200,0.29025134
6973,Rimessa Nuova,A,Early Imperial Period,8,0,100,100,0.041869279
6973,Rimessa Nuova,A,Mid-Imperial Period,9,100,300,200,0.041869279
6974,Rimessa Nuova,A,Late Iron Age,5,-600,-580,20,0.041487098
6974,Rimessa Nuova,A,Archaic Period,6,-580,-500,80,0.041487098
6975,Rimessa Nuova,A,Late Iron Age,5,-600,-580,20,0.070258424
6975,Rimessa Nuova,A,Archaic Period,6,-580,-500,80,0.070258424
6976,Rimessa Nuova,A,Late Iron Age,5,-600,-580,20,0.047840089
6976,Rimessa Nuova,A,Archaic Period,6,-580,-500,80,0.047840089
6977,Rimessa Nuova,A,Late Iron Age,5,-600,-580,20,0.090871632
6977,Rimessa Nuova,A,Archaic Period,6,-580,-500,80,0.090871632
6978,Rimessa Nuova,A,Early Imperial Period,8,0,100,100,0.13977665
6978,Rimessa Nuova,A,Mid-Imperial Period,9,100,300,200,0.13977665
6978,Rimessa Nuova,A,Late Imperial Period,10,300,500,200,0.13977665
6979,Rimessa Nuova,A,Late Iron Age,5,-600,-580,20,0.061989788
6979,Rimessa Nuova,A,Archaic Period,6,-580,-500,80,0.061989788
6980,Procoio di Ceri,A,Republican Period,7,-300,-30,270,0.71160555
6980,Procoio di Ceri,A,Early Imperial Period,8,-30,100,130,0.71160555
6980,Procoio di Ceri,A,Mid-Imperial Period,9,100,300,200,0.71160555
6980,Procoio di Ceri,A,Late Imperial Period,10,300,500,200,0.71160555
6981,Birbo,A,Republican Period,7,-300,-30,270,0.20505285
6981,Birbo,A,Early Imperial Period,8,-30,100,130,0.20505285
6981,Birbo,A,Mid-Imperial Period,9,100,300,200,0.20505285
6981,Birbo,A,Late Imperial Period,10,300,400,100,0.20505285
6982,Birbo,A,Late Iron Age,5,-600,-580,20,0.079909451
6982,Birbo,A,Archaic Period,6,-580,-500,80,0.079909451
6983,Birbo,A,Republican Period,7,-200,-30,170,0.076630376
6984,Font.le della Regina,A,Early Imperial Period,8,0,100,100,0.27275679
6984,Font.le della Regina,A,Mid-Imperial Period,9,100,300,200,0.27275679
6985,Font.le della Regina,A,Early Imperial Period,8,0,100,100,0.34396139
6985,Font.le della Regina,A,Mid-Imperial Period,9,100,300,200,0.34396139
6986,Il Castellaccio,A,Late Iron Age,5,-600,-580,20,0.11559507
6986,Il Castellaccio,A,Archaic Period,6,-580,-400,180,0.11559507
6987,Migliorie di Zambria,A,Late Iron Age,5,-600,-580,20,0.092133924
6987,Migliorie di Zambria,A,Archaic Period,6,-580,-400,180,0.092133924
6988,Migliorie di Zambria,A,Late Iron Age,5,-600,-580,20,0.092133768
6988,Migliorie di Zambria,A,Archaic Period,6,-580,-500,80,0.092133768
6989,Migliorie di Zambria,A,Late Iron Age,5,-600,-580,20,0.092137031
6989,Migliorie di Zambria,A,Archaic Period,6,-580,-500,80,0.092137031
6990,P.te S. Paolo,A,Late Bronze Age,3,-1200,-1020,180,0.13446727
6990,P.te S. Paolo,A,Early Iron Age,4,-1020,-1000,20,0.13446727
6991,P.te S. Paolo,A,Late Bronze Age,3,-1300,-1020,280,0.092532843
6991,P.te S. Paolo,A,Early Iron Age,4,-1020,-1000,20,0.092532843
6992,Il Pineto,A,Republican Period,7,-200,-30,170,0.13718142
6992,Il Pineto,A,Early Imperial Period,8,-30,100,130,0.13718142
6992,Il Pineto,A,Mid-Imperial Period,9,100,300,200,0.13718142
6992,Il Pineto,A,Late Imperial Period,10,300,400,100,0.13718142
6993,C. Sanguinara,A,Republican Period,7,-300,-100,200,0.067011647
6994,Quartaccio,A,Republican Period,7,-200,-30,170,0.15775445
6994,Quartaccio,A,Early Imperial Period,8,-30,100,130,0.15775445
6994,Quartaccio,A,Mid-Imperial Period,9,100,300,200,0.15775445
6995,Quartaccio,A,Late Iron Age,5,-600,-580,20,0.12520871
6995,Quartaccio,A,Archaic Period,6,-580,-500,80,0.12520871
6996,fosso del Quartaccio,A,Late Iron Age,5,-600,-580,20,0.054137643
6996,fosso del Quartaccio,A,Archaic Period,6,-580,-350,230,0.054137643
6996,fosso del Quartaccio,A,Republican Period,7,-350,-200,150,0.054137643
6997,Fosso del Manganello,A,Middle Bronze Age,2,-1700,-1300,400,0.12980665
6997,Fosso del Manganello,A,Late Bronze Age,3,-1300,-1020,280,0.12980665
6997,Fosso del Manganello,A,Early Iron Age,4,-1020,-1000,20,0.12980665
6998,Carlottine,A,Republican Period,7,-200,-30,170,0.1608908
6998,Carlottine,A,Early Imperial Period,8,-30,100,130,0.1608908
6998,Carlottine,A,Mid-Imperial Period,9,100,300,200,0.1608908
6998,Carlottine,A,Late Imperial Period,10,300,400,100,0.1608908
6999,S. Felice,A,Republican Period,7,-200,-30,170,0.13291447
6999,S. Felice,A,Early Imperial Period,8,-30,100,130,0.13291447
6999,S. Felice,A,Mid-Imperial Period,9,100,300,200,0.13291447
6999,S. Felice,A,Late Imperial Period,10,300,400,100,0.13291447
7000,Cervaro,A,Republican Period,7,-200,-30,170,0.08291316
7000,Cervaro,A,Early Imperial Period,8,-30,100,130,0.08291316
7000,Cervaro,A,Mid-Imperial Period,9,100,200,100,0.08291316
7001,Casalone di Ceri,A,Republican Period,7,-300,-30,270,0.095808446
7001,Casalone di Ceri,A,Early Imperial Period,8,-30,100,130,0.095808446
7001,Casalone di Ceri,A,Mid-Imperial Period,9,100,300,200,0.095808446
7001,Casalone di Ceri,A,Late Imperial Period,10,300,400,100,0.095808446
7002,Quarto di Montelungo,A,Republican Period,7,-300,-30,270,0.15140429
7002,Quarto di Montelungo,A,Early Imperial Period,8,-30,100,130,0.15140429
7002,Quarto di Montelungo,A,Mid-Imperial Period,9,100,300,200,0.15140429
7003,Pian Cerese,A,Late Bronze Age,3,-1200,-1020,180,0.090413637
7003,Pian Cerese,A,Early Iron Age,4,-1020,-1000,20,0.090413637
7004,S. Sebastiano,A,Late Bronze Age,3,-1300,-1020,280,0.052327368
7004,S. Sebastiano,A,Early Iron Age,4,-1020,-1000,20,0.052327368
7005,Ceri,A,Late Bronze Age,3,-1300,-1020,280,0.044725247
7005,Ceri,A,Early Iron Age,4,-1020,-1000,20,0.044725247
7006,Porrazzetta,A,Republican Period,7,-300,-30,270,0.10641667
7006,Porrazzetta,A,Early Imperial Period,8,-30,100,130,0.10641667
7006,Porrazzetta,A,Mid-Imperial Period,9,100,300,200,0.10641667
7007,Sughere,A,Republican Period,7,-200,-30,170,0.094077125
7007,Sughere,A,Early Imperial Period,8,-30,100,130,0.094077125
7008,fosso del Tavolato,A,Middle Bronze Age,2,-1700,-1300,400,0.097574212
7008,fosso del Tavolato,A,Late Bronze Age,3,-1300,-1200,100,0.097574212
7009,fosso del Castellaccio,A,Early Bronze Age,1,-2300,-1700,600,0.050043486
7009,fosso del Castellaccio,A,Middle Bronze Age,2,-1700,-1300,400,0.050043486
7009,fosso del Castellaccio,A,Late Bronze Age,3,-1300,-1020,280,0.050043486
7009,fosso del Castellaccio,A,Early Iron Age,4,-1020,-1000,20,0.050043486
7010,fosso del Castellaccio,A,Middle Bronze Age,2,-1700,-1300,400,0.10991041
7010,fosso del Castellaccio,B,Late Bronze Age,3,-1200,-1020,180,0.10991041
7010,fosso del Castellaccio,B,Early Iron Age,4,-1020,-1000,20,0.10991041
7011,fosso del Castellaccio,A,Late Bronze Age,3,-1300,-1020,280,0.10374662
7011,fosso del Castellaccio,A,Early Iron Age,4,-1020,-1000,20,0.10374662
7012,Ladispoli,A,Early Imperial Period,8,0,100,100,0.3790184
7012,Ladispoli,A,Mid-Imperial Period,9,100,300,200,0.3790184
7012,Ladispoli,A,Late Imperial Period,10,300,400,100,0.3790184
7013,Palidoro,A,Early Bronze Age,1,-2300,-1700,600,0.074577667
7013,Palidoro,A,Middle Bronze Age,2,-1700,-1300,400,0.074577667
7013,Palidoro,A,Late Bronze Age,3,-1300,-1020,280,0.074577667
7013,Palidoro,A,Early Iron Age,4,-1020,-800,220,0.074577667
7014,C.li di Vaccina,A,Early Bronze Age,1,-2300,-1700,600,0.026274865
7014,C.li di Vaccina,A,Middle Bronze Age,2,-1700,-1300,400,0.026274865
7014,C.li di Vaccina,A,Late Bronze Age,3,-1300,-1020,280,0.026274865
7014,C.li di Vaccina,A,Early Iron Age,4,-1020,-1000,20,0.026274865
7015,Tenuta di Palo,A,Republican Period,7,-300,-30,270,0.25640631
7015,Tenuta di Palo,A,Early Imperial Period,8,-30,100,130,0.25640631
7015,Tenuta di Palo,A,Mid-Imperial Period,9,100,300,200,0.25640631
7016,Ladispoli,A,Early Imperial Period,8,-30,100,130,0.10140845
7016,Ladispoli,A,Mid-Imperial Period,9,100,300,200,0.10140845
7016,Ladispoli,A,Late Imperial Period,10,300,500,200,0.10140845
7017,Monteroni,A,Early Imperial Period,8,0,100,100,0.073488049
7017,Monteroni,A,Mid-Imperial Period,9,100,200,100,0.073488049
7018,Valle Canneto,A,Late Iron Age,5,-600,-580,20,0.12366264
7018,Valle Canneto,A,Archaic Period,6,-580,-400,180,0.12366264
7019,M. Abbadoncino,A,Late Iron Age,5,-600,-580,20,0.13117331
7019,M. Abbadoncino,A,Archaic Period,6,-580,-500,80,0.13117331
7019,M. Abbadoncino,B,Republican Period,7,-200,-30,170,0.13117331
7019,M. Abbadoncino,B,Early Imperial Period,8,-30,100,130,0.13117331
7020,Monteroni,A,Republican Period,7,-300,-100,200,0.16722642
7021,Quartaccio,A,Late Iron Age,5,-600,-580,20,0.10091195
7021,Quartaccio,A,Archaic Period,6,-580,-500,80,0.10091195
7021,Quartaccio,B,Republican Period,7,-300,-100,200,0.10091195
7022,Valle del Ferraccio,A,Early Bronze Age,1,-2300,-1700,600,0.12231875
7022,Valle del Ferraccio,A,Middle Bronze Age,2,-1700,-1300,400,0.12231875
7022,Valle del Ferraccio,A,Late Bronze Age,3,-1300,-1020,280,0.12231875
7022,Valle del Ferraccio,A,Early Iron Age,4,-1020,-1000,20,0.12231875
7023,fosso dei Due Ponti,A,Early Bronze Age,1,-2300,-1700,600,0.0502255
7023,fosso dei Due Ponti,A,Middle Bronze Age,2,-1700,-1300,400,0.0502255
7023,fosso dei Due Ponti,A,Late Bronze Age,3,-1300,-1020,280,0.0502255
7023,fosso dei Due Ponti,A,Early Iron Age,4,-1020,-1000,20,0.0502255
7024,Quarticciolo,A,Late Iron Age,5,-600,-580,20,0.097539179
7024,Quarticciolo,A,Archaic Period,6,-580,-500,80,0.097539179
7024,Quarticciolo,B,Mid-Imperial Period,9,100,300,200,0.097539179
7025,Pian d'Alma,A,Republican Period,7,-200,-30,170,0.059999999
7025,Pian d'Alma,A,Early Imperial Period,8,-30,100,130,0.059999999
7026,Pian d'Alma,A,Early Imperial Period,8,-30,100,130,0.80000001
7026,Pian d'Alma,A,Mid-Imperial Period,9,100,300,200,0.80000001
7026,Pian d'Alma,A,Late Imperial Period,10,300,500,200,0.80000001
7026,Pian d'Alma,A,Late Antique Period,11,500,1000,500,0.80000001
7027,Portiglione,A,Republican Period,7,-300,-30,270,0.059999999
7027,Portiglione,A,Early Imperial Period,8,-30,100,130,0.059999999
7027,Portiglione,A,Mid-Imperial Period,9,100,300,200,0.059999999
7027,Portiglione,A,Late Imperial Period,10,300,500,200,0.059999999
7028,Portiglione,A,Early Imperial Period,8,-30,100,130,0.30000001
7028,Portiglione,A,Mid-Imperial Period,9,100,200,100,0.30000001
7029,Portiglione,A,Late Bronze Age,3,-1300,-1020,280,0.1
7029,Portiglione,A,Early Iron Age,4,-1020,-1000,20,0.1
7030,Tartana,A,Republican Period,7,-300,-100,200,0.02
7031,Puntone,A,Republican Period,7,-200,-30,170,0.30000001
7031,Puntone,A,Early Imperial Period,8,-30,100,130,0.30000001
7031,Puntone,A,Mid-Imperial Period,9,100,300,200,0.30000001
7031,Puntone,A,Late Imperial Period,10,300,500,200,0.30000001
7032,Puntone Nuovo,A,Late Bronze Age,3,-1300,-1020,280,0.2
7032,Puntone Nuovo,A,Early Iron Age,4,-1020,-1000,20,0.2
7033,Padule di Scarlino,A,Early Imperial Period,8,0,100,100,0.30000001
7033,Padule di Scarlino,A,Mid-Imperial Period,9,100,200,100,0.30000001
7034,Puntone Nuovo,A,Early Bronze Age,1,-2300,-1700,600,0.1
7034,Puntone Nuovo,A,Middle Bronze Age,2,-1700,-1300,400,0.1
7034,Puntone Nuovo,A,Late Bronze Age,3,-1300,-1020,280,0.1
7034,Puntone Nuovo,A,Early Iron Age,4,-1020,-1000,20,0.1
7035,Meleta,A,Late Bronze Age,3,-1300,-1020,280,0.2
7035,Meleta,A,Early Iron Age,4,-1020,-1000,20,0.2
7036,Meleta,A,Republican Period,7,-150,-30,120,0.5
7037,Casa Fonte al Cerro,A,Republican Period,7,-300,-30,270,0.01
7037,Casa Fonte al Cerro,A,Early Imperial Period,8,-30,100,130,0.01
7037,Casa Fonte al Cerro,A,Mid-Imperial Period,9,100,300,200,0.01
7037,Casa Fonte al Cerro,A,Late Imperial Period,10,300,500,200,0.01
7038,Casa Fonte al Cerro,A,Republican Period,7,-300,-30,270,0.1
7038,Casa Fonte al Cerro,A,Early Imperial Period,8,-30,100,130,0.1
7038,Casa Fonte al Cerro,A,Mid-Imperial Period,9,100,300,200,0.1
7038,Casa Fonte al Cerro,A,Late Imperial Period,10,300,500,200,0.1
7039,Podere Montomoli,A,Republican Period,7,-300,-30,270,0.01
7039,Podere Montomoli,A,Early Imperial Period,8,-30,100,130,0.01
7039,Podere Montomoli,A,Mid-Imperial Period,9,100,300,200,0.01
7039,Podere Montomoli,A,Late Imperial Period,10,300,500,200,0.01
7040,Poggio Carbonaia,A,Republican Period,7,-300,-30,270,0.2
7040,Poggio Carbonaia,A,Early Imperial Period,8,-30,100,130,0.2
7040,Poggio Carbonaia,A,Mid-Imperial Period,9,100,300,200,0.2
7040,Poggio Carbonaia,A,Late Imperial Period,10,300,500,200,0.2
7041,Poggio Carbonaia,A,Early Imperial Period,8,0,100,100,0.30000001
7041,Poggio Carbonaia,A,Mid-Imperial Period,9,100,300,200,0.30000001
7041,Poggio Carbonaia,A,Late Imperial Period,10,300,400,100,0.30000001
7042,Casa Petricciani,A,Republican Period,7,-100,-30,70,0.02
7043,Podere la Forcola,A,Republican Period,7,-300,-30,270,0.1
7043,Podere la Forcola,A,Early Imperial Period,8,-30,100,130,0.1
7043,Podere la Forcola,A,Mid-Imperial Period,9,100,300,200,0.1
7043,Podere la Forcola,A,Late Imperial Period,10,300,500,200,0.1
7044,Podere la Forcola,A,Mid-Imperial Period,9,100,200,100,0.1
7045,Podere Cascine,A,Republican Period,7,-300,-30,270,0.039999999
7045,Podere Cascine,A,Early Imperial Period,8,-30,100,130,0.039999999
7045,Podere Cascine,A,Mid-Imperial Period,9,100,300,200,0.039999999
7045,Podere Cascine,A,Late Imperial Period,10,300,500,200,0.039999999
7046,Casa Valdi,A,Early Imperial Period,8,-30,100,130,0.30000001
7046,Casa Valdi,A,Mid-Imperial Period,9,100,300,200,0.30000001
7047,Casa Val Molina,A,Late Iron Age,5,-700,-600,100,0.02
7048,Pian d'Alma,A,Early Imperial Period,8,0,100,100,0.01
7048,Pian d'Alma,A,Mid-Imperial Period,9,100,200,100,0.01
7049,Podere Pupillo,A,Republican Period,7,-300,-30,270,0.1
7049,Podere Pupillo,A,Early Imperial Period,8,-30,100,130,0.1
7049,Podere Pupillo,A,Mid-Imperial Period,9,100,300,200,0.1
7049,Podere Pupillo,A,Late Imperial Period,10,300,500,200,0.1
7050,Podere Cavallari,A,Republican Period,7,-300,-30,270,0.039999999
7050,Podere Cavallari,A,Early Imperial Period,8,-30,100,130,0.039999999
7050,Podere Cavallari,A,Mid-Imperial Period,9,100,300,200,0.039999999
7050,Podere Cavallari,A,Late Imperial Period,10,300,500,200,0.039999999
7051,Podere Canali,A,Early Imperial Period,8,-30,100,130,0.02
7052,Campeggio il Fontino,A,Republican Period,7,-300,-30,270,0.02
7052,Campeggio il Fontino,A,Early Imperial Period,8,-30,100,130,0.02
7052,Campeggio il Fontino,A,Mid-Imperial Period,9,100,300,200,0.02
7052,Campeggio il Fontino,A,Late Imperial Period,10,300,500,200,0.02
7053,Podere Ornani,A,Republican Period,7,-300,-30,270,0.1
7053,Podere Ornani,A,Early Imperial Period,8,-30,100,130,0.1
7053,Podere Ornani,A,Mid-Imperial Period,9,100,300,200,0.1
7053,Podere Ornani,A,Late Imperial Period,10,300,500,200,0.1
7054,Imposto,A,Republican Period,7,-300,-30,270,0.059999999
7054,Imposto,A,Early Imperial Period,8,-30,100,130,0.059999999
7054,Imposto,A,Mid-Imperial Period,9,100,300,200,0.059999999
7054,Imposto,A,Late Imperial Period,10,300,500,200,0.059999999
7055,Podere Imposto,A,Republican Period,7,-300,-30,270,0.050000001
7055,Podere Imposto,A,Early Imperial Period,8,-30,100,130,0.050000001
7055,Podere Imposto,A,Mid-Imperial Period,9,100,300,200,0.050000001
7055,Podere Imposto,A,Late Imperial Period,10,300,500,200,0.050000001
7056,Imposto,A,Early Imperial Period,8,-30,100,130,0.059999999
7057,Casa Campo di Chiara,A,Late Iron Age,5,-700,-600,100,1
7057,Casa Campo di Chiara,A,Republican Period,7,-300,-30,270,0.2
7058,Casa Col di Sasso,A,Republican Period,7,-300,-30,270,0.01
7058,Casa Col di Sasso,A,Early Imperial Period,8,-30,100,130,0.01
7058,Casa Col di Sasso,A,Mid-Imperial Period,9,100,300,200,0.01
7058,Casa Col di Sasso,A,Late Imperial Period,10,300,500,200,0.01
7059,Il Campaccio,A,Republican Period,7,-300,-30,270,0.039999999
7059,Il Campaccio,A,Early Imperial Period,8,-30,100,130,0.039999999
7059,Il Campaccio,A,Mid-Imperial Period,9,100,300,200,0.039999999
7059,Il Campaccio,A,Late Imperial Period,10,300,500,200,0.039999999
7060,Casa Campo di Chiara,A,Republican Period,7,-300,-30,270,0.039999999
7060,Casa Campo di Chiara,A,Early Imperial Period,8,-30,100,130,0.039999999
7060,Casa Campo di Chiara,A,Mid-Imperial Period,9,100,300,200,0.039999999
7060,Casa Campo di Chiara,A,Late Imperial Period,10,300,500,200,0.039999999
7061,La Pieve,A,Republican Period,7,-100,-30,70,2
7061,La Pieve,A,Early Imperial Period,8,-30,100,130,2
7061,La Pieve,A,Mid-Imperial Period,9,100,300,200,2
7061,La Pieve,A,Late Imperial Period,10,300,500,200,2
7061,La Pieve,A,Late Antique Period,11,500,600,100,2
7062,Casa Beccanina,A,Republican Period,7,-300,-30,270,0.30000001
7062,Casa Beccanina,A,Early Imperial Period,8,-30,100,130,0.30000001
7062,Casa Beccanina,A,Mid-Imperial Period,9,100,300,200,0.30000001
7062,Casa Beccanina,A,Late Imperial Period,10,300,500,200,0.30000001
7063,Casa Beccanina,A,Republican Period,7,-300,-30,270,0.059999999
7063,Casa Beccanina,A,Early Imperial Period,8,-30,100,130,0.059999999
7063,Casa Beccanina,A,Mid-Imperial Period,9,100,300,200,0.059999999
7063,Casa Beccanina,A,Late Imperial Period,10,300,500,200,0.059999999
7064,Podere La Pieve,A,Early Imperial Period,8,-30,100,130,0.059999999
7065,Casa Il Pino,A,Republican Period,7,-100,-30,70,0.80000001
7065,Casa Il Pino,A,Early Imperial Period,8,-30,100,130,0.80000001
7065,Casa Il Pino,A,Mid-Imperial Period,9,100,200,100,0.80000001
7066,Casa Il Pino,A,Republican Period,7,-300,-100,200,0.01
7067,Casa Il Pino,A,Republican Period,7,-300,-30,270,0.059999999
7067,Casa Il Pino,A,Early Imperial Period,8,-30,100,130,0.059999999
7067,Casa Il Pino,A,Mid-Imperial Period,9,100,300,200,0.059999999
7067,Casa Il Pino,A,Late Imperial Period,10,300,500,200,0.059999999
7068,Casa Il Pino,A,Republican Period,7,-300,-30,270,0.01
7068,Casa Il Pino,A,Early Imperial Period,8,-30,100,130,0.01
7068,Casa Il Pino,A,Mid-Imperial Period,9,100,300,200,0.01
7068,Casa Il Pino,A,Late Imperial Period,10,300,500,200,0.01
7069,Campo al Piombo,A,Republican Period,7,-100,-30,70,0.30000001
7069,Campo al Piombo,A,Early Imperial Period,8,-30,100,130,0.30000001
7070,Il Pelagone,A,Republican Period,7,-300,-30,270,0.02
7070,Il Pelagone,A,Early Imperial Period,8,-30,100,130,0.02
7070,Il Pelagone,A,Mid-Imperial Period,9,100,300,200,0.02
7070,Il Pelagone,A,Late Imperial Period,10,300,500,200,0.02
7071,Casa Stella Vignale,A,Republican Period,7,-300,-30,270,0.059999999
7071,Casa Stella Vignale,A,Early Imperial Period,8,-30,100,130,0.059999999
7071,Casa Stella Vignale,A,Mid-Imperial Period,9,100,300,200,0.059999999
7071,Casa Stella Vignale,A,Late Imperial Period,10,300,500,200,0.059999999
7072,Casa Stella Vignale,A,Mid-Imperial Period,9,200,300,100,0.059999999
7072,Casa Stella Vignale,A,Late Imperial Period,10,300,400,100,0.059999999
7073,Casa S. Ferdinando,A,Republican Period,7,-300,-30,270,0.02
7073,Casa S. Ferdinando,A,Early Imperial Period,8,-30,100,130,0.02
7073,Casa S. Ferdinando,A,Mid-Imperial Period,9,100,300,200,0.02
7073,Casa S. Ferdinando,A,Late Imperial Period,10,300,500,200,0.02
7074,Poggio Castiglione,A,Republican Period,7,-300,-100,200,0.69999999
7075,Poggio Castiglione,A,Republican Period,7,-200,-30,170,0.039999999
7076,Poggio Castiglione,A,Republican Period,7,-300,-30,270,0.02
7076,Poggio Castiglione,A,Early Imperial Period,8,-30,100,130,0.02
7076,Poggio Castiglione,A,Mid-Imperial Period,9,100,300,200,0.02
7076,Poggio Castiglione,A,Late Imperial Period,10,300,500,200,0.02
7077,Casa Gozzuto I,A,Republican Period,7,-50,-30,20,0.30000001
7077,Casa Gozzuto I,A,Early Imperial Period,8,-30,100,130,0.30000001
7077,Casa Gozzuto I,A,Mid-Imperial Period,9,100,250,150,0.30000001
7078,Podere S. Ansano,A,Early Imperial Period,8,-30,100,130,0.2
7078,Podere S. Ansano,A,Mid-Imperial Period,9,100,300,200,0.2
7078,Podere S. Ansano,A,Late Imperial Period,10,300,450,150,0.2
7079,Podere S. Ansano,A,Republican Period,7,-300,-30,270,0.029999999
7079,Podere S. Ansano,A,Early Imperial Period,8,-30,100,130,0.029999999
7079,Podere S. Ansano,A,Mid-Imperial Period,9,100,300,200,0.029999999
7079,Podere S. Ansano,A,Late Imperial Period,10,300,500,200,0.029999999
7080,S. Ansano,A,Republican Period,7,-200,-30,170,0.02
7081,Podere le Vigne,A,Republican Period,7,-300,-100,200,0.30000001
7082,Palazzo Guelfi,A,Republican Period,7,-200,-30,170,0.039999999
7083,Palazzo Guelfi,A,Republican Period,7,-300,-30,270,0.039999999
7083,Palazzo Guelfi,A,Early Imperial Period,8,-30,100,130,0.039999999
7083,Palazzo Guelfi,A,Mid-Imperial Period,9,100,300,200,0.039999999
7083,Palazzo Guelfi,A,Late Imperial Period,10,300,500,200,0.039999999
7084,Palazzo Guelfi,A,Republican Period,7,-300,-30,270,0.30000001
7084,Palazzo Guelfi,A,Early Imperial Period,8,-30,100,130,0.30000001
7084,Palazzo Guelfi,A,Mid-Imperial Period,9,100,300,200,0.30000001
7084,Palazzo Guelfi,A,Late Imperial Period,10,300,500,200,0.30000001
7085,Podere Poggetti Vecchi,A,Late Iron Age,5,-700,-600,100,0.059999999
7087,Podere Il Fico,A,Republican Period,7,-200,-100,100,0.1
7088,I Poggetti,A,Republican Period,7,-300,-200,100,0.1
7089,I Poggi,A,Republican Period,7,-100,-30,70,0.059999999
7089,I Poggi,A,Early Imperial Period,8,-30,50,80,0.059999999
7090,Palazzo Lenzi,A,Republican Period,7,-300,-200,100,0.039999999
7092,Podere Pecora Vecchia,A,Republican Period,7,-300,-30,270,0.039999999
7092,Podere Pecora Vecchia,A,Early Imperial Period,8,-30,100,130,0.039999999
7092,Podere Pecora Vecchia,A,Mid-Imperial Period,9,100,300,200,0.039999999
7092,Podere Pecora Vecchia,A,Late Imperial Period,10,300,500,200,0.039999999
7093,Pecora Vecchia,A,Late Iron Age,5,-700,-600,100,0.5
7094,Podere Pecora Vecchia,A,Republican Period,7,-50,-30,20,0.07
7094,Podere Pecora Vecchia,A,Early Imperial Period,8,-30,100,130,0.07
7095,Podere il Tesorino,A,Republican Period,7,-300,-30,270,0.02
7095,Podere il Tesorino,A,Early Imperial Period,8,-30,100,130,0.02
7095,Podere il Tesorino,A,Mid-Imperial Period,9,100,300,200,0.02
7095,Podere il Tesorino,A,Late Imperial Period,10,300,500,200,0.02
7096,Vado all'Arancio,A,Early Imperial Period,8,-30,100,130,0.30000001
7096,Vado all'Arancio,A,Mid-Imperial Period,9,100,300,200,0.30000001
7097,Vado all'Arancio,A,Early Imperial Period,8,0,100,100,0.2
7098,Vado all'Arancio,A,Republican Period,7,-300,-30,270,0.80000001
7098,Vado all'Arancio,A,Early Imperial Period,8,-30,100,130,0.80000001
7098,Vado all'Arancio,A,Mid-Imperial Period,9,100,300,200,0.80000001
7098,Vado all'Arancio,A,Late Imperial Period,10,300,500,200,0.80000001
7099,Podere Sarcerini Nuovo,A,Republican Period,7,-300,-30,270,0.059999999
7100,Podere Sarcerini Nuovo,A,Republican Period,7,-300,-30,270,0.059999999
7101,Casa Valmora,A,Republican Period,7,-300,-30,270,0.059999999
7101,Casa Valmora,A,Early Imperial Period,8,-30,100,130,0.059999999
7101,Casa Valmora,A,Mid-Imperial Period,9,100,300,200,0.059999999
7101,Casa Valmora,A,Late Imperial Period,10,300,500,200,0.059999999
7102,Casa Valmora,A,Republican Period,7,-100,-30,70,0.60000002
7102,Casa Valmora,A,Early Imperial Period,8,-30,100,130,0.60000002
7102,Casa Valmora,A,Mid-Imperial Period,9,100,200,100,0.60000002
7103,Pero Castellaccio,A,Mid-Imperial Period,9,150,300,150,0.01
7104,Campo Ruffaldino,A,Early Imperial Period,8,-30,100,130,0.07
7105,Casa Campo Ruffaldino,A,Republican Period,7,-100,-30,70,0.1
7105,Casa Campo Ruffaldino,A,Early Imperial Period,8,-30,100,130,0.1
7106,Casa Campo Ruffaldino,A,Early Imperial Period,8,-30,100,130,0.059999999
7107,Casa Campo Ruffaldo,A,Early Imperial Period,8,-30,100,130,0.02
7108,Fattoria Marsiliana,A,Mid-Imperial Period,9,100,300,200,0.050000001
7108,Fattoria Marsiliana,A,Late Imperial Period,10,300,400,100,0.050000001
7109,Fattoria Marsiliana,A,Republican Period,7,-300,-30,270,0.02
7109,Fattoria Marsiliana,A,Early Imperial Period,8,-30,100,130,0.02
7109,Fattoria Marsiliana,A,Mid-Imperial Period,9,100,300,200,0.02
7109,Fattoria Marsiliana,A,Late Imperial Period,10,300,500,200,0.02
7110,Castello della Marsiliana,A,Republican Period,7,-200,-30,170,0.1
7110,Castello della Marsiliana,A,Early Imperial Period,8,-30,100,130,0.1
7111,Marsiliana,A,Republican Period,7,-100,-30,70,1
7111,Marsiliana,A,Early Imperial Period,8,-30,100,130,1
7112,Podere Sontrone,A,Early Bronze Age,1,-2300,-1700,600,0.01
7112,Podere Sontrone,A,Middle Bronze Age,2,-1700,-1300,400,0.01
7112,Podere Sontrone,A,Late Bronze Age,3,-1300,-1020,280,0.01
7112,Podere Sontrone,A,Early Iron Age,4,-1020,-1000,20,0.01
7113,Podere Miserone,A,Early Imperial Period,8,-30,100,130,0.01
7114,Massa Vecchia,A,Republican Period,7,-300,-30,270,1
7114,Massa Vecchia,A,Early Imperial Period,8,-30,100,130,1
7114,Massa Vecchia,A,Mid-Imperial Period,9,100,300,200,1
7114,Massa Vecchia,A,Late Imperial Period,10,300,500,200,1
7115,Vignale,A,Republican Period,7,-100,-30,70,4
7115,Vignale,A,Early Imperial Period,8,-30,100,130,4
7115,Vignale,A,Mid-Imperial Period,9,100,300,200,4
7115,Vignale,A,Late Imperial Period,10,300,500,200,4
7116,Il Pontone,A,Middle Bronze Age,2,-1400,-1300,100,3
7116,Il Pontone,A,Late Bronze Age,3,-1300,-1020,280,3
7116,Il Pontone,A,Early Iron Age,4,-1020,-1000,20,3
7117,Luni sul Mignone,A,Early Bronze Age,1,-2300,-1700,600,3
7117,Luni sul Mignone,A,Middle Bronze Age,2,-1700,-1300,400,6
7117,Luni sul Mignone,A,Late Bronze Age,3,-1300,-1020,280,6
7117,Luni sul Mignone,A,Early Iron Age,4,-1020,-750,270,6
7117,Luni sul Mignone,A,Late Iron Age,5,-750,-580,170,6
7117,Luni sul Mignone,A,Archaic Period,6,-580,-350,230,6
7117,Luni sul Mignone,A,Republican Period,7,-350,-200,150,6
7118,Rogge di Canino,A,Middle Bronze Age,2,-1700,-1500,200,4
7118,Rogge di Canino,B,Early Iron Age,4,-1000,-750,250,4
7118,Rogge di Canino,B,Late Iron Age,5,-750,-580,170,4
7118,Rogge di Canino,B,Archaic Period,6,-580,-350,230,4
7118,Rogge di Canino,B,Republican Period,7,-350,-30,320,4
7118,Rogge di Canino,B,Early Imperial Period,8,-30,100,130,4
7118,Rogge di Canino,B,Mid-Imperial Period,9,100,300,200,4
7118,Rogge di Canino,B,Late Imperial Period,10,300,500,200,4
7118,Rogge di Canino,B,Late Antique Period,11,500,800,300,4
7119,Monte S. Elia,A,Middle Bronze Age,2,-1700,-1500,200,1
7119,Monte S. Elia,B,Late Bronze Age,3,-1300,-1020,280,1
7119,Monte S. Elia,B,Early Iron Age,4,-1020,-1000,20,1
7120,Monte Fogliano,A,Late Bronze Age,3,-1300,-1020,280,1
7120,Monte Fogliano,A,Early Iron Age,4,-1020,-1000,20,1
7121,Cornossa,A,Late Bronze Age,3,-1200,-1020,180,0.30000001
7121,Cornossa,A,Early Iron Age,4,-1020,-800,220,0.30000001
7122,Casale Pacini,A,Late Bronze Age,3,-1100,-1020,80,0.2
7122,Casale Pacini,A,Early Iron Age,4,-1020,-750,270,0.2
7122,Casale Pacini,A,Late Iron Age,5,-750,-700,50,0.2
7123,Castello di Corneto,A,Middle Bronze Age,2,-1400,-1300,100,0.1
7123,Castello di Corneto,B,Late Bronze Age,3,-1200,-1020,180,0.1
7123,Castello di Corneto,B,Early Iron Age,4,-1020,-1000,20,0.1
7124,Fontanile delle Serpi,A,Late Bronze Age,3,-1100,-1020,80,0.2
7124,Fontanile delle Serpi,A,Early Iron Age,4,-1020,-800,220,0.2
7125,Montanara,A,Early Bronze Age,1,-2300,-1700,600,3
7125,Montanara,A,Middle Bronze Age,2,-1700,-1300,400,3
7125,Montanara,A,Late Bronze Age,3,-1300,-1020,280,3
7125,Montanara,A,Early Iron Age,4,-1020,-1000,20,3
7126,Castellina del Marangone,A,Middle Bronze Age,2,-1400,-1300,100,3
7126,Castellina del Marangone,A,Late Bronze Age,3,-1300,-1020,280,3
7126,Castellina del Marangone,A,Early Iron Age,4,-1020,-800,220,3
7127,Chiarone,A,Late Iron Age,5,-750,-580,170,0.01
7127,Chiarone,A,Archaic Period,6,-580,-550,30,0.01
7128,Lucca S. Concordio,A,Late Iron Age,5,-650,-580,70,0.1
7128,Lucca S. Concordio,A,Archaic Period,6,-580,-550,30,0.1
7129,Ponte del Tiglio,A,Late Iron Age,5,-600,-580,20,0.2
7129,Ponte del Tiglio,A,Archaic Period,6,-580,-400,180,0.2
7130,Antro della Paura di Gioviano,A,Archaic Period,6,-550,-500,50,0.1
7131,Romito di Pozzuolo,A,Archaic Period,6,-500,-450,50,0.01
7131,Romito di Pozzuolo,B,Republican Period,7,-300,-250,50,0.01
7132,Montecatino,A,Archaic Period,6,-500,-450,50,0.1
7133,Tempagnaro,A,Archaic Period,6,-500,-450,50,0.1
7134,Fossa Nera di Porcari,A,Republican Period,7,-150,-30,120,0.039999999
7135,Ponte del Tiglio podere 56,A,Archaic Period,6,-500,-400,100,0.01
7136,Ponte Gini,A,Archaic Period,6,-500,-400,100,0.01
7136,Ponte Gini,B,Republican Period,7,-350,-250,100,0.1
7137,Bottaccio di Bientina,A,Archaic Period,6,-500,-400,100,0.1
7138,Ponte a Moriano,A,Archaic Period,6,-500,-400,100,0.1
7139,Chiarone di Capannori,A,Archaic Period,6,-500,-400,100,0.01
7140,Monte del Pino,A,Republican Period,7,-300,-250,50,0.01
7141,Lucca,A,Republican Period,7,-180,-30,150,38
7141,Lucca,A,Early Imperial Period,8,-30,100,130,38
7141,Lucca,A,Mid-Imperial Period,9,100,300,200,38
7141,Lucca,A,Late Imperial Period,10,300,500,200,38
7142,Vetulonia,A,Early Iron Age,4,-900,-750,150,30
7142,Vetulonia,A,Late Iron Age,5,-750,-580,170,120
7142,Vetulonia,A,Archaic Period,6,-580,-350,230,120
7142,Vetulonia,A,Republican Period,7,-350,-30,320,120
7142,Vetulonia,A,Early Imperial Period,8,-30,100,130,120
7142,Vetulonia,A,Mid-Imperial Period,9,100,200,100,120
7143,Orvieto (Velzna),A,Early Iron Age,4,-900,-750,150,86.059288
7143,Orvieto (Velzna),A,Late Iron Age,5,-750,-580,170,86.059288
7143,Orvieto (Velzna),A,Archaic Period,6,-580,-350,230,86.059288
7143,Orvieto (Velzna),A,Republican Period,7,-350,-264,86,86.059288
7144,Monte Bisenzio (Visentium),A,Early Iron Age,4,-1000,-750,250,140.95039
7144,Monte Bisenzio (Visentium),A,Late Iron Age,5,-750,-580,170,140.95039
7144,Monte Bisenzio (Visentium),A,Archaic Period,6,-580,-350,230,140.95039
7144,Monte Bisenzio (Visentium),A,Republican Period,7,-350,-30,320,140.95039
7144,Monte Bisenzio (Visentium),A,Early Imperial Period,8,-30,100,130,140.95039
7144,Monte Bisenzio (Visentium),A,Mid-Imperial Period,9,100,300,200,140.95039
7144,Monte Bisenzio (Visentium),A,Late Imperial Period,10,300,400,100,140.95039
7145,Montalto di Castro (Vulci),A,Early Iron Age,4,-950,-750,200,120.76795
7145,Montalto di Castro (Vulci),A,Late Iron Age,5,-750,-580,170,120.76795
7145,Montalto di Castro (Vulci),A,Archaic Period,6,-580,-350,230,120.76795
7145,Montalto di Castro (Vulci),A,Republican Period,7,-350,-30,320,95.5242
7146,Tarquinia,A,Late Bronze Age,3,-1200,-1020,180,55.208397
7146,Tarquinia,A,Early Iron Age,4,-1020,-750,270,145.89955
7146,Tarquinia,A,Late Iron Age,5,-750,-580,170,145.89955
7146,Tarquinia,A,Archaic Period,6,-580,-350,230,145.89955
7146,Tarquinia,A,Republican Period,7,-350,-30,320,145.89955
7146,Tarquinia,A,Early Imperial Period,8,-30,100,130,145.89955
7146,Tarquinia,A,Mid-Imperial Period,9,100,300,200,145.89955
7146,Tarquinia,A,Late Imperial Period,10,300,500,200,145.89955
7147,Veio (Veii),A,Early Iron Age,4,-1000,-750,250,215.6069
7147,Veio (Veii),A,Late Iron Age,5,-750,-580,170,215.6069
7147,Veio (Veii),A,Archaic Period,6,-580,-350,230,29.330149
7147,Veio (Veii),A,Republican Period,7,-350,-30,320,29.330149
7147,Veio (Veii),A,Early Imperial Period,8,-30,100,130,29.330149
7147,Veio (Veii),A,Mid-Imperial Period,9,100,300,200,29.330149
7147,Veio (Veii),A,Late Imperial Period,10,300,450,150,29.330149
7148,Cori (Cora),A,Late Iron Age,5,-600,-580,20,13.791266
7148,Cori (Cora),A,Archaic Period,6,-580,-350,230,13.791252
7148,Cori (Cora),A,Republican Period,7,-350,-30,320,13.791252
7148,Cori (Cora),A,Early Imperial Period,8,-30,0,30,13.791252
7156,Rocca d'Arce,A,Early Iron Age,4,-1000,-750,250,0.1
7156,Rocca d'Arce,A,Late Iron Age,5,-750,-700,50,0.1
7164,Lo Schioppo,A,Middle Bronze Age,2,-1700,-1300,400,0.1
7174,Proprieta' d'Annibale,A,Early Iron Age,4,-1000,-750,250,0.1
7174,Proprieta' d'Annibale,A,Late Iron Age,5,-750,-700,50,0.1
7186,La Torre,A,Early Bronze Age,1,-2300,-1700,600,0.1
7186,La Torre,A,Middle Bronze Age,2,-1700,-1300,400,0.1
7186,La Torre,A,Late Bronze Age,3,-1300,-1020,280,0.1
7186,La Torre,B,Early Iron Age,4,-1020,-1000,20,0.1
7187,Grotticella di Monte Licino,A,Middle Bronze Age,2,-1700,-1300,400,0.1
7197,"Casale Bruciato, sito 45",A,Early Bronze Age,1,-2300,-1700,600,0.30000001
7197,"Casale Bruciato, sito 45",A,Middle Bronze Age,2,-1700,-1300,400,0.30000001
7197,"Casale Bruciato, sito 45",A,Late Bronze Age,3,-1300,-1020,280,0.30000001
7197,"Casale Bruciato, sito 45",A,Early Iron Age,4,-1020,-750,270,0.30000001
7197,"Casale Bruciato, sito 45",A,Late Iron Age,5,-750,-700,50,0.30000001
7199,Riserva del Cacciatore,A,Middle Bronze Age,2,-1700,-1300,400,0.2
7199,Riserva del Cacciatore,A,Late Bronze Age,3,-1300,-1020,280,0.2
7199,Riserva del Cacciatore,A,Early Iron Age,4,-1020,-1000,20,0.2
7199,Riserva del Cacciatore,B,Late Iron Age,5,-700,-580,120,0.2
7199,Riserva del Cacciatore,B,Archaic Period,6,-580,-350,230,0.2
7199,Riserva del Cacciatore,B,Republican Period,7,-350,-100,250,0.2
7205,"Roma, sito 47",A,Late Iron Age,5,-700,-600,100,0.1
7216,Colle del Quadri,A,Early Bronze Age,1,-2300,-1700,600,0.1
7216,Colle del Quadri,B,Middle Bronze Age,2,-1400,-1300,100,0.1
7224,Muratella Alta,A,Late Iron Age,5,-700,-600,100,0.1
7225,Pisciarello Vecchio,A,Late Iron Age,5,-700,-600,100,0.1
7229,Riserva dei Grottoni,A,Late Iron Age,5,-700,-600,100,0.1
7229,Riserva dei Grottoni,B,Republican Period,7,-300,-30,270,0.1
7229,Riserva dei Grottoni,B,Early Imperial Period,8,-30,100,130,0.1
7229,Riserva dei Grottoni,B,Mid-Imperial Period,9,100,300,200,0.1
7229,Riserva dei Grottoni,B,Late Imperial Period,10,300,500,200,0.1
7230,Riserva dell'Ara,A,Late Iron Age,5,-600,-580,20,0.1
7230,Riserva dell'Ara,A,Archaic Period,6,-580,-500,80,0.1
7230,Riserva dell'Ara,B,Republican Period,7,-300,-30,270,0.1
7230,Riserva dell'Ara,B,Early Imperial Period,8,-30,100,130,0.1
7230,Riserva dell'Ara,B,Mid-Imperial Period,9,100,300,200,0.1
7230,Riserva dell'Ara,B,Late Imperial Period,10,300,500,200,0.1
7233,Rocca Priora,A,Middle Bronze Age,2,-1700,-1300,400,0.1
7233,Rocca Priora,A,Late Bronze Age,3,-1300,-1020,280,0.1
7233,Rocca Priora,A,Early Iron Age,4,-1020,-1000,20,0.1
7233,Rocca Priora,B,Late Iron Age,5,-700,-600,100,0.1
7253,Luni Tre Erici,A,Early Bronze Age,1,-2300,-1700,600,0.001
7253,Luni Tre Erici,A,Middle Bronze Age,2,-1700,-1300,400,0.001
7253,Luni Tre Erici,A,Late Bronze Age,3,-1300,-1020,280,0.001
7253,Luni Tre Erici,A,Early Iron Age,4,-1020,-1000,20,0.001
7256,Monte Venere,A,Early Bronze Age,1,-2300,-1700,600,0.1
7256,Monte Venere,A,Middle Bronze Age,2,-1700,-1300,400,0.1
7256,Monte Venere,A,Late Bronze Age,3,-1300,-1020,280,0.1
7256,Monte Venere,A,Early Iron Age,4,-1020,-1000,20,0.1
7260,Crostoletto di Lamone,A,Middle Bronze Age,2,-1700,-1300,400,0.1
7260,Crostoletto di Lamone,B,Late Bronze Age,3,-1200,-1020,180,0.1
7260,Crostoletto di Lamone,B,Early Iron Age,4,-1020,-1000,20,0.1
7267,Chiusa Galantini,A,Early Bronze Age,1,-2300,-1700,600,0.1
7267,Chiusa Galantini,A,Middle Bronze Age,2,-1700,-1300,400,0.1
7267,Chiusa Galantini,A,Late Bronze Age,3,-1300,-1020,280,0.1
7267,Chiusa Galantini,A,Early Iron Age,4,-1020,-1000,20,0.1
7268,Fossatone,A,Early Bronze Age,1,-2300,-1700,600,0.1
7268,Fossatone,A,Middle Bronze Age,2,-1700,-1300,400,0.1
7268,Fossatone,A,Late Bronze Age,3,-1300,-1020,280,0.1
7268,Fossatone,A,Early Iron Age,4,-1020,-1000,20,0.1
7270,La Comunella,A,Early Bronze Age,1,-2300,-1700,600,0.1
7270,La Comunella,A,Middle Bronze Age,2,-1700,-1300,400,0.1
7270,La Comunella,A,Late Bronze Age,3,-1300,-1020,280,0.1
7270,La Comunella,A,Early Iron Age,4,-1020,-1000,20,0.1
7271,Le Vignacce,A,Early Bronze Age,1,-2300,-1700,600,0.1
7271,Le Vignacce,A,Middle Bronze Age,2,-1700,-1300,400,0.1
7271,Le Vignacce,A,Late Bronze Age,3,-1300,-1020,280,0.1
7271,Le Vignacce,A,Early Iron Age,4,-1020,-1000,20,0.1
7272,Mandria dell'Arsa,A,Early Bronze Age,1,-2300,-1700,600,0.1
7272,Mandria dell'Arsa,A,Middle Bronze Age,2,-1700,-1300,400,0.1
7272,Mandria dell'Arsa,A,Late Bronze Age,3,-1300,-1020,280,0.1
7272,Mandria dell'Arsa,A,Early Iron Age,4,-1020,-1000,20,0.1
7276,Mandra Grande,A,Early Bronze Age,1,-2300,-1700,600,0.1
7276,Mandra Grande,A,Middle Bronze Age,2,-1700,-1300,400,0.1
7276,Mandra Grande,A,Late Bronze Age,3,-1300,-1020,280,0.1
7276,Mandra Grande,A,Early Iron Age,4,-1020,-750,270,0.1
7276,Mandra Grande,A,Late Iron Age,5,-750,-700,50,0.1
7278,Ponte dell'Abbadia,A,Early Bronze Age,1,-2300,-1700,600,0.1
7278,Ponte dell'Abbadia,A,Middle Bronze Age,2,-1700,-1300,400,0.1
7278,Ponte dell'Abbadia,A,Late Bronze Age,3,-1300,-1020,280,0.1
7278,Ponte dell'Abbadia,A,Early Iron Age,4,-1020,-1000,20,0.1
7281,Piana di S. Pietro,A,Early Bronze Age,1,-2300,-1700,600,0.1
7281,Piana di S. Pietro,A,Middle Bronze Age,2,-1700,-1300,400,0.1
7281,Piana di S. Pietro,A,Late Bronze Age,3,-1300,-1020,280,0.1
7281,Piana di S. Pietro,A,Early Iron Age,4,-1020,-1000,20,0.1
7285,Neto Via Verga,A,Early Bronze Age,1,-2300,-1700,600,0.1
7285,Neto Via Verga,A,Middle Bronze Age,2,-1700,-1300,400,0.1
7285,Neto Via Verga,A,Late Bronze Age,3,-1300,-1020,280,0.1
7285,Neto Via Verga,A,Early Iron Age,4,-1020,-1000,20,0.1
7285,Neto Via Verga,B,Republican Period,7,-300,-30,270,0.1
7285,Neto Via Verga,B,Early Imperial Period,8,-30,100,130,0.1
7285,Neto Via Verga,B,Mid-Imperial Period,9,100,300,200,0.1
7285,Neto Via Verga,B,Late Imperial Period,10,300,500,200,0.1
7307,Riparo Santini,A,Early Bronze Age,1,-2300,-1700,600,0.1
7307,Riparo Santini,A,Middle Bronze Age,2,-1700,-1300,400,0.1
7307,Riparo Santini,A,Late Bronze Age,3,-1300,-1020,280,0.1
7307,Riparo Santini,A,Early Iron Age,4,-1020,-1000,20,0.1
7313,Muraccio,A,Early Bronze Age,1,-2300,-1700,600,0.1
7313,Muraccio,A,Middle Bronze Age,2,-1700,-1300,400,0.1
7313,Muraccio,A,Late Bronze Age,3,-1300,-1020,280,0.1
7313,Muraccio,A,Early Iron Age,4,-1020,-1000,20,0.1
7316,S. Rossore,A,Early Iron Age,4,-1000,-750,250,0.1
7316,S. Rossore,A,Late Iron Age,5,-750,-600,150,0.1
7384,,A,Early Imperial Period,8,-30,100,130,0.2
7384,,A,Mid-Imperial Period,9,100,300,200,0.2
7384,,A,Late Imperial Period,10,300,500,200,0.2
12341,,A,Early Imperial Period,8,-30,100,130,0.2
12341,,A,Mid-Imperial Period,9,100,300,200,0.2
12341,,A,Late Imperial Period,10,300,500,200,0.2
12351,,A,Republican Period,7,-200,-50,150,0.2
12361,,A,Republican Period,7,-200,-50,150,0.2
12362,,A,Mid-Imperial Period,9,200,300,100,0.40000001
12362,,A,Late Imperial Period,10,300,400,100,0.40000001
12371,,A,Republican Period,7,-100,-30,70,0.40000001
12381,Casabianca,A,Early Imperial Period,8,-30,100,130,0.30000001
12381,Casabianca,A,Mid-Imperial Period,9,100,300,200,0.30000001
12381,Casabianca,A,Late Imperial Period,10,300,500,200,0.30000001
12391,,A,Republican Period,7,-100,-30,70,0.60000002
12391,,A,Early Imperial Period,8,-30,100,130,0.60000002
12391,,A,Mid-Imperial Period,9,100,300,200,0.60000002
12391,,A,Late Imperial Period,10,300,500,200,0.60000002
12401,,A,Early Imperial Period,8,-30,100,130,0.40000001
12401,,A,Mid-Imperial Period,9,100,300,200,0.40000001
12401,,A,Late Imperial Period,10,300,500,200,0.40000001
12411,,A,Early Imperial Period,8,-30,100,130,0.5
12411,,A,Mid-Imperial Period,9,100,300,200,0.5
12411,,A,Late Imperial Period,10,300,500,200,0.5
13031,,A,Republican Period,7,-200,-30,170,0.30000001
13031,,A,Early Imperial Period,8,-30,100,130,0.30000001
13601,,A,Republican Period,7,-200,-50,150,0.5
14741,Vigna Ferri,A,Early Imperial Period,8,-30,100,130,0.80000001
14741,Vigna Ferri,A,Mid-Imperial Period,9,100,300,200,0.80000001
14801,Vigna Ferri,A,Republican Period,7,-50,-30,20,0.5
14801,Vigna Ferri,A,Early Imperial Period,8,-30,100,130,0.5
14801,Vigna Ferri,A,Mid-Imperial Period,9,100,200,100,0.5
15791,,A,Archaic Period,6,-500,-350,150,0.2
15791,,A,Republican Period,7,-350,-30,320,0.2
15791,,A,Early Imperial Period,8,-30,100,130,0.2
15791,,A,Mid-Imperial Period,9,100,300,200,0.2
15791,,A,Late Imperial Period,10,300,500,200,0.2
16351,,A,Archaic Period,6,-500,-350,150,0.60000002
16351,,A,Republican Period,7,-350,-30,320,0.60000002
16351,,A,Early Imperial Period,8,-30,100,130,0.60000002
16351,,A,Mid-Imperial Period,9,100,300,200,0.60000002
16351,,A,Late Imperial Period,10,300,500,200,0.60000002
17331,,A,Republican Period,7,-200,-30,170,1
17331,,A,Early Imperial Period,8,-30,100,130,1
17331,,A,Mid-Imperial Period,9,100,200,100,1
19661,,A,Republican Period,7,-50,-30,20,0.050000001
19661,,A,Early Imperial Period,8,-30,100,130,0.050000001
123301,,A,Early Imperial Period,8,-30,100,130,0.40000001
123301,,A,Mid-Imperial Period,9,100,300,200,0.40000001
123301,,A,Late Imperial Period,10,300,500,200,0.40000001
149601,Frascati (villa),A,Republican Period,7,-100,-30,70,3.5
149601,Frascati (villa),A,Early Imperial Period,8,-30,50,80,3.5
173701,,A,Republican Period,7,-200,-30,170,0.30000001
173701,,A,Early Imperial Period,8,-30,100,130,0.30000001
193001,S. Antonio,A,Archaic Period,6,-500,-350,150,0.1
193001,S. Antonio,A,Republican Period,7,-350,-30,320,0.1
200001,,A,Archaic Period,6,-500,-350,150,0.1
200001,,A,Republican Period,7,-350,-30,320,0.1
318001,,A,Republican Period,7,-350,-30,320,0.1
339001,La Ragugna,A,Republican Period,7,-350,-30,320,0.1
342001,La Faggeta 2,A,Republican Period,7,-350,-30,320,0.1
356001,Monte Nero,A,Republican Period,7,-350,-30,320,0.1
356001,Monte Nero,A,Early Imperial Period,8,-30,100,130,0.1
356001,Monte Nero,A,Mid-Imperial Period,9,100,300,200,0.1
356001,Monte Nero,A,Late Imperial Period,10,300,500,200,0.1
