Site Occupation Location,SubOc1,New Comp,Period,Period No.,Period Start,Period End,Estimated Span,Area (ha),Population
1,A,,TF,4,-100,200,300,14.6,730
1,A,,EC,5,200,300,100,16.7,835
1,A,,MC,6,300,450,150,16.7,835
1,A,,LC,7,450,600,150,11.3,565
1,A,,Epi,8,600,850,250,0.3,15
1,A,,EPC,9,850,1150,300,0.1,5
2,A,,EC,5,200,300,100,0.2,10
2,A,,MC,6,300,450,150,0.2,10
3,A,,EC,5,200,300,100,0.2,10
3,A,,MC,6,300,450,150,0.2,10
3,A,,LC,7,450,600,150,0.2,10
3,B,,A,11,1300,1440,140,1.5,75
3,B,,M,12,1440,1520,80,1.5,75
4,A,,EC,5,200,300,100,0.1,5
4,A,,MC,6,300,450,150,0.1,5
4,A,,LC,7,450,600,150,0.1,5
5,A,,TF,4,-100,200,300,0.1,5
5,A,,EC,5,200,300,100,0.1,5
5,B,,LC,7,450,600,150,0.1,5
7,A,,EC,5,200,300,100,1,50
7,A,,MC,6,300,450,150,1,50
7,A,,LC,7,450,600,150,1,50
8,A,,TF,4,-100,200,300,0.9,45
8,A,,EC,5,200,300,100,1.2,60
8,A,,MC,6,300,450,150,0.6,30
8,A,,LC,7,450,600,150,0.3,15
9,A,,TF,4,-100,200,300,0.8,40
9,A,,EC,5,200,300,100,0.8,40
9,A,,MC,6,300,450,150,0.8,40
9,A,,LC,7,450,600,150,0.8,40
10,A,,LC,7,450,600,150,0.1,5
11,A,,MF,2,-1100,-500,600,0.1,5
11,A,,LF,3,-500,-100,400,0.1,5
11,A,,TF,4,-100,200,300,2.1,105
11,A,,EC,5,200,300,100,2.1,105
11,A,,MC,6,300,450,150,2.1,105
11,A,,LC,7,450,600,150,2.1,105
11,A,,Epi,8,600,850,250,2,100
11,A,,EPC,9,850,1150,300,0.1,5
12,A,,LF,3,-500,-100,400,0.1,5
12,A,,TF,4,-100,200,300,8.3,415
12,A,,EC,5,200,300,100,14.6,730
12,A,,MC,6,300,450,150,14.6,730
12,A,,LC,7,450,600,150,6.5,325
12,A,,Epi,8,600,850,250,0.4,20
12,A,,EPC,9,850,1150,300,0.4,20
14,A,,EC,5,200,300,100,0.3,15
14,A,,MC,6,300,450,150,0.3,15
14,A,,LC,7,450,600,150,0.1,5
14,A,799,Epi,8,600,850,250,0.9,45
16,A,,EC,5,200,300,100,0.2,10
16,A,,MC,6,300,450,150,0.2,10
16,B,,P,10,1150,1300,150,0.1,5
16,C,,M,12,1440,1520,80,0.3,15
18,A,,EPC,9,850,1150,300,0.2,10
19,A,,EC,5,200,300,100,0.1,5
19,A,,MC,6,300,450,150,0.1,5
19,A,,LC,7,450,600,150,0.2,10
19,B,,EPC,9,850,1150,300,0.1,5
19,C,,A,11,1300,1440,140,0.2,10
19,C,,M,12,1440,1520,80,0.2,10
21,A,,TF,4,-100,200,300,0.6,30
21,A,,EC,5,200,300,100,0.6,30
21,A,,MC,6,300,450,150,0.6,30
21,A,,LC,7,450,600,150,0.3,15
21,B,,EPC,9,850,1150,300,0.1,5
22,A,,LF,3,-500,-100,400,0.1,5
23,A,,MF,2,-1100,-500,600,1.3,65
23,A,,LF,3,-500,-100,400,1.3,65
23,A,,TF,4,-100,200,300,3.1,155
23,A,,EC,5,200,300,100,3.1,155
23,A,,MC,6,300,450,150,3.1,155
23,B,,Epi,8,600,850,250,1.3,65
23,B,,EPC,9,850,1150,300,3.3,165
23,C,,M,12,1440,1520,80,1.7,85
24,A,,LF,3,-500,-100,400,0.1,5
24,A,,TF,4,-100,200,300,0.3,15
24,A,,EC,5,200,300,100,0.3,15
24,A,,MC,6,300,450,150,0.3,15
24,A,,LC,7,450,600,150,0.2,10
24,B,,EPC,9,850,1150,300,0.2,10
25,A,,MF,2,-1100,-500,600,0.8,40
25,A,,LF,3,-500,-100,400,0.7,35
25,A,,TF,4,-100,200,300,2.1,105
25,A,,EC,5,200,300,100,2.2,110
25,A,,MC,6,300,450,150,2.2,110
25,B,,Epi,8,600,850,250,1.3,65
25,B,,EPC,9,850,1150,300,2.2,110
25,C,,A,11,1300,1440,140,0.3,15
25,C,,M,12,1440,1520,80,0.3,15
26,A,,LF,3,-500,-100,400,1.8,90
26,A,,TF,4,-100,200,300,1.3,65
26,A,,EC,5,200,300,100,2.7,135
26,A,,MC,6,300,450,150,2.7,135
26,B,,Epi,8,600,850,250,2.8,140
26,B,,EPC,9,850,1150,300,1.4,70
27,A,,MF,2,-1100,-500,600,1.1,55
28,A,,MF,2,-1100,-500,600,0.9,45
28,A,,LF,3,-500,-100,400,0.9,45
28,A,,TF,4,-100,200,300,0.8,40
28,A,,EC,5,200,300,100,0.8,40
28,A,,MC,6,300,450,150,0.8,40
28,A,,LC,7,450,600,150,0.6,30
29,A,,MF,2,-1100,-500,600,0.9,45
29,A,,LF,3,-500,-100,400,0.9,45
29,A,,TF,4,-100,200,300,0.9,45
29,A,,EC,5,200,300,100,0.9,45
29,B,,LC,7,450,600,150,0.9,45
30,A,,EPC,9,850,1150,300,0.8,40
31,A,,EPC,9,850,1150,300,0.7,35
32,A,,EPC,9,850,1150,300,0.4,20
33,A,,TF,4,-100,200,300,5.8,290
33,A,,EC,5,200,300,100,5.8,290
33,A,,MC,6,300,450,150,5.8,290
34,A,,EC,5,200,300,100,1.1,55
34,A,,MC,6,300,450,150,1.1,55
35,A,,TF,4,-100,200,300,0.5,25
35,A,,EC,5,200,300,100,0.7,35
35,A,,MC,6,300,450,150,0.7,35
36,A,,EPC,9,850,1150,300,0.1,5
37,A,,EC,5,200,300,100,4.9,245
37,A,,MC,6,300,450,150,4.9,245
38,A,,TF,4,-100,200,300,1,50
38,A,,EC,5,200,300,100,1,50
38,A,,MC,6,300,450,150,1,50
38,A,,LC,7,450,600,150,0.1,5
39,A,,TF,4,-100,200,300,0.3,15
39,A,,EC,5,200,300,100,0.3,15
39,A,,MC,6,300,450,150,0.3,15
39,A,,LC,7,450,600,150,0.3,15
40,A,,TF,4,-100,200,300,0.3,15
40,A,,EC,5,200,300,100,0.3,15
40,A,,MC,6,300,450,150,0.3,15
40,B,,Epi,8,600,850,250,0.3,15
40,B,,EPC,9,850,1150,300,0.3,15
41,A,,EF,1,-1500,-1100,400,0.2,10
41,A,,MF,2,-1100,-500,600,0.2,10
41,A,,LF,3,-500,-100,400,0.8,40
41,A,507,TF,4,-100,200,300,6.2,310
41,A,510,TF,4,-100,200,300,2.3,115
41,A,,TF,4,-100,200,300,0.2,10
41,A,507,EC,5,200,300,100,6.5,325
41,A,510,EC,5,200,300,100,2.3,115
41,A,,EC,5,200,300,100,0.2,10
41,A,507,MC,6,300,450,150,6.5,325
41,A,510,MC,6,300,450,150,2.3,115
41,A,,MC,6,300,450,150,0.2,10
41,A,507,LC,7,450,600,150,2.4,120
41,A,510,LC,7,450,600,150,1.7,85
41,A,,LC,7,450,600,150,0.1,5
41,A,579,Epi,8,600,850,250,7.1,355
41,A,582,Epi,8,600,850,250,2,100
41,A,580,EPC,9,850,1150,300,8,400
41,A,581,EPC,9,850,1150,300,3.1,155
41,A,,EPC,9,850,1150,300,6.4,320
41,A,506,P,10,1150,1300,150,5.7,285
41,A,,P,10,1150,1300,150,2.8,140
41,A,583,A,11,1300,1440,140,18.4,920
41,A,584,A,11,1300,1440,140,1.1,55
41,A,595,M,12,1440,1520,80,66.9,3345
42,A,,EC,5,200,300,100,5.6,280
42,A,,MC,6,300,450,150,5.6,280
42,A,,LC,7,450,600,150,5.6,280
42,A,,Epi,8,600,850,250,6.3,315
42,A,,EPC,9,850,1150,300,0.6,30
43,A,,MF,2,-1100,-500,600,0.4,20
43,A,,LF,3,-500,-100,400,0.4,20
44,A,,MF,2,-1100,-500,600,0.2,10
44,A,,LF,3,-500,-100,400,0.2,10
44,B,,P,10,1150,1300,150,0.2,10
45,A,,EC,5,200,300,100,0.1,5
45,A,,MC,6,300,450,150,0.1,5
45,A,,LC,7,450,600,150,0.1,5
45,B,,M,12,1440,1520,80,0.1,5
47,A,,TF,4,-100,200,300,0.2,10
47,A,,EC,5,200,300,100,0.2,10
47,A,,MC,6,300,450,150,0.2,10
48,A,,MF,2,-1100,-500,600,0.1,5
48,A,,LF,3,-500,-100,400,0.1,5
49,A,,MF,2,-1100,-500,600,0.5,25
49,B,,TF,4,-100,200,300,0.5,25
49,B,,EC,5,200,300,100,0.5,25
49,B,,MC,6,300,450,150,0.5,25
49,B,,LC,7,450,600,150,0.4,20
50,A,,TF,4,-100,200,300,0.6,30
50,A,,EC,5,200,300,100,0.6,30
50,A,,MC,6,300,450,150,0.6,30
50,A,,LC,7,450,600,150,0.4,20
50,A,,Epi,8,600,850,250,0.3,15
50,A,,EPC,9,850,1150,300,0.6,30
50,A,,P,10,1150,1300,150,0.1,5
51,A,,EC,5,200,300,100,0.3,15
51,A,,MC,6,300,450,150,0.3,15
51,A,,LC,7,450,600,150,0.3,15
51,A,,Epi,8,600,850,250,0.3,15
51,A,,EPC,9,850,1150,300,0.1,5
52,A,,TF,4,-100,200,300,0.1,5
52,A,,EC,5,200,300,100,0.1,5
52,A,,MC,6,300,450,150,0.1,5
52,B,,Epi,8,600,850,250,0.3,15
52,B,,EPC,9,850,1150,300,0.3,15
53,A,,Epi,8,600,850,250,0.7,35
53,A,,EPC,9,850,1150,300,0.7,35
53,A,,P,10,1150,1300,150,0.3,15
54,A,,EC,5,200,300,100,0.3,15
54,A,,MC,6,300,450,150,0.3,15
54,B,,Epi,8,600,850,250,0.3,15
54,B,,EPC,9,850,1150,300,0.3,15
55,A,,EPC,9,850,1150,300,0.1,5
56,A,,TF,4,-100,200,300,0.2,10
56,A,,EC,5,200,300,100,0.2,10
56,A,,MC,6,300,450,150,0.2,10
56,A,,LC,7,450,600,150,0.2,10
56,B,,EPC,9,850,1150,300,0.3,15
57,A,,EPC,9,850,1150,300,0.5,25
58,A,,MF,2,-1100,-500,600,0.6,30
58,A,,LF,3,-500,-100,400,0.6,30
58,B,,EC,5,200,300,100,0.4,20
58,B,,MC,6,300,450,150,0.4,20
58,B,,LC,7,450,600,150,0.4,20
58,B,,Epi,8,600,850,250,0.5,25
58,B,,EPC,9,850,1150,300,1.1,55
59,A,,EPC,9,850,1150,300,0.1,5
59,A,,P,10,1150,1300,150,0.1,5
59,A,,A,11,1300,1440,140,0.3,15
59,A,,M,12,1440,1520,80,0.3,15
61,A,,TF,4,-100,200,300,0.6,30
61,A,,EC,5,200,300,100,0.6,30
61,A,,MC,6,300,450,150,0.6,30
62,A,,M,12,1440,1520,80,0.5,25
63,A,,TF,4,-100,200,300,1,50
63,A,,EC,5,200,300,100,1,50
63,A,,MC,6,300,450,150,1,50
63,A,,LC,7,450,600,150,1,50
63,B,,M,12,1440,1520,80,1,50
64,A,,TF,4,-100,200,300,0.1,5
64,A,,EC,5,200,300,100,0.1,5
64,A,,MC,6,300,450,150,0.1,5
64,A,,LC,7,450,600,150,0.1,5
64,B,,M,12,1440,1520,80,0.1,5
65,A,,TF,4,-100,200,300,0.1,5
65,A,,EC,5,200,300,100,0.1,5
65,A,,MC,6,300,450,150,0.1,5
65,A,,LC,7,450,600,150,0.1,5
67,A,,LF,3,-500,-100,400,0.3,15
68,A,,LF,3,-500,-100,400,0.3,15
68,B,,EC,5,200,300,100,0.1,5
68,B,,MC,6,300,450,150,0.1,5
70,A,,A,11,1300,1440,140,0.3,15
70,A,,M,12,1440,1520,80,0.3,15
71,A,,Epi,8,600,850,250,1,50
71,B,,A,11,1300,1440,140,1,50
71,B,,M,12,1440,1520,80,1,50
73,A,,TF,4,-100,200,300,0.1,5
73,A,,EC,5,200,300,100,0.1,5
73,A,,MC,6,300,450,150,0.1,5
73,A,,LC,7,450,600,150,0.1,5
74,A,,TF,4,-100,200,300,0.1,5
74,A,,EC,5,200,300,100,0.1,5
74,A,,MC,6,300,450,150,0.1,5
74,A,,LC,7,450,600,150,0.1,5
75,A,,EC,5,200,300,100,0.1,5
75,A,,MC,6,300,450,150,0.1,5
75,A,,LC,7,450,600,150,0.1,5
76,A,,TF,4,-100,200,300,0.3,15
76,A,,EC,5,200,300,100,0.3,15
76,A,,MC,6,300,450,150,0.3,15
76,A,,LC,7,450,600,150,0.3,15
77,A,,TF,4,-100,200,300,0.3,15
77,A,,EC,5,200,300,100,0.7,35
77,A,,MC,6,300,450,150,0.7,35
77,A,,LC,7,450,600,150,0.3,15
77,B,,EPC,9,850,1150,300,0.3,15
77,C,,M,12,1440,1520,80,0.7,35
78,A,,EPC,9,850,1150,300,0.3,15
78,A,,P,10,1150,1300,150,0.4,20
78,A,,A,11,1300,1440,140,0.4,20
78,A,,M,12,1440,1520,80,0.4,20
80,A,,MF,2,-1100,-500,600,0.1,5
80,A,,LF,3,-500,-100,400,0.1,5
80,B,,EPC,9,850,1150,300,1,50
81,A,,A,11,1300,1440,140,0.4,20
81,A,,M,12,1440,1520,80,0.4,20
82,A,,A,11,1300,1440,140,0.1,5
83,A,,M,12,1440,1520,80,0.1,5
84,A,,TF,4,-100,200,300,0.1,5
84,A,,EC,5,200,300,100,0.1,5
84,A,,MC,6,300,450,150,0.1,5
84,B,,EPC,9,850,1150,300,0.1,5
85,A,,LF,3,-500,-100,400,0.1,5
85,A,,TF,4,-100,200,300,0.1,5
85,A,,EC,5,200,300,100,0.1,5
85,A,,MC,6,300,450,150,0.1,5
85,A,,LC,7,450,600,150,0.1,5
85,A,,Epi,8,600,850,250,0.1,5
86,A,,EC,5,200,300,100,0.4,20
86,B,,Epi,8,600,850,250,0.4,20
86,B,,EPC,9,850,1150,300,0.7,35
86,C,,A,11,1300,1440,140,0.4,20
86,C,,M,12,1440,1520,80,0.7,35
87,A,,LF,3,-500,-100,400,0.1,5
87,B,,EC,5,200,300,100,0.2,10
87,B,,MC,6,300,450,150,0.2,10
87,B,,LC,7,450,600,150,0.2,10
88,A,,TF,4,-100,200,300,0.1,5
88,A,,EC,5,200,300,100,0.1,5
88,A,,MC,6,300,450,150,0.1,5
88,A,,LC,7,450,600,150,0.1,5
89,A,,TF,4,-100,200,300,0.2,10
89,A,,EC,5,200,300,100,0.2,10
89,A,,MC,6,300,450,150,0.2,10
89,B,,EPC,9,850,1150,300,0.1,5
89,B,,P,10,1150,1300,150,0.2,10
90,A,,A,11,1300,1440,140,0.1,5
91,A,,EPC,9,850,1150,300,0.1,5
91,B,,M,12,1440,1520,80,0.1,5
92,A,,EC,5,200,300,100,0.2,10
92,A,,MC,6,300,450,150,0.2,10
92,B,,P,10,1150,1300,150,0.2,10
93,A,,TF,4,-100,200,300,0.1,5
93,A,,EC,5,200,300,100,0.1,5
93,A,,MC,6,300,450,150,0.1,5
93,A,,LC,7,450,600,150,0.1,5
93,B,,P,10,1150,1300,150,0.1,5
94,A,,EC,5,200,300,100,0.1,5
94,A,,MC,6,300,450,150,0.1,5
95,A,,TF,4,-100,200,300,0.4,20
95,A,,EC,5,200,300,100,0.4,20
95,A,,MC,6,300,450,150,0.4,20
95,A,,LC,7,450,600,150,0.2,10
95,B,,EPC,9,850,1150,300,0.2,10
95,C,,M,12,1440,1520,80,0.4,20
96,A,,TF,4,-100,200,300,0.1,5
96,A,,EC,5,200,300,100,0.2,10
96,A,,MC,6,300,450,150,0.2,10
96,A,,LC,7,450,600,150,0.1,5
96,B,,EPC,9,850,1150,300,0.1,5
97,A,,TF,4,-100,200,300,0.2,10
97,A,,EC,5,200,300,100,0.2,10
97,A,,MC,6,300,450,150,0.2,10
97,A,,LC,7,450,600,150,0.1,5
98,A,,A/M,12,1300,1520,220,0,5
99,A,,EF,1,-1500,-1100,400,0.3,15
99,A,,MF,2,-1100,-500,600,0.8,40
99,A,,LF,3,-500,-100,400,1.5,75
99,A,,TF,4,-100,200,300,16.6,830
99,A,,EC,5,200,300,100,23.8,1190
99,A,,MC,6,300,450,150,22,1100
99,A,,LC,7,450,600,150,16.8,840
100,A,,TF,4,-100,200,300,0.3,15
100,A,,EC,5,200,300,100,0.3,15
100,A,,MC,6,300,450,150,0.3,15
100,B,,P,10,1150,1300,150,0.3,15
101,A,,TF,4,-100,200,300,0.9,45
101,A,,EC,5,200,300,100,0.9,45
101,A,,MC,6,300,450,150,0.9,45
101,A,,LC,7,450,600,150,0.9,45
102,A,,MF,2,-1100,-500,600,0.2,10
102,A,,LF,3,-500,-100,400,1.6,80
102,B,,EC,5,200,300,100,0.1,5
102,B,,MC,6,300,450,150,0.1,5
103,A,,MF,2,-1100,-500,600,0.7,35
103,A,,LF,3,-500,-100,400,2.8,140
103,A,,TF,4,-100,200,300,0.5,25
103,A,,EC,5,200,300,100,2.5,125
103,A,,MC,6,300,450,150,2.5,125
103,A,,LC,7,450,600,150,0.5,25
103,A,,Epi,8,600,850,250,0,0
103,A,,EPC,9,850,1150,300,0.7,35
104,A,,TF,4,-100,200,300,0.5,25
104,A,,EC,5,200,300,100,0.5,25
104,A,,MC,6,300,450,150,0.5,25
104,A,,LC,7,450,600,150,0.5,25
104,A,,Epi,8,600,850,250,0.4,20
104,A,,EPC,9,850,1150,300,0.4,20
105,A,,TF,4,-100,200,300,0.1,5
105,A,,EC,5,200,300,100,0.1,5
105,A,,MC,6,300,450,150,0.1,5
105,A,,LC,7,450,600,150,0.1,5
106,A,,LF,3,-500,-100,400,0.2,10
106,A,,TF,4,-100,200,300,0.5,25
106,A,,EC,5,200,300,100,0.5,25
106,A,,MC,6,300,450,150,0.5,25
106,A,,LC,7,450,600,150,0.5,25
106,B,,EPC,9,850,1150,300,0.3,15
106,C,,M,12,1440,1520,80,0.3,15
107,A,,EC,5,200,300,100,1.8,90
107,A,,MC,6,300,450,150,1.8,90
107,A,,LC,7,450,600,150,1.8,90
107,B,714,P,10,1150,1300,150,0.8,40
107,B,,P,10,1150,1300,150,0.9,45
107,B,713,A,11,1300,1440,140,0.6,30
107,B,,A,11,1300,1440,140,8.5,425
107,B,712,M,12,1440,1520,80,0.6,30
107,B,,M,12,1440,1520,80,11.4,570
108,A,,EC,5,200,300,100,2.6,130
108,A,,MC,6,300,450,150,2.6,130
108,A,,LC,7,450,600,150,2.6,130
108,B,,A,11,1300,1440,140,28.3,1415
108,B,,M,12,1440,1520,80,28.3,1415
109,A,,A/M,12,1300,1520,220,0.1,5
110,A,,A,11,1300,1440,140,0.1,5
110,A,,M,12,1440,1520,80,0.1,5
111,A,,A,11,1300,1440,140,0.1,5
111,A,,M,12,1440,1520,80,0.1,5
112,A,,EC,5,200,300,100,0.3,15
112,A,,MC,6,300,450,150,0.3,15
112,B,,EPC,9,850,1150,300,0.3,15
112,C,,A,11,1300,1440,140,0.5,25
112,C,,M,12,1440,1520,80,0.7,35
113,A,,Epi,8,600,850,250,0.9,45
113,B,,P,10,1150,1300,150,0.5,25
114,A,,P,10,1150,1300,150,0.1,5
115,A,,EC,5,200,300,100,0.1,5
115,A,,MC,6,300,450,150,0.1,5
115,A,,LC,7,450,600,150,0.1,5
115,B,,P,10,1150,1300,150,0.1,5
116,A,,EC,5,200,300,100,0.1,5
116,A,,MC,6,300,450,150,0.1,5
116,A,,LC,7,450,600,150,0.1,5
117,A,,TF,4,-100,200,300,0.1,5
117,A,,EC,5,200,300,100,0.1,5
117,A,,MC,6,300,450,150,0.1,5
118,A,,EF,1,-1500,-1100,400,0.1,5
118,B,,LF,3,-500,-100,400,0.1,5
118,C,,EC,5,200,300,100,0.9,45
118,C,,MC,6,300,450,150,0.9,45
118,C,,LC,7,450,600,150,0.1,5
118,C,,Epi,8,600,850,250,0,0
118,D,,P,10,1150,1300,150,0.3,15
118,D,,A,11,1300,1440,140,0.8,40
118,D,,M,12,1440,1520,80,0.8,40
119,A,,P,10,1150,1300,150,0.1,5
119,A,,A,11,1300,1440,140,0.2,10
119,A,,M,12,1440,1520,80,0.2,10
120,A,,A,11,1300,1440,140,0.7,35
120,A,,M,12,1440,1520,80,1,50
121,A,,A,11,1300,1440,140,0.3,15
121,A,,M,12,1440,1520,80,0.5,25
122,A,,EPC,9,850,1150,300,0.5,25
122,A,,P,10,1150,1300,150,0.5,25
122,A,,A,11,1300,1440,140,0.5,25
122,A,,M,12,1440,1520,80,0.5,25
123,A,,TF,4,-100,200,300,0.1,5
123,A,,EC,5,200,300,100,0.1,5
123,A,,MC,6,300,450,150,0.1,5
123,A,,LC,7,450,600,150,0.1,5
123,B,,A,11,1300,1440,140,0.4,20
123,B,,M,12,1440,1520,80,0.4,20
124,A,,Epi,8,600,850,250,0.2,10
124,A,,EPC,9,850,1150,300,0.2,10
124,A,,P,10,1150,1300,150,0.2,10
124,A,,A,11,1300,1440,140,0.3,15
124,A,,M,12,1440,1520,80,0.3,15
125,A,,EC,5,200,300,100,0.1,5
125,B,,Epi,8,600,850,250,0.1,5
125,B,,EPC,9,850,1150,300,0.1,5
126,A,,MF,2,-1100,-500,600,4.4,220
126,A,,LF,3,-500,-100,400,34,1700
126,A,900,TF,4,-100,200,300,2.9,145
126,A,,TF,4,-100,200,300,19.7,985
126,A,,EC,5,200,300,100,54.7,2735
126,A,,MC,6,300,450,150,48.9,2445
126,A,901,LC,7,450,600,150,0.9,45
126,A,902,LC,7,450,600,150,1,50
126,A,903,LC,7,450,600,150,1.2,60
126,A,,LC,7,450,600,150,5.5,275
126,A,598,Epi,8,600,850,250,3.2,160
126,A,599,Epi,8,600,850,250,1.1,55
126,A,700,Epi,8,600,850,250,4.8,240
126,A,,Epi,8,600,850,250,34,1700
126,A,,EPC,9,850,1150,300,54.7,2735
126,A,701,P,10,1150,1300,150,2.8,140
126,A,702,P,10,1150,1300,150,0.6,30
126,A,703,P,10,1150,1300,150,8.6,430
126,A,,P,10,1150,1300,150,0.3,15
126,A,704,A,11,1300,1440,140,32.2,1610
126,A,,A,11,1300,1440,140,0.3,15
126,A,502,M,12,1440,1520,80,3.5,175
126,A,,M,12,1440,1520,80,24.8,1240
127,A,700,Epi,8,600,850,250,4.8,240
127,A,,Epi,8,600,850,250,0.3,15
127,A,,EPC,9,850,1150,300,0.7,35
127,A,,P,10,1150,1300,150,0.3,15
127,A,,A,11,1300,1440,140,0.5,25
127,A,,M,12,1440,1520,80,0.3,15
128,A,,LF,3,-500,-100,400,0.2,10
128,B,,EC,5,200,300,100,0.3,15
128,B,,MC,6,300,450,150,0.3,15
128,C,,Epi,8,600,850,250,0.2,10
128,C,,EPC,9,850,1150,300,0.3,15
128,D,,A,11,1300,1440,140,0.3,15
128,D,,M,12,1440,1520,80,0.3,15
129,A,,MF,2,-1100,-500,600,0.4,20
129,A,,LF,3,-500,-100,400,2.3,115
129,A,,TF,4,-100,200,300,1.9,95
129,A,,EC,5,200,300,100,4.4,220
129,A,,MC,6,300,450,150,4.4,220
129,A,,LC,7,450,600,150,0.8,40
130,A,,LF,3,-500,-100,400,0.1,5
130,A,,TF,4,-100,200,300,0.1,5
130,A,,EC,5,200,300,100,0.1,5
131,A,,TF,4,-100,200,300,0.1,5
131,A,,EC,5,200,300,100,0.1,5
131,A,,MC,6,300,450,150,0.1,5
131,B,,Epi,8,600,850,250,0.1,5
131,C,,M,12,1440,1520,80,0.1,5
132,A,,EC,5,200,300,100,0.1,5
132,A,,MC,6,300,450,150,0.1,5
132,B,,Epi,8,600,850,250,0.1,5
132,B,,EPC,9,850,1150,300,0.1,5
133,A,,MF,2,-1100,-500,600,0.2,10
133,A,,LF,3,-500,-100,400,2.4,120
133,A,,TF,4,-100,200,300,1.5,75
133,A,,EC,5,200,300,100,1.7,85
133,A,,MC,6,300,450,150,1.7,85
133,A,,LC,7,450,600,150,0.8,40
133,A,723,Epi,8,600,850,250,2.6,130
133,A,,Epi,8,600,850,250,0.3,15
133,A,,EPC,9,850,1150,300,0.3,15
133,A,,P,10,1150,1300,150,0.3,15
133,A,,A,11,1300,1440,140,8.8,440
133,A,,M,12,1440,1520,80,9,450
134,A,,M,12,1440,1520,80,0.6,30
135,A,,TF,4,-100,200,300,0.1,5
135,A,,EC,5,200,300,100,0.1,5
135,A,,MC,6,300,450,150,0.1,5
135,A,,LC,7,450,600,150,0.1,5
136,A,,P,10,1150,1300,150,0.1,5
136,B,,M,12,1440,1520,80,0.1,5
137,A,,EPC,9,850,1150,300,0.2,10
137,B,,A,11,1300,1440,140,0.2,10
138,A,,TF,4,-100,200,300,0.1,5
138,A,,EC,5,200,300,100,0.2,10
138,A,,MC,6,300,450,150,0.2,10
138,A,,LC,7,450,600,150,0.2,10
138,B,,A,11,1300,1440,140,0.2,10
139,A,,MF,2,-1100,-500,600,2.1,105
139,A,,LF,3,-500,-100,400,2.9,145
139,A,,TF,4,-100,200,300,4.6,230
139,A,,EC,5,200,300,100,5.5,275
139,A,,MC,6,300,450,150,5.5,275
139,A,,LC,7,450,600,150,2.1,105
139,B,,EPC,9,850,1150,300,0.3,15
139,C,,M,12,1440,1520,80,3.7,185
140,A,,MF,2,-1100,-500,600,0.1,5
140,B,,TF,4,-100,200,300,1.2,60
140,B,,EC,5,200,300,100,4.8,240
140,B,,MC,6,300,450,150,4.8,240
140,B,,LC,7,450,600,150,0.6,30
140,B,,Epi,8,600,850,250,0,0
140,B,,EPC,9,850,1150,300,4.2,210
140,B,,P,10,1150,1300,150,1,50
140,B,,A,11,1300,1440,140,4.8,240
140,B,724,M,12,1440,1520,80,0.5,25
140,B,,M,12,1440,1520,80,2.3,115
141,A,,TF,4,-100,200,300,0.8,40
141,A,,EC,5,200,300,100,6.8,340
141,A,,MC,6,300,450,150,6.8,340
141,A,,LC,7,450,600,150,4.9,245
141,A,,Epi,8,600,850,250,0.2,10
141,A,,EPC,9,850,1150,300,5.2,260
141,B,,A,11,1300,1440,140,0.4,20
141,B,,M,12,1440,1520,80,0.2,10
142,A,,MF,2,-1100,-500,600,5.8,290
142,A,,LF,3,-500,-100,400,8.9,445
142,A,737,TF,4,-100,200,300,2.9,145
142,A,,TF,4,-100,200,300,5.6,280
142,A,,EC,5,200,300,100,25.2,1260
142,A,,MC,6,300,450,150,18.4,920
142,A,904,LC,7,450,600,150,2,100
142,A,,LC,7,450,600,150,1.8,90
142,A,734,Epi,8,600,850,250,1.3,65
142,A,735,Epi,8,600,850,250,5.3,265
142,A,,Epi,8,600,850,250,0.2,10
142,A,733,EPC,9,850,1150,300,9.9,495
142,A,,EPC,9,850,1150,300,5.3,265
142,A,732,P,10,1150,1300,150,1.3,65
142,A,,P,10,1150,1300,150,0.8,40
142,B,,M,12,1440,1520,80,2.9,145
143,A,,LF,3,-500,-100,400,0.9,45
143,B,,Epi,8,600,850,250,1.1,55
143,B,,EPC,9,850,1150,300,1,50
144,A,,LF,3,-500,-100,400,1.1,55
144,B,,Epi,8,600,850,250,1.3,65
144,B,,EPC,9,850,1150,300,1.3,65
147,A,,MF,2,-1100,-500,600,2.1,105
147,A,,LF,3,-500,-100,400,2.1,105
147,A,,TF,4,-100,200,300,3.9,195
147,A,588,EC,5,200,300,100,1,50
147,A,,EC,5,200,300,100,18.5,925
147,A,588,MC,6,300,450,150,1,50
147,A,,MC,6,300,450,150,18.5,925
147,A,,LC,7,450,600,150,2.5,125
147,A,593,Epi,8,600,850,250,2,100
147,A,,Epi,8,600,850,250,11.4,570
147,A,,EPC,9,850,1150,300,30.6,1530
147,A,594,P,10,1150,1300,150,0.2,10
147,A,596,P,10,1150,1300,150,31.2,1560
147,A,708,P,10,1150,1300,150,0.8,40
148,A,,MF,2,-1100,-500,600,1.7,85
148,A,,LF,3,-500,-100,400,1.7,85
148,A,905,TF,4,-100,200,300,1.3,65
148,A,,TF,4,-100,200,300,3.3,165
148,A,,EC,5,200,300,100,11,550
148,A,,MC,6,300,450,150,11,550
148,A,906,LC,7,450,600,150,0.9,45
148,A,,LC,7,450,600,150,1.2,60
148,A,,Epi,8,600,850,250,6.8,340
148,A,,EPC,9,850,1150,300,13,650
148,A,,P,10,1150,1300,150,3.8,190
148,A,,A,11,1300,1440,140,2,100
148,A,,M,12,1440,1520,80,12,600
149,A,,LF,3,-500,-100,400,0.3,15
149,A,,TF,4,-100,200,300,1.4,70
149,A,,EC,5,200,300,100,2.1,105
149,A,,MC,6,300,450,150,2.1,105
149,A,,LC,7,450,600,150,0.1,5
149,A,,Epi,8,600,850,250,0.2,10
149,A,,EPC,9,850,1150,300,0.2,10
151,A,907,TF,4,-100,200,300,5.6,280
151,A,908,TF,4,-100,200,300,0.6,30
151,A,,TF,4,-100,200,300,6.7,335
151,A,,EC,5,200,300,100,80.4,4020
151,A,,MC,6,300,450,150,78.8,3940
151,A,909,LC,7,450,600,150,2.6,130
151,A,910,LC,7,450,600,150,1.5,75
151,A,911,LC,7,450,600,150,0.2,10
151,A,,LC,7,450,600,150,4,200
151,A,,Epi,8,600,850,250,0,0
151,B,880,A,11,1300,1440,140,0.1,5
151,B,881,A,11,1300,1440,140,0.1,5
151,B,,A,11,1300,1440,140,0.3,15
151,B,879,M,12,1440,1520,80,0.4,20
151,B,,M,12,1440,1520,80,0.4,20
152,A,,EC,5,200,300,100,0.2,10
152,A,,MC,6,300,450,150,0.2,10
152,B,,Epi,8,600,850,250,0.1,5
152,C,,A,11,1300,1440,140,0.1,5
152,C,,M,12,1440,1520,80,0.1,5
153,A,,LF,3,-500,-100,400,0.1,5
153,B,,EC,5,200,300,100,0.1,5
153,B,,MC,6,300,450,150,0.1,5
154,A,,TF,4,-100,200,300,0.1,5
154,A,,EC,5,200,300,100,0.1,5
154,A,,MC,6,300,450,150,0.1,5
154,A,,LC,7,450,600,150,0.1,5
154,B,,P,10,1150,1300,150,0.1,5
155,A,,LF,3,-500,-100,400,0.1,5
155,B,,A,11,1300,1440,140,0.1,5
155,B,,M,12,1440,1520,80,0.1,5
156,A,,A,11,1300,1440,140,0.3,15
156,A,,M,12,1440,1520,80,0.3,15
157,A,,TF,4,-100,200,300,0.1,5
157,A,,EC,5,200,300,100,0.1,5
157,A,,MC,6,300,450,150,0.1,5
158,A,,M,12,1440,1520,80,0.1,5
159,A,,LF,3,-500,-100,400,0.4,20
160,A,,LF,3,-500,-100,400,5.8,290
160,A,747,TF,4,-100,200,300,2.6,130
160,A,749,TF,4,-100,200,300,0.1,5
160,A,750,TF,4,-100,200,300,5.9,295
160,A,751,TF,4,-100,200,300,1.2,60
160,A,752,TF,4,-100,200,300,0.8,40
160,A,755,TF,4,-100,200,300,0.6,30
160,A,,TF,4,-100,200,300,5.8,290
160,A,747,EC,5,200,300,100,3.1,155
160,A,749,EC,5,200,300,100,0.1,5
160,A,750,EC,5,200,300,100,7.3,365
160,A,751,EC,5,200,300,100,4.8,240
160,A,752,EC,5,200,300,100,1.8,90
160,A,753,EC,5,200,300,100,1.6,80
160,A,755,EC,5,200,300,100,0.8,40
160,A,,EC,5,200,300,100,9.8,490
160,A,747,MC,6,300,450,150,3.5,175
160,A,749,MC,6,300,450,150,0.1,5
160,A,750,MC,6,300,450,150,7.3,365
160,A,751,MC,6,300,450,150,5.2,260
160,A,752,MC,6,300,450,150,1.8,90
160,A,753,MC,6,300,450,150,2.3,115
160,A,755,MC,6,300,450,150,0.8,40
160,A,,MC,6,300,450,150,9.8,490
160,A,750,LC,7,450,600,150,2.6,130
160,A,751,LC,7,450,600,150,3.2,160
160,A,752,LC,7,450,600,150,0.8,40
160,A,753,LC,7,450,600,150,1.7,85
160,A,755,LC,7,450,600,150,0.6,30
160,A,,LC,7,450,600,150,2,100
160,A,743,Epi,8,600,850,250,1.7,85
160,A,744,Epi,8,600,850,250,0.1,5
160,A,745,Epi,8,600,850,250,0.3,15
160,A,746,Epi,8,600,850,250,1.8,90
160,A,,Epi,8,600,850,250,6.2,310
160,A,527,EPC,9,850,1150,300,0.3,15
160,A,528,EPC,9,850,1150,300,0.2,10
160,A,529,EPC,9,850,1150,300,0.2,10
160,A,739,EPC,9,850,1150,300,3.6,180
160,A,740,EPC,9,850,1150,300,0.1,5
160,A,741,EPC,9,850,1150,300,0.1,5
160,A,742,EPC,9,850,1150,300,11,550
160,A,763,EPC,9,850,1150,300,0.1,5
160,A,,EPC,9,850,1150,300,6.2,310
160,A,523,P,10,1150,1300,150,2.6,130
160,A,524,P,10,1150,1300,150,0.3,15
160,A,525,P,10,1150,1300,150,0.8,40
160,A,526,P,10,1150,1300,150,0.1,5
160,A,529,P,10,1150,1300,150,0.1,5
160,A,,P,10,1150,1300,150,30.9,1545
160,A,764,A,11,1300,1440,140,13,650
160,A,,A,11,1300,1440,140,84.3,4215
160,A,884,M,12,1440,1520,80,37.4,1870
160,A,,M,12,1440,1520,80,102.8,5140
161,A,,LF,3,-500,-100,400,0.3,15
162,A,772,P,10,1150,1300,150,0.1,5
163,A,,MF,2,-1100,-500,600,0.2,10
163,A,,LF,3,-500,-100,400,0.2,10
163,B,,EC,5,200,300,100,16,800
163,B,,MC,6,300,450,150,15.1,755
163,B,,LC,7,450,600,150,1.8,90
163,B,774,Epi,8,600,850,250,1,50
163,B,,Epi,8,600,850,250,0,0
163,B,773,EPC,9,850,1150,300,0.1,5
163,B,,EPC,9,850,1150,300,22.1,1105
163,B,771,P,10,1150,1300,150,0.2,10
163,B,,P,10,1150,1300,150,0.2,10
163,B,,A,11,1300,1440,140,0.2,10
163,B,,M,12,1440,1520,80,2.2,110
164,A,,MF,2,-1100,-500,600,2.4,120
164,A,,LF,3,-500,-100,400,18.1,905
164,A,530,TF,4,-100,200,300,5.9,295
164,A,801,TF,4,-100,200,300,1.9,95
164,A,802,TF,4,-100,200,300,0.4,20
164,A,811,TF,4,-100,200,300,0.4,20
164,A,812,TF,4,-100,200,300,2.5,125
164,A,821,TF,4,-100,200,300,0.9,45
164,A,865,TF,4,-100,200,300,0.9,45
164,A,918,TF,4,-100,200,300,1,50
164,A,919,TF,4,-100,200,300,2.2,110
164,A,920,TF,4,-100,200,300,2.4,120
164,A,921,TF,4,-100,200,300,1.9,95
164,A,922,TF,4,-100,200,300,0.4,20
164,A,,TF,4,-100,200,300,22.2,1110
164,A,530,EC,5,200,300,100,31.7,1585
164,A,800,EC,5,200,300,100,0.9,45
164,A,801,EC,5,200,300,100,1.9,95
164,A,802,EC,5,200,300,100,0.4,20
164,A,804,EC,5,200,300,100,1.3,65
164,A,807,EC,5,200,300,100,0.6,30
164,A,808,EC,5,200,300,100,4.7,235
164,A,809,EC,5,200,300,100,0.4,20
164,A,812,EC,5,200,300,100,3,150
164,A,814,EC,5,200,300,100,0.3,15
164,A,821,EC,5,200,300,100,1.1,55
164,A,865,EC,5,200,300,100,0.9,45
164,A,919,EC,5,200,300,100,2.2,110
164,A,920,EC,5,200,300,100,6.7,335
164,A,923,EC,5,200,300,100,0.1,5
164,A,,EC,5,200,300,100,23.4,1170
164,A,530,MC,6,300,450,150,4.5,225
164,A,800,MC,6,300,450,150,0.9,45
164,A,801,MC,6,300,450,150,1.4,70
164,A,802,MC,6,300,450,150,0.4,20
164,A,804,MC,6,300,450,150,2.3,115
164,A,807,MC,6,300,450,150,0.6,30
164,A,808,MC,6,300,450,150,10.5,525
164,A,812,MC,6,300,450,150,1.6,80
164,A,821,MC,6,300,450,150,1.9,95
164,A,865,MC,6,300,450,150,0.9,45
164,A,920,MC,6,300,450,150,6.7,335
164,A,923,MC,6,300,450,150,0.1,5
164,A,,MC,6,300,450,150,19.4,970
164,A,530,LC,7,450,600,150,1.5,75
164,A,801,LC,7,450,600,150,0.5,25
164,A,808,LC,7,450,600,150,2.5,125
164,A,818,LC,7,450,600,150,0.6,30
164,A,821,LC,7,450,600,150,0.3,15
164,A,920,LC,7,450,600,150,2.4,120
164,A,,LC,7,450,600,150,5.4,270
164,A,741,Epi,8,600,850,250,0.1,5
164,A,788,Epi,8,600,850,250,1.1,55
164,A,789,Epi,8,600,850,250,0.4,20
164,A,790,Epi,8,600,850,250,5.5,275
164,A,792,Epi,8,600,850,250,0.6,30
164,A,793,Epi,8,600,850,250,3,150
164,A,794,Epi,8,600,850,250,1.3,65
164,A,795,Epi,8,600,850,250,0.4,20
164,A,796,Epi,8,600,850,250,0.6,30
164,A,797,Epi,8,600,850,250,1.2,60
164,A,798,Epi,8,600,850,250,1.3,65
164,A,851,Epi,8,600,850,250,0.2,10
164,A,,Epi,8,600,850,250,25.6,1280
164,A,530,EPC,9,850,1150,300,0.3,15
164,A,568,EPC,9,850,1150,300,16.9,845
164,A,569,EPC,9,850,1150,300,0.9,45
164,A,570,EPC,9,850,1150,300,0.4,20
164,A,571,EPC,9,850,1150,300,0.5,25
164,A,572,EPC,9,850,1150,300,0.2,10
164,A,782,EPC,9,850,1150,300,2.5,125
164,A,783,EPC,9,850,1150,300,0.2,10
164,A,784,EPC,9,850,1150,300,2.3,115
164,A,785,EPC,9,850,1150,300,8.7,435
164,A,786,EPC,9,850,1150,300,0.9,45
164,A,787,EPC,9,850,1150,300,5.9,295
164,A,850,EPC,9,850,1150,300,1.1,55
164,A,,EPC,9,850,1150,300,25.6,1280
164,A,,EPC,9,850,1150,300,0.5,25
164,A,555,P,10,1150,1300,150,0.5,25
164,A,556,P,10,1150,1300,150,0.1,5
164,A,557,P,10,1150,1300,150,0.2,10
164,A,558,P,10,1150,1300,150,0.8,40
164,A,559,P,10,1150,1300,150,1.1,55
164,A,560,P,10,1150,1300,150,3.8,190
164,A,,P,10,1150,1300,150,33.4,1670
164,A,548,A,11,1300,1440,140,1.4,70
164,A,549,A,11,1300,1440,140,2.8,140
164,A,550,A,11,1300,1440,140,1,50
164,A,551,A,11,1300,1440,140,2.4,120
164,A,552,A,11,1300,1440,140,1.9,95
164,A,553,A,11,1300,1440,140,6.9,345
164,A,554,A,11,1300,1440,140,1.7,85
164,A,,A,11,1300,1440,140,9.8,490
164,A,539,M,12,1440,1520,80,1.7,85
164,A,540,M,12,1440,1520,80,1,50
164,A,541,M,12,1440,1520,80,1.7,85
164,A,542,M,12,1440,1520,80,1,50
164,A,543,M,12,1440,1520,80,0.2,10
164,A,544,M,12,1440,1520,80,1.2,60
164,A,545,M,12,1440,1520,80,1.2,60
164,A,546,M,12,1440,1520,80,0.2,10
164,A,547,M,12,1440,1520,80,6,300
164,A,849,M,12,1440,1520,80,1.9,95
164,A,,M,12,1440,1520,80,2.4,120
165,A,,LF,3,-500,-100,400,0.5,25
165,A,,TF,4,-100,200,300,0.2,10
165,A,,EC,5,200,300,100,0.9,45
165,A,,MC,6,300,450,150,0.9,45
165,B,,P,10,1150,1300,150,2.9,145
165,B,,A,11,1300,1440,140,2.9,145
165,B,,M,12,1440,1520,80,2.9,145
166,A,,TF,4,-100,200,300,0.7,35
166,A,,EC,5,200,300,100,0.1,5
166,A,,MC,6,300,450,150,0.1,5
166,B,,EPC,9,850,1150,300,0.1,5
168,A,,LF,3,-500,-100,400,0.9,45
168,B,,EC,5,200,300,100,4.1,205
168,B,,MC,6,300,450,150,4.1,205
168,C,,EPC,9,850,1150,300,2,100
169,A,,LF,3,-500,-100,400,0.5,25
169,B,,Epi,8,600,850,250,0.5,25
170,A,,EC,5,200,300,100,0.1,5
170,A,,MC,6,300,450,150,0.1,5
171,A,,EC,5,200,300,100,0.2,10
171,A,,MC,6,300,450,150,0.2,10
171,B,,A,11,1300,1440,140,0.4,20
171,B,,M,12,1440,1520,80,0.7,35
172,A,,A,11,1300,1440,140,1.4,70
172,A,,M,12,1440,1520,80,1.4,70
173,A,,P,10,1150,1300,150,0.1,5
173,A,,A,11,1300,1440,140,0.1,5
173,A,,M,12,1440,1520,80,0.3,15
174,A,,P,10,1150,1300,150,0.4,20
174,A,,A,11,1300,1440,140,0.4,20
174,A,,M,12,1440,1520,80,0.4,20
175,A,,A,11,1300,1440,140,0.2,10
175,A,,M,12,1440,1520,80,0.2,10
176,A,,EC,5,200,300,100,0.1,5
176,A,,MC,6,300,450,150,0.1,5
176,B,,A,11,1300,1440,140,0.4,20
176,B,,M,12,1440,1520,80,0.4,20
177,A,,LF,3,-500,-100,400,1,50
177,A,,TF,4,-100,200,300,0.2,10
177,B,,MC,6,300,450,150,0.6,30
177,B,,LC,7,450,600,150,0.9,45
177,B,,Epi,8,600,850,250,1,50
177,C,,P,10,1150,1300,150,0.8,40
177,D,,M,12,1440,1520,80,0.3,15
178,A,,LF,3,-500,-100,400,0.9,45
178,A,,TF,4,-100,200,300,4.3,215
178,A,,EC,5,200,300,100,2.2,110
178,B,,LC,7,450,600,150,2.5,125
178,C,,EPC,9,850,1150,300,0.9,45
179,A,,P,10,1150,1300,150,0.2,10
179,B,,M,12,1440,1520,80,0.1,5
180,A,,LF,3,-500,-100,400,0.1,5
180,B,,LC,7,450,600,150,0.1,5
181,A,,TF,4,-100,200,300,0.1,5
181,A,,EC,5,200,300,100,0.1,5
181,B,,EPC,9,850,1150,300,0.1,5
182,A,,A/M,12,1300,1520,220,0.4,20
183,A,,A,11,1300,1440,140,0.2,10
183,A,,M,12,1440,1520,80,0.2,10
184,A,,Epi,8,600,850,250,0.2,10
184,A,,EPC,9,850,1150,300,0.2,10
185,A,,Epi,8,600,850,250,2.5,125
185,A,,EPC,9,850,1150,300,0.9,45
185,A,,P,10,1150,1300,150,2.5,125
185,A,,A,11,1300,1440,140,0.8,40
185,A,,M,12,1440,1520,80,0.8,40
186,A,,A/M,12,1300,1520,220,0.1,5
187,A,,A,11,1300,1440,140,0.1,5
187,A,,M,12,1440,1520,80,0.1,5
188,A,,MF,2,-1100,-500,600,0.3,15
188,A,,LF,3,-500,-100,400,0.3,15
188,B,,P,10,1150,1300,150,0.3,15
189,A,,Epi,8,600,850,250,10.1,505
189,B,,A,11,1300,1440,140,0.6,30
189,B,,M,12,1440,1520,80,2.8,140
190,A,,EPC,9,850,1150,300,0.1,5
190,A,,P,10,1150,1300,150,0.1,5
190,A,,A,11,1300,1440,140,0.2,10
190,A,,M,12,1440,1520,80,0.2,10
191,A,,A,11,1300,1440,140,0.1,5
191,A,,M,12,1440,1520,80,0.1,5
192,A,,LF,3,-500,-100,400,0.2,10
192,A,,TF,4,-100,200,300,0.2,10
192,A,,EC,5,200,300,100,0.2,10
192,A,,MC,6,300,450,150,0.1,5
192,A,,LC,7,450,600,150,0.2,10
193,A,,EC,5,200,300,100,5.4,270
193,B,,LC,7,450,600,150,1.3,65
193,B,,Epi,8,600,850,250,5.5,275
193,B,,EPC,9,850,1150,300,0.6,30
193,B,727,P,10,1150,1300,150,2.8,140
193,B,,P,10,1150,1300,150,5.5,275
193,B,726,A,11,1300,1440,140,4.3,215
193,B,,A,11,1300,1440,140,5.5,275
193,B,,M,12,1440,1520,80,14.2,710
194,A,,LF,3,-500,-100,400,0.4,20
194,B,,EC,5,200,300,100,0.4,20
194,B,,MC,6,300,450,150,0.4,20
194,B,,LC,7,450,600,150,0.1,5
195,A,,LF,3,-500,-100,400,0.5,25
195,A,,TF,4,-100,200,300,0.5,25
195,A,,EC,5,200,300,100,0.5,25
195,A,,MC,6,300,450,150,0.5,25
195,B,,EPC,9,850,1150,300,0.1,5
195,C,,M,12,1440,1520,80,0.5,25
196,A,,LF,3,-500,-100,400,4.1,205
196,A,,TF,4,-100,200,300,7.6,380
196,A,,EC,5,200,300,100,16.8,840
196,A,,MC,6,300,450,150,16.8,840
196,A,912,LC,7,450,600,150,2.1,105
196,A,,LC,7,450,600,150,3.5,175
196,B,,EPC,9,850,1150,300,1.2,60
196,B,,P,10,1150,1300,150,1.2,60
197,A,,P,10,1150,1300,150,0.1,5
197,A,,A,11,1300,1440,140,0.1,5
197,A,,M,12,1440,1520,80,0.1,5
198,A,,MF,2,-1100,-500,600,1.1,55
198,A,,LF,3,-500,-100,400,1.5,75
198,A,,TF,4,-100,200,300,1.5,75
198,A,,EC,5,200,300,100,1.5,75
198,A,,MC,6,300,450,150,1.5,75
198,B,,EPC,9,850,1150,300,1.1,55
198,B,,P,10,1150,1300,150,1.1,55
198,C,,M,12,1440,1520,80,1.1,55
199,A,,LF,3,-500,-100,400,0.3,15
199,B,,EPC,9,850,1150,300,0.7,35
199,C,,A,11,1300,1440,140,0.3,15
199,C,,M,12,1440,1520,80,0.7,35
200,A,,LF,3,-500,-100,400,0.1,5
200,B,,Epi,8,600,850,250,0.1,5
200,B,,EPC,9,850,1150,300,0.1,5
200,B,,P,10,1150,1300,150,25.6,1280
200,B,,A,11,1300,1440,140,30.3,1515
200,B,855,M,12,1440,1520,80,0.1,5
200,B,,M,12,1440,1520,80,122.5,6125
201,A,,Epi,8,600,850,250,0.1,5
201,A,,EPC,9,850,1150,300,7.6,380
201,A,,P,10,1150,1300,150,0.9,45
201,A,,A,11,1300,1440,140,0.1,5
201,A,,M,12,1440,1520,80,2.7,135
202,A,,Epi,8,600,850,250,0.1,5
202,A,,EPC,9,850,1150,300,1.9,95
202,A,,P,10,1150,1300,150,0.1,5
202,A,,A,11,1300,1440,140,5.5,275
202,A,,M,12,1440,1520,80,0.9,45
203,A,,Epi,8,600,850,250,0.1,5
203,A,,EPC,9,850,1150,300,0.1,5
203,A,,P,10,1150,1300,150,0.1,5
203,A,,A,11,1300,1440,140,24.5,1225
203,A,,M,12,1440,1520,80,2.1,105
204,A,,Epi,8,600,850,250,0.1,5
204,A,,EPC,9,850,1150,300,0.1,5
204,A,,P,10,1150,1300,150,0.1,5
204,A,,A,11,1300,1440,140,0.1,5
204,A,,M,12,1440,1520,80,0.1,5
205,A,,EPC,9,850,1150,300,0.1,5
205,A,,P,10,1150,1300,150,0.1,5
205,A,,A,11,1300,1440,140,0.1,5
205,A,,M,12,1440,1520,80,0.1,5
206,A,,EPC,9,850,1150,300,0.6,30
206,A,,P,10,1150,1300,150,0.1,5
206,A,,A,11,1300,1440,140,0.1,5
206,A,,M,12,1440,1520,80,0.1,5
207,A,,EPC,9,850,1150,300,0.1,5
207,A,,P,10,1150,1300,150,0.1,5
207,A,,A,11,1300,1440,140,0.1,5
207,A,,M,12,1440,1520,80,0.1,5
208,A,1403,P,10,1150,1300,150,0.1,5
208,B,1403,M,12,1440,1520,80,0.1,5
209,A,,M,12,1440,1520,80,0.1,5
211,A,,MF,2,-1100,-500,600,0.6,30
211,A,,LF,3,-500,-100,400,0.6,30
211,A,,TF,4,-100,200,300,0.6,30
211,A,,EC,5,200,300,100,0.6,30
211,A,,MC,6,300,450,150,0.6,30
211,A,,LC,7,450,600,150,0.6,30
211,B,,EPC,9,850,1150,300,0.6,30
211,C,,M,12,1440,1520,80,0.6,30
212,A,,LF,3,-500,-100,400,0.3,15
212,B,,EC,5,200,300,100,0.4,20
212,B,,MC,6,300,450,150,0.8,40
212,C,,Epi,8,600,850,250,0.2,10
212,D,,A,11,1300,1440,140,0.2,10
212,D,,M,12,1440,1520,80,0.5,25
213,A,,A,11,1300,1440,140,0.8,40
213,A,,M,12,1440,1520,80,1.3,65
214,A,,EC,5,200,300,100,0.2,10
214,A,,MC,6,300,450,150,0.2,10
214,A,,LC,7,450,600,150,0.1,5
215,A,,A,11,1300,1440,140,0.1,5
215,A,,M,12,1440,1520,80,0.1,5
216,A,,A,11,1300,1440,140,0.2,10
216,A,,M,12,1440,1520,80,0.2,10
218,A,,EC,5,200,300,100,0.4,20
218,A,,MC,6,300,450,150,0.4,20
218,B,,P,10,1150,1300,150,0.3,15
218,B,,A,11,1300,1440,140,0.3,15
218,B,,M,12,1440,1520,80,0.7,35
219,A,,EC,5,200,300,100,6,300
219,A,,MC,6,300,450,150,6,300
219,A,,LC,7,450,600,150,0.9,45
219,B,,P,10,1150,1300,150,1,50
219,B,,A,11,1300,1440,140,5.8,290
219,B,,M,12,1440,1520,80,5.8,290
220,A,,LF,3,-500,-100,400,0.1,5
220,B,,EC,5,200,300,100,0.2,10
220,B,,MC,6,300,450,150,0.2,10
220,C,,EPC,9,850,1150,300,0.2,10
220,D,,A,11,1300,1440,140,0.3,15
220,D,,M,12,1440,1520,80,0.3,15
221,A,,MF,2,-1100,-500,600,1.1,55
221,A,,LF,3,-500,-100,400,2.8,140
221,B,,EC,5,200,300,100,2.5,125
221,B,,MC,6,300,450,150,2.5,125
221,C,,Epi,8,600,850,250,2.8,140
221,C,,EPC,9,850,1150,300,4.5,225
221,D,,A,11,1300,1440,140,2.8,140
221,D,,M,12,1440,1520,80,2.8,140
222,A,,EPC,9,850,1150,300,0.6,30
223,A,,MF,2,-1100,-500,600,0.9,45
223,A,,LF,3,-500,-100,400,0.9,45
223,B,,EC,5,200,300,100,1.8,90
223,B,,MC,6,300,450,150,1.8,90
223,C,,EPC,9,850,1150,300,1.8,90
223,D,,A,11,1300,1440,140,0.9,45
223,D,,M,12,1440,1520,80,1.8,90
224,A,,LF,3,-500,-100,400,0.5,25
224,A,,TF,4,-100,200,300,2,100
224,A,,EC,5,200,300,100,9.9,495
224,A,,MC,6,300,450,150,9.9,495
224,B,,EPC,9,850,1150,300,4,200
224,B,,P,10,1150,1300,150,3.4,170
224,B,,A,11,1300,1440,140,10.6,530
224,B,,M,12,1440,1520,80,11.6,580
225,A,,MF,2,-1100,-500,600,0.1,5
225,B,,EC,5,200,300,100,0.1,5
225,B,,MC,6,300,450,150,0.1,5
225,C,,Epi,8,600,850,250,0.1,5
225,C,,EPC,9,850,1150,300,0.1,5
225,D,,A,11,1300,1440,140,0.1,5
225,D,,M,12,1440,1520,80,0.1,5
226,A,,LF,3,-500,-100,400,0.3,15
226,A,,TF,4,-100,200,300,0.3,15
226,B,,Epi,8,600,850,250,0.6,30
226,B,,EPC,9,850,1150,300,0.6,30
227,A,,A,11,1300,1440,140,0.1,5
227,A,,M,12,1440,1520,80,0.1,5
228,A,,Epi,8,600,850,250,0.1,5
228,B,,A,11,1300,1440,140,0.3,15
228,B,,M,12,1440,1520,80,0.3,15
229,A,,EC,5,200,300,100,0.7,35
229,A,,MC,6,300,450,150,0.7,35
230,A,,LF,3,-500,-100,400,1.8,90
230,B,,EC,5,200,300,100,3.3,165
230,B,,MC,6,300,450,150,3.3,165
230,B,,LC,7,450,600,150,0.2,10
230,C,,P,10,1150,1300,150,1.2,60
230,C,,A,11,1300,1440,140,1,50
230,C,,M,12,1440,1520,80,3.8,190
231,A,,LF,3,-500,-100,400,0.2,10
231,B,,EC,5,200,300,100,2.9,145
231,B,,MC,6,300,450,150,2.9,145
231,C,,A,11,1300,1440,140,0.2,10
231,C,778,M,12,1440,1520,80,0.2,10
231,C,,M,12,1440,1520,80,0.6,30
232,A,,TF,4,-100,200,300,5,250
232,A,,EC,5,200,300,100,62.6,3130
232,A,,MC,6,300,450,150,62.6,3130
232,A,913,LC,7,450,600,150,2.1,105
232,A,,LC,7,450,600,150,2.4,120
233,A,,LF,3,-500,-100,400,2,100
233,B,,EC,5,200,300,100,1.4,70
233,B,,MC,6,300,450,150,1.4,70
233,B,,LC,7,450,600,150,4.4,220
233,C,,EPC,9,850,1150,300,0.6,30
233,D,,A,11,1300,1440,140,3.7,185
233,D,,M,12,1440,1520,80,6.4,320
234,A,,EC,5,200,300,100,0.5,25
234,A,,MC,6,300,450,150,0.5,25
234,B,,A,11,1300,1440,140,0.2,10
234,B,,M,12,1440,1520,80,0.5,25
235,A,,LF,3,-500,-100,400,0.2,10
235,A,,TF,4,-100,200,300,0.3,15
235,A,,EC,5,200,300,100,0.3,15
235,A,,MC,6,300,450,150,0.3,15
235,B,,Epi,8,600,850,250,0.2,10
236,A,,A,11,1300,1440,140,0.4,20
236,A,,M,12,1440,1520,80,0.4,20
237,A,,TF,4,-100,200,300,1.3,65
237,A,,EC,5,200,300,100,1.3,65
237,A,,MC,6,300,450,150,1.3,65
238,A,,LF,3,-500,-100,400,2.1,105
238,B,,EC,5,200,300,100,17.8,890
238,B,,MC,6,300,450,150,17.8,890
238,B,,LC,7,450,600,150,1.1,55
238,B,,Epi,8,600,850,250,2.1,105
238,B,779,EPC,9,850,1150,300,0.7,35
238,B,,EPC,9,850,1150,300,0.8,40
238,B,,P,10,1150,1300,150,2.7,135
238,B,,A,11,1300,1440,140,4.4,220
238,B,,M,12,1440,1520,80,5.9,295
239,A,,EC,5,200,300,100,1.1,55
239,B,,P,10,1150,1300,150,1.1,55
239,B,,A,11,1300,1440,140,1.1,55
239,B,,M,12,1440,1520,80,1.1,55
240,A,,P,10,1150,1300,150,0.2,10
240,A,,A/M,12,1300,1520,220,0.2,10
242,A,,TF,4,-100,200,300,0.3,15
242,A,,EC,5,200,300,100,0.3,15
242,A,,MC,6,300,450,150,0.3,15
242,A,,LC,7,450,600,150,0.3,15
244,A,,TF,4,-100,200,300,2.3,115
244,A,,EC,5,200,300,100,2.3,115
245,A,,MC,6,300,450,150,0.1,5
245,A,,LC,7,450,600,150,0.1,5
245,B,,A,11,1300,1440,140,0.2,10
245,B,,M,12,1440,1520,80,0.2,10
246,A,,LF,3,-500,-100,400,0.4,20
246,A,,TF,4,-100,200,300,5.3,265
246,A,,EC,5,200,300,100,20.2,1010
246,A,,MC,6,300,450,150,20.2,1010
246,A,,LC,7,450,600,150,0.2,10
246,B,,EPC,9,850,1150,300,0.3,15
246,B,,P,10,1150,1300,150,1.6,80
246,B,,A,11,1300,1440,140,2.8,140
246,B,,M,12,1440,1520,80,2.8,140
247,A,,EC,5,200,300,100,1.3,65
247,A,,MC,6,300,450,150,1.3,65
248,A,,A,11,1300,1440,140,0.2,10
248,A,,M,12,1440,1520,80,0.2,10
249,A,,P,10,1150,1300,150,0.1,5
249,A,,A,11,1300,1440,140,0.1,5
249,A,,M,12,1440,1520,80,0.1,5
250,A,,A,11,1300,1440,140,0.1,3
250,A,,M,12,1440,1520,80,0.1,3
251,A,914,TF,4,-100,200,300,0.1,5
251,A,,TF,4,-100,200,300,0.8,40
251,A,,EC,5,200,300,100,5.7,285
251,A,,MC,6,300,450,150,5.7,285
251,B,,Epi,8,600,850,250,6.5,325
251,B,,EPC,9,850,1150,300,0.4,20
251,C,,M,12,1440,1520,80,4.3,215
252,A,,MF,2,-1100,-500,600,0.9,45
252,A,,LF,3,-500,-100,400,3.5,175
252,B,,EC,5,200,300,100,5.9,295
252,B,,MC,6,300,450,150,5.9,295
252,C,,Epi,8,600,850,250,0.7,35
252,D,,M,12,1440,1520,80,0.4,20
253,A,,LF,3,-500,-100,400,0.4,20
253,B,,EC,5,200,300,100,11.3,565
253,B,,MC,6,300,450,150,11.3,565
253,B,,LC,7,450,600,150,2.1,105
253,B,,Epi,8,600,850,250,4.1,205
254,A,,MF,2,-1100,-500,600,0.8,40
254,A,,LF,3,-500,-100,400,0.8,40
254,A,,TF,4,-100,200,300,0.8,40
254,A,,EC,5,200,300,100,0.8,40
255,A,,MF,2,-1100,-500,600,0.2,10
255,A,,LF,3,-500,-100,400,0.2,10
255,A,,TF,4,-100,200,300,0.1,5
255,A,,EC,5,200,300,100,0.1,5
255,A,,MC,6,300,450,150,0.1,5
255,B,,A,11,1300,1440,140,0.5,25
255,B,,M,12,1440,1520,80,0.4,20
256,A,,EPC,9,850,1150,300,0.3,15
256,A,,P,10,1150,1300,150,1.1,55
258,A,,EC,5,200,300,100,0.2,10
258,A,,MC,6,300,450,150,0.2,10
258,B,,EPC,9,850,1150,300,0.5,25
259,A,,TF,4,-100,200,300,1,50
259,A,,EC,5,200,300,100,1,50
260,A,,EC,5,200,300,100,1.1,55
260,A,,MC,6,300,450,150,1.1,55
260,B,,A,11,1300,1440,140,1.1,55
260,B,,M,12,1440,1520,80,1.1,55
261,A,,A,11,1300,1440,140,0.3,15
261,A,,M,12,1440,1520,80,1.9,95
262,A,,EC,5,200,300,100,0.2,10
262,B,,LC,7,450,600,150,0.4,20
262,C,,A,11,1300,1440,140,0.5,25
262,C,,M,12,1440,1520,80,0.5,25
264,A,,EC,5,200,300,100,0.1,5
264,A,,MC,6,300,450,150,0.1,5
264,B,,M,12,1440,1520,80,0.2,10
265,A,,A,11,1300,1440,140,0.2,10
265,A,,M,12,1440,1520,80,0.2,10
266,A,,EC,5,200,300,100,3.5,175
266,A,,MC,6,300,450,150,3.5,175
266,B,,Epi,8,600,850,250,3.5,175
266,B,,EPC,9,850,1150,300,0.8,40
267,A,,LF,3,-500,-100,400,2.2,110
267,B,,EC,5,200,300,100,4.4,220
267,B,,MC,6,300,450,150,4.4,220
267,C,,Epi,8,600,850,250,4.4,220
267,C,,EPC,9,850,1150,300,1.5,75
268,A,,EC,5,200,300,100,0.1,5
268,A,,MC,6,300,450,150,0.1,5
268,B,,EPC,9,850,1150,300,0.1,5
269,A,,MF,2,-1100,-500,600,0.3,15
269,A,,LF,3,-500,-100,400,0.3,15
269,B,,P,10,1150,1300,150,1.2,60
270,A,,LF,3,-500,-100,400,1.3,65
270,B,,EC,5,200,300,100,0.8,40
270,B,,MC,6,300,450,150,0.8,40
270,C,,Epi,8,600,850,250,1.3,65
271,A,,M,12,1440,1520,80,0.1,5
272,A,,Epi,8,600,850,250,0.2,10
273,A,,Epi,8,600,850,250,0.4,20
273,A,,EPC,9,850,1150,300,0.1,5
273,B,,A,11,1300,1440,140,0.4,20
273,B,,M,12,1440,1520,80,0.4,20
274,A,,M,12,1440,1520,80,0.3,15
280,A,,EPC,9,850,1150,300,0.4,20
280,B,,A,11,1300,1440,140,0.8,40
280,B,,M,12,1440,1520,80,0.8,40
281,A,,A,11,1300,1440,140,0.2,10
281,A,,M,12,1440,1520,80,0.2,10
282,A,,EC,5,200,300,100,0.2,10
282,A,,MC,6,300,450,150,0.2,10
282,B,,EPC,9,850,1150,300,0.2,10
283,A,,A,11,1300,1440,140,0.3,15
283,A,,M,12,1440,1520,80,0.3,15
284,A,,LF,3,-500,-100,400,0.5,25
284,B,,EC,5,200,300,100,1.2,60
284,B,,MC,6,300,450,150,1.2,60
284,C,,EPC,9,850,1150,300,0.7,35
286,A,,EF,1,-1500,-1100,400,0.2,10
286,A,,MF,2,-1100,-500,600,1.5,75
286,A,,LF,3,-500,-100,400,36,1800
286,A,,TF,4,-100,200,300,8.5,425
286,A,,EC,5,200,300,100,36.1,1805
286,A,,MC,6,300,450,150,36.1,1805
286,B,,Epi,8,600,850,250,36.1,1805
287,A,,LF,3,-500,-100,400,0.3,15
287,B,,MC,6,300,450,150,0.3,15
287,B,,LC,7,450,600,150,0.3,15
287,C,,P,10,1150,1300,150,0.3,15
288,A,,P,10,1150,1300,150,0.6,30
288,A,,A,11,1300,1440,140,0.6,30
288,A,,M,12,1440,1520,80,0.6,30
290,A,,EPC,9,850,1150,300,0.3,15
290,B,,A,11,1300,1440,140,0.3,15
290,B,,M,12,1440,1520,80,0.3,15
293,A,,A/M,12,1300,1520,220,0.1,5
294,A,,MF,2,-1100,-500,600,0.3,15
294,A,,LF,3,-500,-100,400,0.3,15
294,B,,EC,5,200,300,100,0.7,35
294,B,,MC,6,300,450,150,0.7,35
294,C,,EPC,9,850,1150,300,0.1,5
294,C,,P,10,1150,1300,150,0.1,5
294,C,,A,11,1300,1440,140,0.1,5
294,C,,M,12,1440,1520,80,0.3,15
295,A,,Epi,8,600,850,250,0,0
295,A,,EPC,9,850,1150,300,2,100
297,A,,MF,2,-1100,-500,600,0.4,20
297,A,,LF,3,-500,-100,400,0.1,5
297,B,,Epi,8,600,850,250,0,0
297,B,,EPC,9,850,1150,300,0.1,5
297,B,,P,10,1150,1300,150,0.1,5
298,A,,M,12,1440,1520,80,0.8,40
299,A,,MF,2,-1100,-500,600,0.2,10
299,B,,EC,5,200,300,100,3.2,160
299,B,,MC,6,300,450,150,3.2,160
299,C,,Epi,8,600,850,250,0.2,10
299,C,,EPC,9,850,1150,300,0.7,35
299,C,,P,10,1150,1300,150,3,150
299,C,,A,11,1300,1440,140,1.8,90
299,C,,M,12,1440,1520,80,2.9,145
300,A,,P,10,1150,1300,150,1,50
301,A,,LF,3,-500,-100,400,0.2,10
302,A,,P,10,1150,1300,150,0.3,15
302,A,,A,11,1300,1440,140,0.3,15
302,A,,M,12,1440,1520,80,0.3,15
304,A,,MF,2,-1100,-500,600,3.2,160
304,A,,LF,3,-500,-100,400,0.2,10
304,A,,TF,4,-100,200,300,2.7,135
304,A,,EC,5,200,300,100,3.2,160
304,A,,MC,6,300,450,150,3.2,160
304,A,,LC,7,450,600,150,2.7,135
305,A,,MF,2,-1100,-500,600,1.8,90
305,A,,LF,3,-500,-100,400,1.8,90
305,A,,TF,4,-100,200,300,1.8,90
305,A,,EC,5,200,300,100,1.9,95
305,A,,MC,6,300,450,150,1.8,90
305,A,,LC,7,450,600,150,0.6,30
305,B,,P,10,1150,1300,150,0.5,25
306,A,,Epi,8,600,850,250,0.3,15
306,A,,EPC,9,850,1150,300,0.3,15
307,A,,MF,2,-1100,-500,600,1.7,85
307,B,,TF,4,-100,200,300,1.9,95
307,B,,EC,5,200,300,100,1.9,95
307,B,,MC,6,300,450,150,1.9,95
307,C,,Epi,8,600,850,250,1.7,85
307,D,,P,10,1150,1300,150,0.8,40
307,D,,A,11,1300,1440,140,0.8,40
307,D,,M,12,1440,1520,80,0.8,40
308,A,,MF,2,-1100,-500,600,0.2,10
308,B,,TF,4,-100,200,300,0.4,20
308,B,,EC,5,200,300,100,0.4,20
308,B,,MC,6,300,450,150,0.4,20
308,B,,LC,7,450,600,150,0.1,5
308,B,,Epi,8,600,850,250,0.1,5
308,C,,M,12,1440,1520,80,0.2,10
309,A,,TF,4,-100,200,300,0.1,5
309,A,,EC,5,200,300,100,0.1,5
309,A,,MC,6,300,450,150,0.1,5
309,A,,LC,7,450,600,150,0.1,5
309,B,,EPC,9,850,1150,300,0.1,5
309,B,,P,10,1150,1300,150,0.1,5
309,B,,A,11,1300,1440,140,0.1,5
309,B,,M,12,1440,1520,80,0.1,5
310,A,,TF,4,-100,200,300,0.2,10
310,A,,EC,5,200,300,100,0.2,10
310,A,,MC,6,300,450,150,0.2,10
310,A,,LC,7,450,600,150,0.2,10
310,A,,Epi,8,600,850,250,0.2,10
311,A,,TF,4,-100,200,300,0.2,10
311,A,,EC,5,200,300,100,0.2,10
311,A,,MC,6,300,450,150,0.2,10
311,B,,Epi,8,600,850,250,0.1,5
311,C,,P,10,1150,1300,150,0.1,5
311,C,,A,11,1300,1440,140,0.3,15
312,A,,TF,4,-100,200,300,0.1,5
312,A,,EC,5,200,300,100,0.1,5
312,A,,MC,6,300,450,150,0.1,5
312,A,,LC,7,450,600,150,0.1,5
312,A,,Epi,8,600,850,250,0.1,5
312,A,,EPC,9,850,1150,300,0.1,5
312,B,,A,11,1300,1440,140,0.1,5
313,A,,MF,2,-1100,-500,600,0.1,5
313,A,,LF,3,-500,-100,400,0.4,20
313,B,,P,10,1150,1300,150,0.4,20
313,B,,A,11,1300,1440,140,0.4,20
314,A,,EC,5,200,300,100,6.1,305
314,A,,MC,6,300,450,150,6,300
314,B,,Epi,8,600,850,250,0.9,45
314,C,,P,10,1150,1300,150,0.9,45
314,C,,A,11,1300,1440,140,2.1,105
314,C,,M,12,1440,1520,80,4.6,230
316,A,,TF,4,-100,200,300,0.7,35
316,A,,EC,5,200,300,100,0.7,35
316,A,,MC,6,300,450,150,0.7,35
316,B,,A,11,1300,1440,140,0.7,35
317,A,,EC,5,200,300,100,0.9,45
317,A,,MC,6,300,450,150,0.9,45
317,B,,P,10,1150,1300,150,0.9,45
317,B,,A,11,1300,1440,140,0.9,45
317,B,,M,12,1440,1520,80,0.9,45
318,A,,LC,7,450,600,150,0.1,5
318,B,,P,10,1150,1300,150,0.1,5
318,B,,A,11,1300,1440,140,0.1,5
320,A,,MF,2,-1100,-500,600,0.1,5
320,B,,EC,5,200,300,100,0.4,20
320,B,,MC,6,300,450,150,0.4,20
320,C,,A,11,1300,1440,140,0.4,20
320,C,,M,12,1440,1520,80,0.4,20
321,A,,TF,4,-100,200,300,0.3,15
321,A,,EC,5,200,300,100,0.3,15
321,A,,MC,6,300,450,150,0.3,15
321,A,,LC,7,450,600,150,0.3,15
321,B,,EPC,9,850,1150,300,0.3,15
322,A,,TF,4,-100,200,300,0.4,20
322,A,,EC,5,200,300,100,0.4,20
322,A,,MC,6,300,450,150,0.4,20
322,A,,LC,7,450,600,150,0.4,20
323,A,,TF,4,-100,200,300,1,50
323,A,,EC,5,200,300,100,1,50
323,A,,MC,6,300,450,150,1,50
324,A,,EC,5,200,300,100,0.2,10
324,A,,MC,6,300,450,150,0.2,10
324,A,,LC,7,450,600,150,0.2,10
324,B,,P,10,1150,1300,150,0.4,20
324,B,,A,11,1300,1440,140,1.5,75
324,B,,M,12,1440,1520,80,1.5,75
325,A,,P,10,1150,1300,150,0.2,10
325,A,,A,11,1300,1440,140,0.6,30
325,A,,M,12,1440,1520,80,0.6,30
326,A,,TF,4,-100,200,300,0.5,25
326,A,,EC,5,200,300,100,0.5,25
326,A,,MC,6,300,450,150,0.5,25
326,B,,Epi,8,600,850,250,0.5,25
326,C,,P,10,1150,1300,150,0.5,25
327,A,,LF,3,-500,-100,400,0.3,15
327,A,,TF,4,-100,200,300,0.1,5
327,A,,EC,5,200,300,100,0.1,5
327,A,,MC,6,300,450,150,0.1,5
329,A,,LF,3,-500,-100,400,0.1,5
329,A,,TF,4,-100,200,300,0.1,5
329,A,,EC,5,200,300,100,0.1,5
329,A,,MC,6,300,450,150,0.1,5
329,A,,LC,7,450,600,150,0.1,5
329,A,,Epi,8,600,850,250,0.1,5
329,B,,M,12,1440,1520,80,0.1,5
330,A,,MC,6,300,450,150,0.3,15
330,A,,LC,7,450,600,150,0.3,15
331,A,,TF,4,-100,200,300,0.1,5
331,A,,EC,5,200,300,100,0.1,5
331,A,,MC,6,300,450,150,0.1,5
332,A,,TF,4,-100,200,300,1.2,60
332,A,,EC,5,200,300,100,1.2,60
332,A,,MC,6,300,450,150,1.2,60
332,A,,LC,7,450,600,150,1.2,60
333,A,,LF,3,-500,-100,400,0.5,25
333,A,,TF,4,-100,200,300,0.5,25
333,A,,EC,5,200,300,100,0.5,25
334,A,,MF,2,-1100,-500,600,0.2,10
334,A,,LF,3,-500,-100,400,1.5,75
334,A,886,TF,4,-100,200,300,6.2,310
334,A,,TF,4,-100,200,300,2.7,135
334,A,,EC,5,200,300,100,37.4,1870
334,A,,MC,6,300,450,150,37.4,1870
334,A,886,LC,7,450,600,150,2.7,135
334,A,,LC,7,450,600,150,0.4,20
334,A,,Epi,8,600,850,250,0.4,20
334,A,887,EPC,9,850,1150,300,0.2,10
334,A,,EPC,9,850,1150,300,0.2,10
334,A,,P,10,1150,1300,150,4.1,205
334,A,,A,11,1300,1440,140,17.7,885
334,A,,M,12,1440,1520,80,13.3,665
335,A,,MF,2,-1100,-500,600,0.1,5
335,A,,LF,3,-500,-100,400,0.1,5
335,A,915,TF,4,-100,200,300,0.8,40
335,A,,TF,4,-100,200,300,2.2,110
335,A,915,EC,5,200,300,100,0.8,40
335,A,,EC,5,200,300,100,2.2,110
335,A,915,MC,6,300,450,150,0.8,40
335,A,,MC,6,300,450,150,2.2,110
335,A,915,LC,7,450,600,150,0.8,40
335,A,,LC,7,450,600,150,2.2,110
335,A,,Epi,8,600,850,250,22.8,1140
335,B,,P,10,1150,1300,150,1.4,70
335,B,,A,11,1300,1440,140,17.3,865
335,B,,M,12,1440,1520,80,22.8,1140
336,A,,EC,5,200,300,100,0.1,5
336,B,,M,12,1440,1520,80,0.1,5
337,A,,TF,4,-100,200,300,0.3,15
337,A,,EC,5,200,300,100,0.3,15
337,A,,MC,6,300,450,150,0.3,15
337,B,,A,11,1300,1440,140,0.3,15
337,B,,M,12,1440,1520,80,0.3,15
338,A,,EC,5,200,300,100,0.1,5
338,B,,A,11,1300,1440,140,0.4,20
338,B,,M,12,1440,1520,80,0.4,20
339,A,,TF,4,-100,200,300,1.3,65
339,A,,EC,5,200,300,100,1.3,65
339,A,,MC,6,300,450,150,1.3,65
339,A,,LC,7,450,600,150,1.3,65
340,A,,EC,5,200,300,100,0.1,5
340,A,,MC,6,300,450,150,0.1,5
340,A,,LC,7,450,600,150,0.1,5
341,A,,LF,3,-500,-100,400,2.1,105
341,A,,TF,4,-100,200,300,13.1,655
341,A,,EC,5,200,300,100,13.1,655
341,A,,MC,6,300,450,150,13.1,655
341,A,,LC,7,450,600,150,12.3,615
341,A,,Epi,8,600,850,250,1,50
341,A,,EPC,9,850,1150,300,0.1,5
341,A,,P,10,1150,1300,150,5,250
341,A,,A,11,1300,1440,140,4.9,245
341,A,,M,12,1440,1520,80,13,650
342,A,,MF,2,-1100,-500,600,0.1,5
342,B,,TF,4,-100,200,300,0.1,5
342,B,,EC,5,200,300,100,0.1,5
342,B,,MC,6,300,450,150,0.1,5
342,B,,LC,7,450,600,150,0.1,5
343,A,,TF,4,-100,200,300,0.2,10
343,A,,EC,5,200,300,100,5.9,295
343,A,,MC,6,300,450,150,5.9,295
343,A,,LC,7,450,600,150,0.9,45
343,B,,EPC,9,850,1150,300,0.4,20
344,A,,A,11,1300,1440,140,0.1,5
344,A,,M,12,1440,1520,80,0.1,5
345,A,,EC,5,200,300,100,0.1,5
345,A,,MC,6,300,450,150,0.1,5
346,A,,MF,2,-1100,-500,600,0.3,15
346,B,,EC,5,200,300,100,0.5,25
346,B,,MC,6,300,450,150,0.5,25
346,C,,A,11,1300,1440,140,3.4,170
346,C,,M,12,1440,1520,80,1.6,80
348,A,,P,10,1150,1300,150,1.2,60
348,A,,A,11,1300,1440,140,1.2,60
348,A,,M,12,1440,1520,80,1.2,60
349,A,,EC,5,200,300,100,0.4,20
349,A,,MC,6,300,450,150,0.4,20
349,B,,A,11,1300,1440,140,0.4,20
350,A,,Epi,8,600,850,250,1.3,65
350,A,,EPC,9,850,1150,300,1.1,55
350,A,,P,10,1150,1300,150,1.3,65
350,A,,A,11,1300,1440,140,3.6,180
350,A,,M,12,1440,1520,80,3.6,180
351,A,,EPC,9,850,1150,300,0.2,10
351,A,,P,10,1150,1300,150,0.2,10
352,A,,MF,2,-1100,-500,600,1.8,90
352,B,,TF,4,-100,200,300,0.9,45
352,B,,EC,5,200,300,100,1.8,90
352,B,,MC,6,300,450,150,1.8,90
352,B,,LC,7,450,600,150,0.9,45
353,A,,TF,4,-100,200,300,0.5,25
353,A,,EC,5,200,300,100,2.4,120
353,A,,MC,6,300,450,150,2.4,120
353,A,,LC,7,450,600,150,2.5,125
353,B,,P,10,1150,1300,150,4.5,225
353,B,,A,11,1300,1440,140,8.6,430
353,B,,M,12,1440,1520,80,8.6,430
354,A,,TF,4,-100,200,300,0.3,15
354,A,,EC,5,200,300,100,0.3,15
354,A,,MC,6,300,450,150,0.3,15
354,A,,LC,7,450,600,150,0.3,15
354,B,,P,10,1150,1300,150,0.1,5
354,B,,A,11,1300,1440,140,0.1,5
354,B,,M,12,1440,1520,80,0.3,15
355,A,,P,10,1150,1300,150,0.6,30
355,A,,A,11,1300,1440,140,0.6,30
356,A,,LC,7,450,600,150,0.2,10
357,A,,TF,4,-100,200,300,0.1,5
358,A,,TF,4,-100,200,300,10.6,530
358,A,,EC,5,200,300,100,10.6,530
358,A,,MC,6,300,450,150,0.7,35
358,A,,LC,7,450,600,150,1.3,65
358,B,,P,10,1150,1300,150,10.6,530
358,B,889,A,11,1300,1440,140,0.2,10
358,B,,A,11,1300,1440,140,4.2,210
358,B,,M,12,1440,1520,80,3.1,155
359,A,,TF,4,-100,200,300,0.4,20
359,A,,EC,5,200,300,100,0.4,20
359,B,,LC,7,450,600,150,0.4,20
359,C,,A,11,1300,1440,140,0.4,20
359,C,,M,12,1440,1520,80,0.1,5
360,A,,LF,3,-500,-100,400,6.5,325
360,B,,EC,5,200,300,100,11.6,580
360,B,,MC,6,300,450,150,11.6,580
360,C,,EPC,9,850,1150,300,0.1,5
360,C,,P,10,1150,1300,150,1.4,70
361,A,,EC,5,200,300,100,0.2,10
361,A,,MC,6,300,450,150,0.2,10
361,B,,P,10,1150,1300,150,28.5,1425
361,B,,A,11,1300,1440,140,12.2,610
361,B,892,M,12,1440,1520,80,3.8,190
361,B,,M,12,1440,1520,80,3.6,180
362,A,,TF,4,-100,200,300,0.3,15
362,A,,EC,5,200,300,100,0.3,15
362,A,,MC,6,300,450,150,0.3,15
362,B,,P,10,1150,1300,150,1.2,60
362,B,,A,11,1300,1440,140,1.2,60
362,B,,M,12,1440,1520,80,1.2,60
363,A,,TF,4,-100,200,300,0.1,5
363,A,,EC,5,200,300,100,0.1,5
363,A,,MC,6,300,450,150,0.1,5
363,A,,LC,7,450,600,150,0.1,5
363,B,,P,10,1150,1300,150,0.2,10
363,B,891,A,11,1300,1440,140,0.3,15
363,B,,A,11,1300,1440,140,0.2,10
363,B,,M,12,1440,1520,80,1,50
365,A,,P,10,1150,1300,150,0.1,5
366,A,,P,10,1150,1300,150,0.3,15
366,A,,A,11,1300,1440,140,0.3,15
367,A,,TF,4,-100,200,300,0.8,40
367,A,,EC,5,200,300,100,0.8,40
367,B,,P,10,1150,1300,150,0.8,40
367,B,,A,11,1300,1440,140,0.8,40
367,B,,M,12,1440,1520,80,0.1,5
368,A,,LF,3,-500,-100,400,0.2,10
368,A,,TF,4,-100,200,300,0.4,20
368,A,,EC,5,200,300,100,0.8,40
368,A,,MC,6,300,450,150,0.4,20
368,A,,LC,7,450,600,150,0.4,20
368,B,,P,10,1150,1300,150,0.2,10
368,B,,A,11,1300,1440,140,0.4,20
368,B,,M,12,1440,1520,80,0.2,10
370,A,,MC,6,300,450,150,0.3,15
371,A,,TF,4,-100,200,300,0.8,40
371,A,,EC,5,200,300,100,0.8,40
371,A,,MC,6,300,450,150,0.8,40
371,A,,LC,7,450,600,150,0.1,5
371,A,,Epi,8,600,850,250,0.3,15
371,A,,EPC,9,850,1150,300,0.3,15
371,B,,A,11,1300,1440,140,0.3,15
372,A,,TF,4,-100,200,300,2,100
372,B,,A,11,1300,1440,140,2,100
372,B,,M,12,1440,1520,80,2,100
373,A,,TF,4,-100,200,300,0.7,35
373,A,,EC,5,200,300,100,1.6,80
373,A,,MC,6,300,450,150,1.6,80
373,B,,M,12,1440,1520,80,4.2,210
375,A,,TF,4,-100,200,300,1.2,60
375,A,,EC,5,200,300,100,1.2,60
375,A,,MC,6,300,450,150,1.2,60
375,A,,LC,7,450,600,150,1.2,60
375,B,,P,10,1150,1300,150,0.7,35
375,B,,A,11,1300,1440,140,1.2,60
375,B,,M,12,1440,1520,80,0.7,35
376,A,,TF,4,-100,200,300,4.1,205
376,B,,Epi,8,600,850,250,2.2,110
376,C,,A,11,1300,1440,140,1.5,75
376,C,,M,12,1440,1520,80,1.5,75
377,A,,M,12,1440,1520,80,0.5,25
379,A,,LC,7,450,600,150,0.4,20
379,B,,A,11,1300,1440,140,0.4,20
382,A,,LF,3,-500,-100,400,3.1,155
382,B,,EC,5,200,300,100,12,600
382,B,,MC,6,300,450,150,13.1,655
382,C,,Epi,8,600,850,250,13.1,655
382,D,,A,11,1300,1440,140,0.8,40
382,D,,M,12,1440,1520,80,1.9,95
383,A,,LF,3,-500,-100,400,0.6,30
383,A,,TF,4,-100,200,300,1.5,75
383,A,,EC,5,200,300,100,1.5,75
383,A,,MC,6,300,450,150,5,250
383,A,,LC,7,450,600,150,0.2,10
383,B,,EPC,9,850,1150,300,0.1,5
383,B,,P,10,1150,1300,150,1.3,65
383,B,,A,11,1300,1440,140,3,150
383,B,,M,12,1440,1520,80,2.8,140
388,A,,EC,5,200,300,100,0.7,35
388,A,,MC,6,300,450,150,0.7,35
390,A,,P,10,1150,1300,150,0.2,10
390,A,,A,11,1300,1440,140,0.5,25
390,A,,M,12,1440,1520,80,0.5,25
391,A,,MF,2,-1100,-500,600,1,50
391,A,,LF,3,-500,-100,400,0.4,20
391,A,,TF,4,-100,200,300,0.3,15
391,A,,EC,5,200,300,100,17.6,880
391,A,,MC,6,300,450,150,17.6,880
391,B,,EPC,9,850,1150,300,1.1,55
391,B,,P,10,1150,1300,150,0.5,25
391,B,,A,11,1300,1440,140,28.8,1440
391,B,,M,12,1440,1520,80,26.9,1345
392,A,,TF,4,-100,200,300,0.8,40
392,B,,MC,6,300,450,150,0.8,40
392,B,,LC,7,450,600,150,0.8,40
392,B,,Epi,8,600,850,250,0.8,40
392,B,,EPC,9,850,1150,300,0.4,20
392,C,,A,11,1300,1440,140,0.8,40
393,A,,EC,5,200,300,100,1.2,60
393,A,,MC,6,300,450,150,1.2,60
393,B,,Epi,8,600,850,250,1.2,60
393,C,,A,11,1300,1440,140,1.2,60
393,C,,M,12,1440,1520,80,1.2,60
394,A,,P,10,1150,1300,150,2.4,120
394,A,,A,11,1300,1440,140,7.2,360
394,A,,M,12,1440,1520,80,7.2,360
395,A,,TF,4,-100,200,300,0.1,5
395,A,916,EC,5,200,300,100,1,50
395,A,,EC,5,200,300,100,0.1,5
395,B,,P,10,1150,1300,150,6.7,335
395,B,,A,11,1300,1440,140,22.7,1135
395,B,,M,12,1440,1520,80,22.7,1135
396,A,,P,10,1150,1300,150,0.6,30
396,A,,A,11,1300,1440,140,1.2,60
396,A,,M,12,1440,1520,80,1.2,60
397,A,,P,10,1150,1300,150,0.3,15
397,A,,A,11,1300,1440,140,0.3,15
397,A,,M,12,1440,1520,80,0.3,15
398,A,,A,11,1300,1440,140,0.2,10
398,A,,M,12,1440,1520,80,0.2,10
400,A,,EC,5,200,300,100,0.2,10
401,A,,LF,3,-500,-100,400,0.2,10
401,A,,TF,4,-100,200,300,2.4,120
401,B,,MC,6,300,450,150,2.4,120
401,C,,P,10,1150,1300,150,0.2,10
401,C,,A,11,1300,1440,140,3,150
401,C,,M,12,1440,1520,80,3,150
405,A,,LF,3,-500,-100,400,4.6,230
405,A,,TF,4,-100,200,300,4.3,215
405,A,,EC,5,200,300,100,7.3,365
405,A,,MC,6,300,450,150,7.3,365
405,B,,P,10,1150,1300,150,3.4,170
405,B,,A,11,1300,1440,140,4.2,210
405,B,,M,12,1440,1520,80,7.3,365
406,A,,TF,4,-100,200,300,0.4,20
406,B,,MC,6,300,450,150,0.4,20
407,A,,TF,4,-100,200,300,0.3,15
407,A,,EC,5,200,300,100,0.3,15
407,A,,MC,6,300,450,150,0.5,25
407,B,,P,10,1150,1300,150,0.5,25
407,B,,A,11,1300,1440,140,0.3,15
408,A,,TF,4,-100,200,300,2.8,140
408,A,,EC,5,200,300,100,2.8,140
408,A,,MC,6,300,450,150,2.8,140
409,A,,MF,2,-1100,-500,600,2.1,105
409,A,,LF,3,-500,-100,400,0.3,15
409,A,,TF,4,-100,200,300,0.6,30
409,A,,EC,5,200,300,100,0.6,30
409,A,,MC,6,300,450,150,0.6,30
409,A,,LC,7,450,600,150,0.1,5
411,A,,TF,4,-100,200,300,0.3,15
411,A,,EC,5,200,300,100,0.4,20
411,A,,MC,6,300,450,150,0.4,20
411,A,,LC,7,450,600,150,0.1,5
411,A,,Epi,8,600,850,250,0.2,10
411,B,,P,10,1150,1300,150,0.2,10
411,B,,A,11,1300,1440,140,0.2,10
411,B,,M,12,1440,1520,80,0.2,10
412,A,917,TF,4,-100,200,300,0.2,10
412,A,,TF,4,-100,200,300,2.1,105
412,A,,EC,5,200,300,100,6.6,330
412,A,,MC,6,300,450,150,6.6,330
412,A,,LC,7,450,600,150,0.6,30
412,A,,Epi,8,600,850,250,0,0
412,B,,P,10,1150,1300,150,1.7,85
412,B,,A,11,1300,1440,140,6.6,330
412,B,,M,12,1440,1520,80,5,250
413,A,,MF,2,-1100,-500,600,3,150
413,A,,LF,3,-500,-100,400,0.8,40
413,A,,TF,4,-100,200,300,18.5,925
413,A,,EC,5,200,300,100,18.5,925
413,A,,MC,6,300,450,150,18.5,925
413,A,,LC,7,450,600,150,10.3,515
414,A,,MF,2,-1100,-500,600,2.5,125
414,A,,LF,3,-500,-100,400,3.2,160
414,A,,TF,4,-100,200,300,1.3,65
414,A,,EC,5,200,300,100,3.2,160
414,A,,MC,6,300,450,150,3.2,160
414,A,,LC,7,450,600,150,1.9,95
414,A,,A/M,12,1300,1520,220,1.1,55
1401,A,854,M,12,1440,1520,80,0.1,5
1402,A,852,M,12,1440,1520,80,0.1,5
1402,A,853,M,12,1440,1520,80,0.1,5
